Jahr,Monat,Code,Label,Ausfuhr: Wert,Einfuhr: Wert,Handelsvolumen
2008,1,WA01,Lebende Tiere,82264000,102367000,184631000
2008,1,WA02,Fleisch,509402000,439739000,949141000
2008,1,WA03,"Fische, Krebs- und Weichtiere",84368000,230238000,314606000
2008,1,WA04,"Milch, Milcherzeugnisse, Eier, Honig",586000000,466414000,1052414000
2008,1,WA05,Andere Waren tierischen Ursprungs,43838000,50859000,94697000
2008,1,WA06,"Pflanzen, Waren des Blumenhandels",35126000,163049000,198175000
2008,1,WA07,"Gemüse, Pflanzen für Ernährung",76808000,395631000,472439000
2008,1,WA08,Genießbare Früchte und Nüsse,122384000,493176000,615560000
2008,1,WA09,"Kaffee, Tee, Mate, Gewürze",103900000,221306000,325206000
2008,1,WA10,Getreide,136814000,191885000,328699000
2008,1,WA11,"Müllereierzeugnisse, Malz usw.",84705000,36767000,121472000
2008,1,WA12,"Ölsamen usw., Heilpflanzen usw.",120035000,262931000,382966000
2008,1,WA13,"Schellack, Gummen, Harz, Pflanzensaft",40772000,23540000,64312000
2008,1,WA14,Flechtstoffe usw. pflanzlichen Ursprungs,652000,2216000,2868000
2008,1,WA15,"Tierische und pflanzliche Fette, Öle, Wachs",166381000,242549000,408930000
2008,1,WA16,"Zubereitungen von Fleisch, Fisch usw.",188204000,150767000,338971000
2008,1,WA17,Zucker und Zuckerwaren,115265000,106555000,221820000
2008,1,WA18,Kakao und Zubereitungen aus Kakao,195297000,179462000,374759000
2008,1,WA19,"Zubereitungen aus Getreide usw., Backwaren",302522000,205949000,508471000
2008,1,WA20,"Zubereitungen von Gemüse, Früchten usw.",175324000,348935000,524259000
2008,1,WA21,Verschiedene Lebensmittelzubereitungen,265082000,215471000,480553000
2008,1,WA22,"Getränke, alkoholhaltige Flüssigkeiten, Essig",282187000,397076000,679263000
2008,1,WA23,"Rückstände der Lebensmittelindustrie, Futter",223132000,246366000,469498000
2008,1,WA24,Tabak,295462000,119982000,415444000
2008,1,WA25,"Salz, Schwefel, Steine, Erden usw.",167820000,140800000,308620000
2008,1,WA26,"Erze, Schlacken, Aschen",29254000,543399000,572653000
2008,1,WA27,Mineralische Brennstoffe usw.,2361631000,9125173000,11486804000
2008,1,WA28,Anorganische chemische Erzeugnisse,649353000,408571000,1057924000
2008,1,WA29,Organische chemische Erzeugnisse,2426315000,1913139000,4339454000
2008,1,WA30,Pharmazeutische Erzeugnisse,3656510000,2336170000,5992680000
2008,1,WA31,Düngemittel,183403000,113059000,296462000
2008,1,WA32,"Gerb- und Farbstoffe, Farben, Lacke usw.",683576000,317471000,1001047000
2008,1,WA33,"Etherische Öle, Riech-, Schönheitsmittel",582528000,329731000,912259000
2008,1,WA34,"Seifen, Waschmittel usw.",435089000,208760000,643849000
2008,1,WA35,"Eiweißstoffe, Klebstoffe, Enzyme",161894000,123829000,285723000
2008,1,WA36,"Sprengstoffe, pyrotechnische Artikel usw.",15248000,16323000,31571000
2008,1,WA37,Photochemische Erzeugnisse,130966000,81249000,212215000
2008,1,WA38,Verschiedene Erzeugnisse der Chemischen Industrie,1535643000,743735000,2279378000
2008,1,WA39,Kunststoffe und Waren daraus,3931414000,2237149000,6168563000
2008,1,WA40,Kautschuk und Waren daraus,867253000,840209000,1707462000
2008,1,WA41,"Häute, Felle, Leder",98901000,73682000,172583000
2008,1,WA42,"Lederwaren, Sattlerwaren",107582000,205162000,312744000
2008,1,WA43,"Pelzfelle, künstliches Pelzwerk",11746000,10242000,21988000
2008,1,WA44,"Holz, Holzwaren, Holzkohle",686142000,464249000,1150391000
2008,1,WA45,"Kork, Korkwaren",3003000,10598000,13601000
2008,1,WA46,"Flechtwaren, Korbmacherwaren",4391000,14111000,18502000
2008,1,WA47,"Halbstoffe aus Holz usw., Papierabfall",76535000,298252000,374787000
2008,1,WA48,"Papier, Pappe und Waren daraus",1616175000,1025047000,2641222000
2008,1,WA49,"Bücher, Zeitungen, Bilddrucke usw.",437662000,179441000,617103000
2008,1,WA50,Seide,7274000,7825000,15099000
2008,1,WA51,"Wolle, feine und grobe Tierhaare",57676000,75537000,133213000
2008,1,WA52,Baumwolle,106323000,91856000,198179000
2008,1,WA53,"Andere pflanzliche Spinnstoffe, Papiergarn",11703000,11454000,23157000
2008,1,WA54,Synthetisches oder künstliches Filament,224163000,133593000,357756000
2008,1,WA55,Synthetische oder künstliche Spinnfaser,187745000,126223000,313968000
2008,1,WA56,"Watte, Filz, Vliesstoff usw., Tauwerk",167750000,91641000,259391000
2008,1,WA57,"Teppiche, Fußbodenbelag aus Spinnstoff",46876000,96950000,143826000
2008,1,WA58,"Spezialgewebe, Spitzen, Tapisserien",39369000,29330000,68699000
2008,1,WA59,"Getränkte, bestrichene usw. Gewebe",149653000,101785000,251438000
2008,1,WA60,Gewirke und Gestricke,78104000,36589000,114693000
2008,1,WA61,"Bekleidung usw. aus Gewirken, Gestricken",410078000,883377000,1293455000
2008,1,WA62,"Andere Bekleidung, Bekleidungszubehör",652015000,1073156000,1725171000
2008,1,WA63,"Andere Konfektion, Spinnstoffwaren usw.",138498000,224952000,363450000
2008,1,WA64,"Schuhe, Gamaschen, ähnliche Waren",253893000,489037000,742930000
2008,1,WA65,Kopfbedeckungen und Teile davon,16670000,30945000,47615000
2008,1,WA66,"Schirme, Gehstöcke usw., Peitschen",4407000,16428000,20835000
2008,1,WA67,"Zugerichtete Federn, Daunen, künstliche Blumen",7665000,13966000,21631000
2008,1,WA68,"Waren aus Steinen, Gips, Zement usw.",272663000,167344000,440007000
2008,1,WA69,Keramische Waren,249054000,167541000,416595000
2008,1,WA70,Glas und Glaswaren,423756000,309503000,733259000
2008,1,WA71,"Perlen, Edelsteine, Edelmetalle",751101000,887010000,1638111000
2008,1,WA72,Eisen und Stahl,2179287000,2282042000,4461329000
2008,1,WA73,Waren aus Eisen oder Stahl,2156353000,1340441000,3496794000
2008,1,WA74,Kupfer und Waren daraus,939287000,726522000,1665809000
2008,1,WA75,Nickel und Waren daraus,119475000,169858000,289333000
2008,1,WA76,Aluminium und Waren daraus,1049210000,1014094000,2063304000
2008,1,WA78,Blei und Waren daraus,39859000,23616000,63475000
2008,1,WA79,Zink und Waren daraus,48411000,77512000,125923000
2008,1,WA80,Zinn und Waren daraus,10296000,28327000,38623000
2008,1,WA81,"Andere unedle Metalle, Cermets usw.",94750000,135918000,230668000
2008,1,WA82,"Werkzeuge, Schneidwaren, Essbestecke",538234000,314398000,852632000
2008,1,WA83,Verschiedene Waren aus unedlen Metallen,552939000,314929000,867868000
2008,1,WA84,"Maschinen, Apparate, mechanische Geräte",15791430000,8890887000,24682317000
2008,1,WA85,Elektrotechnische Erzeugnisse,8562552000,7182760000,15745312000
2008,1,WA86,Schienenfahrzeuge,266941000,123094000,390035000
2008,1,WA87,"Kraftfahrzeuge, Landfahrzeuge",13653490000,5200401000,18853891000
2008,1,WA88,"Luftfahrzeuge, Raumfahrzeuge",1394177000,1354022000,2748199000
2008,1,WA89,Wasserfahrzeuge,80427000,447973000,528400000
2008,1,WA90,"Optische, photografische usw. Erzeugnisse",3296652000,1802415000,5099067000
2008,1,WA91,Uhrmacherwaren,78946000,100380000,179326000
2008,1,WA92,Musikinstrumente,35665000,29416000,65081000
2008,1,WA93,Waffen und Munition,26231000,11012000,37243000
2008,1,WA94,"Möbel, Beleuchtungskörper usw.",1001750000,1060909000,2062659000
2008,1,WA95,"Spielzeug, Spiele usw., Sportgeräte",362954000,440493000,803447000
2008,1,WA96,Verschiedene Waren,152037000,99495000,251532000
2008,1,WA97,"Kunstgegenstände, Sammlungsstücke",39142000,26524000,65666000
2008,1,WA98,Vollständige Fabrikationsanlagen,307077000,5149000,312226000
2008,1,WA99,Zusammenstellungen verschiedener Waren,1194263000,939915000,2134178000
2008,2,WA01,Lebende Tiere,69436000,95585000,165021000
2008,2,WA02,Fleisch,434724000,415809000,850533000
2008,2,WA03,"Fische, Krebs- und Weichtiere",70345000,191777000,262122000
2008,2,WA04,"Milch, Milcherzeugnisse, Eier, Honig",595027000,464154000,1059181000
2008,2,WA05,Andere Waren tierischen Ursprungs,39055000,51688000,90743000
2008,2,WA06,"Pflanzen, Waren des Blumenhandels",47726000,219546000,267272000
2008,2,WA07,"Gemüse, Pflanzen für Ernährung",56387000,352508000,408895000
2008,2,WA08,Genießbare Früchte und Nüsse,123056000,482373000,605429000
2008,2,WA09,"Kaffee, Tee, Mate, Gewürze",119383000,204465000,323848000
2008,2,WA10,Getreide,134048000,193512000,327560000
2008,2,WA11,"Müllereierzeugnisse, Malz usw.",79403000,36896000,116299000
2008,2,WA12,"Ölsamen usw., Heilpflanzen usw.",151197000,212253000,363450000
2008,2,WA13,"Schellack, Gummen, Harz, Pflanzensaft",44263000,30332000,74595000
2008,2,WA14,Flechtstoffe usw. pflanzlichen Ursprungs,924000,2500000,3424000
2008,2,WA15,"Tierische und pflanzliche Fette, Öle, Wachs",143993000,250017000,394010000
2008,2,WA16,"Zubereitungen von Fleisch, Fisch usw.",167291000,158310000,325601000
2008,2,WA17,Zucker und Zuckerwaren,96195000,111467000,207662000
2008,2,WA18,Kakao und Zubereitungen aus Kakao,219371000,194386000,413757000
2008,2,WA19,"Zubereitungen aus Getreide usw., Backwaren",327083000,186615000,513698000
2008,2,WA20,"Zubereitungen von Gemüse, Früchten usw.",185102000,300368000,485470000
2008,2,WA21,Verschiedene Lebensmittelzubereitungen,287922000,187824000,475746000
2008,2,WA22,"Getränke, alkoholhaltige Flüssigkeiten, Essig",298151000,369502000,667653000
2008,2,WA23,"Rückstände der Lebensmittelindustrie, Futter",180409000,236238000,416647000
2008,2,WA24,Tabak,248134000,107082000,355216000
2008,2,WA25,"Salz, Schwefel, Steine, Erden usw.",157066000,138045000,295111000
2008,2,WA26,"Erze, Schlacken, Aschen",25361000,501114000,526475000
2008,2,WA27,Mineralische Brennstoffe usw.,2019722000,8979102000,10998824000
2008,2,WA28,Anorganische chemische Erzeugnisse,591858000,574658000,1166516000
2008,2,WA29,Organische chemische Erzeugnisse,2160168000,2029764000,4189932000
2008,2,WA30,Pharmazeutische Erzeugnisse,3612902000,2555744000,6168646000
2008,2,WA31,Düngemittel,221188000,126836000,348024000
2008,2,WA32,"Gerb- und Farbstoffe, Farben, Lacke usw.",707027000,301439000,1008466000
2008,2,WA33,"Etherische Öle, Riech-, Schönheitsmittel",547748000,304488000,852236000
2008,2,WA34,"Seifen, Waschmittel usw.",410924000,194044000,604968000
2008,2,WA35,"Eiweißstoffe, Klebstoffe, Enzyme",168051000,134713000,302764000
2008,2,WA36,"Sprengstoffe, pyrotechnische Artikel usw.",18952000,11354000,30306000
2008,2,WA37,Photochemische Erzeugnisse,123573000,68803000,192376000
2008,2,WA38,Verschiedene Erzeugnisse der Chemischen Industrie,1382906000,785141000,2168047000
2008,2,WA39,Kunststoffe und Waren daraus,3773066000,2266380000,6039446000
2008,2,WA40,Kautschuk und Waren daraus,849433000,838124000,1687557000
2008,2,WA41,"Häute, Felle, Leder",79148000,67559000,146707000
2008,2,WA42,"Lederwaren, Sattlerwaren",114744000,196836000,311580000
2008,2,WA43,"Pelzfelle, künstliches Pelzwerk",12841000,7999000,20840000
2008,2,WA44,"Holz, Holzwaren, Holzkohle",636497000,451347000,1087844000
2008,2,WA45,"Kork, Korkwaren",3653000,10030000,13683000
2008,2,WA46,"Flechtwaren, Korbmacherwaren",4302000,11986000,16288000
2008,2,WA47,"Halbstoffe aus Holz usw., Papierabfall",93755000,294623000,388378000
2008,2,WA48,"Papier, Pappe und Waren daraus",1513720000,951297000,2465017000
2008,2,WA49,"Bücher, Zeitungen, Bilddrucke usw.",410783000,162947000,573730000
2008,2,WA50,Seide,7049000,6548000,13597000
2008,2,WA51,"Wolle, feine und grobe Tierhaare",76162000,64104000,140266000
2008,2,WA52,Baumwolle,89799000,81802000,171601000
2008,2,WA53,"Andere pflanzliche Spinnstoffe, Papiergarn",7475000,8987000,16462000
2008,2,WA54,Synthetisches oder künstliches Filament,199588000,133554000,333142000
2008,2,WA55,Synthetische oder künstliche Spinnfaser,150540000,109264000,259804000
2008,2,WA56,"Watte, Filz, Vliesstoff usw., Tauwerk",157585000,91591000,249176000
2008,2,WA57,"Teppiche, Fußbodenbelag aus Spinnstoff",38757000,87514000,126271000
2008,2,WA58,"Spezialgewebe, Spitzen, Tapisserien",40963000,25595000,66558000
2008,2,WA59,"Getränkte, bestrichene usw. Gewebe",147260000,103048000,250308000
2008,2,WA60,Gewirke und Gestricke,69000000,33747000,102747000
2008,2,WA61,"Bekleidung usw. aus Gewirken, Gestricken",419879000,879114000,1298993000
2008,2,WA62,"Andere Bekleidung, Bekleidungszubehör",710845000,1151967000,1862812000
2008,2,WA63,"Andere Konfektion, Spinnstoffwaren usw.",119401000,212596000,331997000
2008,2,WA64,"Schuhe, Gamaschen, ähnliche Waren",260100000,502652000,762752000
2008,2,WA65,Kopfbedeckungen und Teile davon,17933000,29677000,47610000
2008,2,WA66,"Schirme, Gehstöcke usw., Peitschen",4886000,23529000,28415000
2008,2,WA67,"Zugerichtete Federn, Daunen, künstliche Blumen",5944000,11082000,17026000
2008,2,WA68,"Waren aus Steinen, Gips, Zement usw.",273601000,172991000,446592000
2008,2,WA69,Keramische Waren,226845000,172899000,399744000
2008,2,WA70,Glas und Glaswaren,393440000,286620000,680060000
2008,2,WA71,"Perlen, Edelsteine, Edelmetalle",805788000,823389000,1629177000
2008,2,WA72,Eisen und Stahl,2182150000,2241948000,4424098000
2008,2,WA73,Waren aus Eisen oder Stahl,2106812000,1312805000,3419617000
2008,2,WA74,Kupfer und Waren daraus,903843000,835557000,1739400000
2008,2,WA75,Nickel und Waren daraus,106781000,195878000,302659000
2008,2,WA76,Aluminium und Waren daraus,1037132000,1023947000,2061079000
2008,2,WA78,Blei und Waren daraus,52544000,25876000,78420000
2008,2,WA79,Zink und Waren daraus,54796000,88975000,143771000
2008,2,WA80,Zinn und Waren daraus,12728000,22027000,34755000
2008,2,WA81,"Andere unedle Metalle, Cermets usw.",94896000,129588000,224484000
2008,2,WA82,"Werkzeuge, Schneidwaren, Essbestecke",507529000,333362000,840891000
2008,2,WA83,Verschiedene Waren aus unedlen Metallen,535816000,296113000,831929000
2008,2,WA84,"Maschinen, Apparate, mechanische Geräte",15451175000,8646839000,24098014000
2008,2,WA85,Elektrotechnische Erzeugnisse,8424436000,6987746000,15412182000
2008,2,WA86,Schienenfahrzeuge,210645000,104935000,315580000
2008,2,WA87,"Kraftfahrzeuge, Landfahrzeuge",14977088000,5639790000,20616878000
2008,2,WA88,"Luftfahrzeuge, Raumfahrzeuge",1958036000,1735349000,3693385000
2008,2,WA89,Wasserfahrzeuge,175377000,191768000,367145000
2008,2,WA90,"Optische, photografische usw. Erzeugnisse",3183246000,1799569000,4982815000
2008,2,WA91,Uhrmacherwaren,85673000,92116000,177789000
2008,2,WA92,Musikinstrumente,33883000,28713000,62596000
2008,2,WA93,Waffen und Munition,29114000,10917000,40031000
2008,2,WA94,"Möbel, Beleuchtungskörper usw.",1014753000,1022542000,2037295000
2008,2,WA95,"Spielzeug, Spiele usw., Sportgeräte",425220000,515178000,940398000
2008,2,WA96,Verschiedene Waren,160299000,93210000,253509000
2008,2,WA97,"Kunstgegenstände, Sammlungsstücke",34091000,24961000,59052000
2008,2,WA98,Vollständige Fabrikationsanlagen,337600000,2950000,340550000
2008,2,WA99,Zusammenstellungen verschiedener Waren,1439747000,978366000,2418113000
2008,3,WA01,Lebende Tiere,68070000,83520000,151590000
2008,3,WA02,Fleisch,406255000,419111000,825366000
2008,3,WA03,"Fische, Krebs- und Weichtiere",83547000,194085000,277632000
2008,3,WA04,"Milch, Milcherzeugnisse, Eier, Honig",607801000,514152000,1121953000
2008,3,WA05,Andere Waren tierischen Ursprungs,37912000,42833000,80745000
2008,3,WA06,"Pflanzen, Waren des Blumenhandels",61782000,257162000,318944000
2008,3,WA07,"Gemüse, Pflanzen für Ernährung",68897000,431147000,500044000
2008,3,WA08,Genießbare Früchte und Nüsse,100719000,473601000,574320000
2008,3,WA09,"Kaffee, Tee, Mate, Gewürze",127290000,192973000,320263000
2008,3,WA10,Getreide,157784000,206813000,364597000
2008,3,WA11,"Müllereierzeugnisse, Malz usw.",68874000,37112000,105986000
2008,3,WA12,"Ölsamen usw., Heilpflanzen usw.",130423000,233172000,363595000
2008,3,WA13,"Schellack, Gummen, Harz, Pflanzensaft",42380000,29289000,71669000
2008,3,WA14,Flechtstoffe usw. pflanzlichen Ursprungs,1030000,2345000,3375000
2008,3,WA15,"Tierische und pflanzliche Fette, Öle, Wachs",168654000,296681000,465335000
2008,3,WA16,"Zubereitungen von Fleisch, Fisch usw.",178480000,151683000,330163000
2008,3,WA17,Zucker und Zuckerwaren,94972000,109366000,204338000
2008,3,WA18,Kakao und Zubereitungen aus Kakao,166697000,157613000,324310000
2008,3,WA19,"Zubereitungen aus Getreide usw., Backwaren",317689000,195738000,513427000
2008,3,WA20,"Zubereitungen von Gemüse, Früchten usw.",172731000,315964000,488695000
2008,3,WA21,Verschiedene Lebensmittelzubereitungen,286086000,188082000,474168000
2008,3,WA22,"Getränke, alkoholhaltige Flüssigkeiten, Essig",305600000,371643000,677243000
2008,3,WA23,"Rückstände der Lebensmittelindustrie, Futter",175677000,180576000,356253000
2008,3,WA24,Tabak,271221000,104334000,375555000
2008,3,WA25,"Salz, Schwefel, Steine, Erden usw.",184523000,152544000,337067000
2008,3,WA26,"Erze, Schlacken, Aschen",26732000,471922000,498654000
2008,3,WA27,Mineralische Brennstoffe usw.,2467270000,8639598000,11106868000
2008,3,WA28,Anorganische chemische Erzeugnisse,683955000,448182000,1132137000
2008,3,WA29,Organische chemische Erzeugnisse,2057493000,1834547000,3892040000
2008,3,WA30,Pharmazeutische Erzeugnisse,3398879000,2385090000,5783969000
2008,3,WA31,Düngemittel,221682000,100223000,321905000
2008,3,WA32,"Gerb- und Farbstoffe, Farben, Lacke usw.",693540000,315479000,1009019000
2008,3,WA33,"Etherische Öle, Riech-, Schönheitsmittel",500808000,277600000,778408000
2008,3,WA34,"Seifen, Waschmittel usw.",383209000,166403000,549612000
2008,3,WA35,"Eiweißstoffe, Klebstoffe, Enzyme",169918000,124305000,294223000
2008,3,WA36,"Sprengstoffe, pyrotechnische Artikel usw.",19101000,12567000,31668000
2008,3,WA37,Photochemische Erzeugnisse,103217000,104403000,207620000
2008,3,WA38,Verschiedene Erzeugnisse der Chemischen Industrie,1347978000,894917000,2242895000
2008,3,WA39,Kunststoffe und Waren daraus,3903476000,2300194000,6203670000
2008,3,WA40,Kautschuk und Waren daraus,850245000,855312000,1705557000
2008,3,WA41,"Häute, Felle, Leder",77436000,75241000,152677000
2008,3,WA42,"Lederwaren, Sattlerwaren",103131000,161952000,265083000
2008,3,WA43,"Pelzfelle, künstliches Pelzwerk",12159000,9297000,21456000
2008,3,WA44,"Holz, Holzwaren, Holzkohle",635528000,516375000,1151903000
2008,3,WA45,"Kork, Korkwaren",3603000,13278000,16881000
2008,3,WA46,"Flechtwaren, Korbmacherwaren",3670000,7700000,11370000
2008,3,WA47,"Halbstoffe aus Holz usw., Papierabfall",96366000,308288000,404654000
2008,3,WA48,"Papier, Pappe und Waren daraus",1442608000,971034000,2413642000
2008,3,WA49,"Bücher, Zeitungen, Bilddrucke usw.",422180000,175396000,597576000
2008,3,WA50,Seide,6298000,6011000,12309000
2008,3,WA51,"Wolle, feine und grobe Tierhaare",58437000,70648000,129085000
2008,3,WA52,Baumwolle,90073000,86282000,176355000
2008,3,WA53,"Andere pflanzliche Spinnstoffe, Papiergarn",5498000,7035000,12533000
2008,3,WA54,Synthetisches oder künstliches Filament,210206000,137934000,348140000
2008,3,WA55,Synthetische oder künstliche Spinnfaser,144573000,122485000,267058000
2008,3,WA56,"Watte, Filz, Vliesstoff usw., Tauwerk",163011000,85399000,248410000
2008,3,WA57,"Teppiche, Fußbodenbelag aus Spinnstoff",42688000,88294000,130982000
2008,3,WA58,"Spezialgewebe, Spitzen, Tapisserien",44613000,27310000,71923000
2008,3,WA59,"Getränkte, bestrichene usw. Gewebe",155200000,100463000,255663000
2008,3,WA60,Gewirke und Gestricke,76919000,37136000,114055000
2008,3,WA61,"Bekleidung usw. aus Gewirken, Gestricken",477898000,772658000,1250556000
2008,3,WA62,"Andere Bekleidung, Bekleidungszubehör",740569000,979642000,1720211000
2008,3,WA63,"Andere Konfektion, Spinnstoffwaren usw.",123718000,186827000,310545000
2008,3,WA64,"Schuhe, Gamaschen, ähnliche Waren",258285000,456498000,714783000
2008,3,WA65,Kopfbedeckungen und Teile davon,25390000,25003000,50393000
2008,3,WA66,"Schirme, Gehstöcke usw., Peitschen",5906000,18339000,24245000
2008,3,WA67,"Zugerichtete Federn, Daunen, künstliche Blumen",4648000,5953000,10601000
2008,3,WA68,"Waren aus Steinen, Gips, Zement usw.",308744000,184774000,493518000
2008,3,WA69,Keramische Waren,267357000,157142000,424499000
2008,3,WA70,Glas und Glaswaren,392832000,339050000,731882000
2008,3,WA71,"Perlen, Edelsteine, Edelmetalle",747072000,837001000,1584073000
2008,3,WA72,Eisen und Stahl,2330089000,2404406000,4734495000
2008,3,WA73,Waren aus Eisen oder Stahl,2062410000,1365803000,3428213000
2008,3,WA74,Kupfer und Waren daraus,942712000,944276000,1886988000
2008,3,WA75,Nickel und Waren daraus,107691000,188752000,296443000
2008,3,WA76,Aluminium und Waren daraus,1112371000,1049145000,2161516000
2008,3,WA78,Blei und Waren daraus,40499000,31074000,71573000
2008,3,WA79,Zink und Waren daraus,58284000,74605000,132889000
2008,3,WA80,Zinn und Waren daraus,9664000,26776000,36440000
2008,3,WA81,"Andere unedle Metalle, Cermets usw.",100696000,138294000,238990000
2008,3,WA82,"Werkzeuge, Schneidwaren, Essbestecke",557878000,311341000,869219000
2008,3,WA83,Verschiedene Waren aus unedlen Metallen,516724000,287176000,803900000
2008,3,WA84,"Maschinen, Apparate, mechanische Geräte",15360000000,8723778000,24083778000
2008,3,WA85,Elektrotechnische Erzeugnisse,8403460000,7034140000,15437600000
2008,3,WA86,Schienenfahrzeuge,235531000,127423000,362954000
2008,3,WA87,"Kraftfahrzeuge, Landfahrzeuge",14598559000,6035464000,20634023000
2008,3,WA88,"Luftfahrzeuge, Raumfahrzeuge",1541625000,694936000,2236561000
2008,3,WA89,Wasserfahrzeuge,137068000,923721000,1060789000
2008,3,WA90,"Optische, photografische usw. Erzeugnisse",3243630000,1819913000,5063543000
2008,3,WA91,Uhrmacherwaren,94148000,88430000,182578000
2008,3,WA92,Musikinstrumente,37177000,27281000,64458000
2008,3,WA93,Waffen und Munition,27163000,12495000,39658000
2008,3,WA94,"Möbel, Beleuchtungskörper usw.",1003923000,919616000,1923539000
2008,3,WA95,"Spielzeug, Spiele usw., Sportgeräte",339477000,456252000,795729000
2008,3,WA96,Verschiedene Waren,152549000,89328000,241877000
2008,3,WA97,"Kunstgegenstände, Sammlungsstücke",32719000,24182000,56901000
2008,3,WA98,Vollständige Fabrikationsanlagen,250953000,2804000,253757000
2008,3,WA99,Zusammenstellungen verschiedener Waren,1198885000,943086000,2141971000
2008,4,WA01,Lebende Tiere,78804000,121281000,200085000
2008,4,WA02,Fleisch,509512000,395430000,904942000
2008,4,WA03,"Fische, Krebs- und Weichtiere",76632000,193398000,270030000
2008,4,WA04,"Milch, Milcherzeugnisse, Eier, Honig",535299000,427859000,963158000
2008,4,WA05,Andere Waren tierischen Ursprungs,43928000,53034000,96962000
2008,4,WA06,"Pflanzen, Waren des Blumenhandels",64830000,242236000,307066000
2008,4,WA07,"Gemüse, Pflanzen für Ernährung",71033000,455342000,526375000
2008,4,WA08,Genießbare Früchte und Nüsse,108886000,504788000,613674000
2008,4,WA09,"Kaffee, Tee, Mate, Gewürze",144473000,255993000,400466000
2008,4,WA10,Getreide,283420000,232642000,516062000
2008,4,WA11,"Müllereierzeugnisse, Malz usw.",89630000,40841000,130471000
2008,4,WA12,"Ölsamen usw., Heilpflanzen usw.",89704000,277285000,366989000
2008,4,WA13,"Schellack, Gummen, Harz, Pflanzensaft",42168000,30169000,72337000
2008,4,WA14,Flechtstoffe usw. pflanzlichen Ursprungs,669000,2012000,2681000
2008,4,WA15,"Tierische und pflanzliche Fette, Öle, Wachs",199227000,293172000,492399000
2008,4,WA16,"Zubereitungen von Fleisch, Fisch usw.",193664000,169154000,362818000
2008,4,WA17,Zucker und Zuckerwaren,104242000,122925000,227167000
2008,4,WA18,Kakao und Zubereitungen aus Kakao,146521000,150807000,297328000
2008,4,WA19,"Zubereitungen aus Getreide usw., Backwaren",344079000,195475000,539554000
2008,4,WA20,"Zubereitungen von Gemüse, Früchten usw.",184315000,315710000,500025000
2008,4,WA21,Verschiedene Lebensmittelzubereitungen,297679000,223056000,520735000
2008,4,WA22,"Getränke, alkoholhaltige Flüssigkeiten, Essig",352701000,429794000,782495000
2008,4,WA23,"Rückstände der Lebensmittelindustrie, Futter",213686000,236347000,450033000
2008,4,WA24,Tabak,257995000,118595000,376590000
2008,4,WA25,"Salz, Schwefel, Steine, Erden usw.",178300000,137354000,315654000
2008,4,WA26,"Erze, Schlacken, Aschen",22144000,523007000,545151000
2008,4,WA27,Mineralische Brennstoffe usw.,2364100000,9471185000,11835285000
2008,4,WA28,Anorganische chemische Erzeugnisse,669354000,424985000,1094339000
2008,4,WA29,Organische chemische Erzeugnisse,1971079000,1988105000,3959184000
2008,4,WA30,Pharmazeutische Erzeugnisse,3636766000,2618607000,6255373000
2008,4,WA31,Düngemittel,215502000,118538000,334040000
2008,4,WA32,"Gerb- und Farbstoffe, Farben, Lacke usw.",765660000,325758000,1091418000
2008,4,WA33,"Etherische Öle, Riech-, Schönheitsmittel",559049000,359022000,918071000
2008,4,WA34,"Seifen, Waschmittel usw.",448212000,233798000,682010000
2008,4,WA35,"Eiweißstoffe, Klebstoffe, Enzyme",165705000,136674000,302379000
2008,4,WA36,"Sprengstoffe, pyrotechnische Artikel usw.",17949000,13710000,31659000
2008,4,WA37,Photochemische Erzeugnisse,103617000,77892000,181509000
2008,4,WA38,Verschiedene Erzeugnisse der Chemischen Industrie,1342992000,922485000,2265477000
2008,4,WA39,Kunststoffe und Waren daraus,4089210000,2456624000,6545834000
2008,4,WA40,Kautschuk und Waren daraus,922142000,894800000,1816942000
2008,4,WA41,"Häute, Felle, Leder",80131000,77717000,157848000
2008,4,WA42,"Lederwaren, Sattlerwaren",99625000,167473000,267098000
2008,4,WA43,"Pelzfelle, künstliches Pelzwerk",14543000,12393000,26936000
2008,4,WA44,"Holz, Holzwaren, Holzkohle",696306000,524298000,1220604000
2008,4,WA45,"Kork, Korkwaren",3796000,10092000,13888000
2008,4,WA46,"Flechtwaren, Korbmacherwaren",3592000,9668000,13260000
2008,4,WA47,"Halbstoffe aus Holz usw., Papierabfall",91883000,282106000,373989000
2008,4,WA48,"Papier, Pappe und Waren daraus",1582415000,1018363000,2600778000
2008,4,WA49,"Bücher, Zeitungen, Bilddrucke usw.",381504000,153507000,535011000
2008,4,WA50,Seide,6957000,6485000,13442000
2008,4,WA51,"Wolle, feine und grobe Tierhaare",82270000,75318000,157588000
2008,4,WA52,Baumwolle,94712000,85716000,180428000
2008,4,WA53,"Andere pflanzliche Spinnstoffe, Papiergarn",4419000,5958000,10377000
2008,4,WA54,Synthetisches oder künstliches Filament,218896000,140099000,358995000
2008,4,WA55,Synthetische oder künstliche Spinnfaser,151197000,123926000,275123000
2008,4,WA56,"Watte, Filz, Vliesstoff usw., Tauwerk",169378000,104956000,274334000
2008,4,WA57,"Teppiche, Fußbodenbelag aus Spinnstoff",42518000,79633000,122151000
2008,4,WA58,"Spezialgewebe, Spitzen, Tapisserien",53511000,29010000,82521000
2008,4,WA59,"Getränkte, bestrichene usw. Gewebe",163733000,111739000,275472000
2008,4,WA60,Gewirke und Gestricke,84026000,45156000,129182000
2008,4,WA61,"Bekleidung usw. aus Gewirken, Gestricken",381626000,736808000,1118434000
2008,4,WA62,"Andere Bekleidung, Bekleidungszubehör",542979000,882110000,1425089000
2008,4,WA63,"Andere Konfektion, Spinnstoffwaren usw.",131312000,218872000,350184000
2008,4,WA64,"Schuhe, Gamaschen, ähnliche Waren",242616000,355582000,598198000
2008,4,WA65,Kopfbedeckungen und Teile davon,17532000,23768000,41300000
2008,4,WA66,"Schirme, Gehstöcke usw., Peitschen",6422000,18573000,24995000
2008,4,WA67,"Zugerichtete Federn, Daunen, künstliche Blumen",5931000,7564000,13495000
2008,4,WA68,"Waren aus Steinen, Gips, Zement usw.",300514000,183366000,483880000
2008,4,WA69,Keramische Waren,273376000,193029000,466405000
2008,4,WA70,Glas und Glaswaren,449362000,358618000,807980000
2008,4,WA71,"Perlen, Edelsteine, Edelmetalle",790375000,940131000,1730506000
2008,4,WA72,Eisen und Stahl,2543594000,2544883000,5088477000
2008,4,WA73,Waren aus Eisen oder Stahl,2298902000,1456939000,3755841000
2008,4,WA74,Kupfer und Waren daraus,1079826000,887070000,1966896000
2008,4,WA75,Nickel und Waren daraus,117333000,161470000,278803000
2008,4,WA76,Aluminium und Waren daraus,1161197000,1099982000,2261179000
2008,4,WA78,Blei und Waren daraus,38785000,21581000,60366000
2008,4,WA79,Zink und Waren daraus,55907000,86850000,142757000
2008,4,WA80,Zinn und Waren daraus,8357000,29487000,37844000
2008,4,WA81,"Andere unedle Metalle, Cermets usw.",99129000,130159000,229288000
2008,4,WA82,"Werkzeuge, Schneidwaren, Essbestecke",534541000,349036000,883577000
2008,4,WA83,Verschiedene Waren aus unedlen Metallen,567716000,316376000,884092000
2008,4,WA84,"Maschinen, Apparate, mechanische Geräte",16338543000,9129616000,25468159000
2008,4,WA85,Elektrotechnische Erzeugnisse,9030357000,7302399000,16332756000
2008,4,WA86,Schienenfahrzeuge,315244000,154527000,469771000
2008,4,WA87,"Kraftfahrzeuge, Landfahrzeuge",15832411000,6338162000,22170573000
2008,4,WA88,"Luftfahrzeuge, Raumfahrzeuge",1744964000,1691863000,3436827000
2008,4,WA89,Wasserfahrzeuge,751143000,130738000,881881000
2008,4,WA90,"Optische, photografische usw. Erzeugnisse",3392897000,1820769000,5213666000
2008,4,WA91,Uhrmacherwaren,68175000,92613000,160788000
2008,4,WA92,Musikinstrumente,35472000,27076000,62548000
2008,4,WA93,Waffen und Munition,28910000,13822000,42732000
2008,4,WA94,"Möbel, Beleuchtungskörper usw.",1061343000,1020842000,2082185000
2008,4,WA95,"Spielzeug, Spiele usw., Sportgeräte",503515000,583519000,1087034000
2008,4,WA96,Verschiedene Waren,183040000,94676000,277716000
2008,4,WA97,"Kunstgegenstände, Sammlungsstücke",45764000,31589000,77353000
2008,4,WA98,Vollständige Fabrikationsanlagen,330854000,4864000,335718000
2008,4,WA99,Zusammenstellungen verschiedener Waren,1510452000,1022844000,2533296000
2008,5,WA01,Lebende Tiere,58707000,93198000,151905000
2008,5,WA02,Fleisch,509233000,430069000,939302000
2008,5,WA03,"Fische, Krebs- und Weichtiere",82664000,200626000,283290000
2008,5,WA04,"Milch, Milcherzeugnisse, Eier, Honig",637090000,532647000,1169737000
2008,5,WA05,Andere Waren tierischen Ursprungs,49170000,51686000,100856000
2008,5,WA06,"Pflanzen, Waren des Blumenhandels",78932000,312496000,391428000
2008,5,WA07,"Gemüse, Pflanzen für Ernährung",76864000,446407000,523271000
2008,5,WA08,Genießbare Früchte und Nüsse,100884000,521996000,622880000
2008,5,WA09,"Kaffee, Tee, Mate, Gewürze",131436000,202080000,333516000
2008,5,WA10,Getreide,242045000,187278000,429323000
2008,5,WA11,"Müllereierzeugnisse, Malz usw.",77126000,40507000,117633000
2008,5,WA12,"Ölsamen usw., Heilpflanzen usw.",83077000,250142000,333219000
2008,5,WA13,"Schellack, Gummen, Harz, Pflanzensaft",38603000,27831000,66434000
2008,5,WA14,Flechtstoffe usw. pflanzlichen Ursprungs,1417000,2460000,3877000
2008,5,WA15,"Tierische und pflanzliche Fette, Öle, Wachs",164879000,274383000,439262000
2008,5,WA16,"Zubereitungen von Fleisch, Fisch usw.",178163000,185551000,363714000
2008,5,WA17,Zucker und Zuckerwaren,100660000,110793000,211453000
2008,5,WA18,Kakao und Zubereitungen aus Kakao,165792000,144365000,310157000
2008,5,WA19,"Zubereitungen aus Getreide usw., Backwaren",318919000,198965000,517884000
2008,5,WA20,"Zubereitungen von Gemüse, Früchten usw.",180895000,334933000,515828000
2008,5,WA21,Verschiedene Lebensmittelzubereitungen,357389000,218078000,575467000
2008,5,WA22,"Getränke, alkoholhaltige Flüssigkeiten, Essig",369863000,419093000,788956000
2008,5,WA23,"Rückstände der Lebensmittelindustrie, Futter",208994000,231794000,440788000
2008,5,WA24,Tabak,271311000,101167000,372478000
2008,5,WA25,"Salz, Schwefel, Steine, Erden usw.",211856000,144787000,356643000
2008,5,WA26,"Erze, Schlacken, Aschen",21715000,548571000,570286000
2008,5,WA27,Mineralische Brennstoffe usw.,2176503000,8974322000,11150825000
2008,5,WA28,Anorganische chemische Erzeugnisse,624998000,424316000,1049314000
2008,5,WA29,Organische chemische Erzeugnisse,1839982000,1789595000,3629577000
2008,5,WA30,Pharmazeutische Erzeugnisse,3202320000,2269980000,5472300000
2008,5,WA31,Düngemittel,237244000,149760000,387004000
2008,5,WA32,"Gerb- und Farbstoffe, Farben, Lacke usw.",701012000,306380000,1007392000
2008,5,WA33,"Etherische Öle, Riech-, Schönheitsmittel",514863000,298988000,813851000
2008,5,WA34,"Seifen, Waschmittel usw.",420003000,187503000,607506000
2008,5,WA35,"Eiweißstoffe, Klebstoffe, Enzyme",176512000,126546000,303058000
2008,5,WA36,"Sprengstoffe, pyrotechnische Artikel usw.",17198000,12318000,29516000
2008,5,WA37,Photochemische Erzeugnisse,97923000,63982000,161905000
2008,5,WA38,Verschiedene Erzeugnisse der Chemischen Industrie,1201773000,820369000,2022142000
2008,5,WA39,Kunststoffe und Waren daraus,3866904000,2314327000,6181231000
2008,5,WA40,Kautschuk und Waren daraus,856269000,829978000,1686247000
2008,5,WA41,"Häute, Felle, Leder",80864000,70964000,151828000
2008,5,WA42,"Lederwaren, Sattlerwaren",87441000,179826000,267267000
2008,5,WA43,"Pelzfelle, künstliches Pelzwerk",15888000,13092000,28980000
2008,5,WA44,"Holz, Holzwaren, Holzkohle",650235000,463776000,1114011000
2008,5,WA45,"Kork, Korkwaren",3356000,9076000,12432000
2008,5,WA46,"Flechtwaren, Korbmacherwaren",2835000,10740000,13575000
2008,5,WA47,"Halbstoffe aus Holz usw., Papierabfall",80146000,256569000,336715000
2008,5,WA48,"Papier, Pappe und Waren daraus",1467531000,974579000,2442110000
2008,5,WA49,"Bücher, Zeitungen, Bilddrucke usw.",341263000,177369000,518632000
2008,5,WA50,Seide,7297000,6883000,14180000
2008,5,WA51,"Wolle, feine und grobe Tierhaare",80038000,74564000,154602000
2008,5,WA52,Baumwolle,96938000,91656000,188594000
2008,5,WA53,"Andere pflanzliche Spinnstoffe, Papiergarn",3843000,5775000,9618000
2008,5,WA54,Synthetisches oder künstliches Filament,205717000,133290000,339007000
2008,5,WA55,Synthetische oder künstliche Spinnfaser,145527000,124443000,269970000
2008,5,WA56,"Watte, Filz, Vliesstoff usw., Tauwerk",167536000,88066000,255602000
2008,5,WA57,"Teppiche, Fußbodenbelag aus Spinnstoff",42462000,78573000,121035000
2008,5,WA58,"Spezialgewebe, Spitzen, Tapisserien",46208000,28210000,74418000
2008,5,WA59,"Getränkte, bestrichene usw. Gewebe",144657000,107219000,251876000
2008,5,WA60,Gewirke und Gestricke,78086000,38453000,116539000
2008,5,WA61,"Bekleidung usw. aus Gewirken, Gestricken",347880000,695047000,1042927000
2008,5,WA62,"Andere Bekleidung, Bekleidungszubehör",393498000,758737000,1152235000
2008,5,WA63,"Andere Konfektion, Spinnstoffwaren usw.",134731000,224377000,359108000
2008,5,WA64,"Schuhe, Gamaschen, ähnliche Waren",196104000,350070000,546174000
2008,5,WA65,Kopfbedeckungen und Teile davon,16750000,23057000,39807000
2008,5,WA66,"Schirme, Gehstöcke usw., Peitschen",7120000,20968000,28088000
2008,5,WA67,"Zugerichtete Federn, Daunen, künstliche Blumen",3793000,9834000,13627000
2008,5,WA68,"Waren aus Steinen, Gips, Zement usw.",282109000,186708000,468817000
2008,5,WA69,Keramische Waren,268397000,182642000,451039000
2008,5,WA70,Glas und Glaswaren,381325000,373903000,755228000
2008,5,WA71,"Perlen, Edelsteine, Edelmetalle",699082000,829824000,1528906000
2008,5,WA72,Eisen und Stahl,2606371000,2762585000,5368956000
2008,5,WA73,Waren aus Eisen oder Stahl,2151097000,1435533000,3586630000
2008,5,WA74,Kupfer und Waren daraus,946425000,966787000,1913212000
2008,5,WA75,Nickel und Waren daraus,115182000,123555000,238737000
2008,5,WA76,Aluminium und Waren daraus,1047998000,1083242000,2131240000
2008,5,WA78,Blei und Waren daraus,43490000,22457000,65947000
2008,5,WA79,Zink und Waren daraus,55143000,77470000,132613000
2008,5,WA80,Zinn und Waren daraus,9814000,36792000,46606000
2008,5,WA81,"Andere unedle Metalle, Cermets usw.",98146000,146743000,244889000
2008,5,WA82,"Werkzeuge, Schneidwaren, Essbestecke",519375000,325987000,845362000
2008,5,WA83,Verschiedene Waren aus unedlen Metallen,532127000,304962000,837089000
2008,5,WA84,"Maschinen, Apparate, mechanische Geräte",14929309000,8293624000,23222933000
2008,5,WA85,Elektrotechnische Erzeugnisse,7956848000,6439298000,14396146000
2008,5,WA86,Schienenfahrzeuge,267485000,120485000,387970000
2008,5,WA87,"Kraftfahrzeuge, Landfahrzeuge",13232401000,5973081000,19205482000
2008,5,WA88,"Luftfahrzeuge, Raumfahrzeuge",1463618000,989122000,2452740000
2008,5,WA89,Wasserfahrzeuge,533367000,550541000,1083908000
2008,5,WA90,"Optische, photografische usw. Erzeugnisse",2956607000,1705486000,4662093000
2008,5,WA91,Uhrmacherwaren,67941000,100850000,168791000
2008,5,WA92,Musikinstrumente,30590000,29995000,60585000
2008,5,WA93,Waffen und Munition,27246000,11651000,38897000
2008,5,WA94,"Möbel, Beleuchtungskörper usw.",995829000,990682000,1986511000
2008,5,WA95,"Spielzeug, Spiele usw., Sportgeräte",188804000,476609000,665413000
2008,5,WA96,Verschiedene Waren,156553000,102242000,258795000
2008,5,WA97,"Kunstgegenstände, Sammlungsstücke",45911000,31958000,77869000
2008,5,WA98,Vollständige Fabrikationsanlagen,319192000,3007000,322199000
2008,5,WA99,Zusammenstellungen verschiedener Waren,1306278000,888691000,2194969000
2008,6,WA01,Lebende Tiere,80844000,120711000,201555000
2008,6,WA02,Fleisch,547962000,427285000,975247000
2008,6,WA03,"Fische, Krebs- und Weichtiere",86325000,164928000,251253000
2008,6,WA04,"Milch, Milcherzeugnisse, Eier, Honig",578478000,437102000,1015580000
2008,6,WA05,Andere Waren tierischen Ursprungs,46910000,64421000,111331000
2008,6,WA06,"Pflanzen, Waren des Blumenhandels",50438000,201674000,252112000
2008,6,WA07,"Gemüse, Pflanzen für Ernährung",72042000,379329000,451371000
2008,6,WA08,Genießbare Früchte und Nüsse,127200000,531587000,658787000
2008,6,WA09,"Kaffee, Tee, Mate, Gewürze",129586000,222473000,352059000
2008,6,WA10,Getreide,209557000,161934000,371491000
2008,6,WA11,"Müllereierzeugnisse, Malz usw.",95792000,48737000,144529000
2008,6,WA12,"Ölsamen usw., Heilpflanzen usw.",75153000,305174000,380327000
2008,6,WA13,"Schellack, Gummen, Harz, Pflanzensaft",41652000,24968000,66620000
2008,6,WA14,Flechtstoffe usw. pflanzlichen Ursprungs,991000,2289000,3280000
2008,6,WA15,"Tierische und pflanzliche Fette, Öle, Wachs",191395000,260354000,451749000
2008,6,WA16,"Zubereitungen von Fleisch, Fisch usw.",196766000,163207000,359973000
2008,6,WA17,Zucker und Zuckerwaren,110116000,124253000,234369000
2008,6,WA18,Kakao und Zubereitungen aus Kakao,141569000,155237000,296806000
2008,6,WA19,"Zubereitungen aus Getreide usw., Backwaren",341849000,202606000,544455000
2008,6,WA20,"Zubereitungen von Gemüse, Früchten usw.",216165000,325607000,541772000
2008,6,WA21,Verschiedene Lebensmittelzubereitungen,311444000,219591000,531035000
2008,6,WA22,"Getränke, alkoholhaltige Flüssigkeiten, Essig",387952000,439544000,827496000
2008,6,WA23,"Rückstände der Lebensmittelindustrie, Futter",210067000,200886000,410953000
2008,6,WA24,Tabak,328539000,130004000,458543000
2008,6,WA25,"Salz, Schwefel, Steine, Erden usw.",209063000,156809000,365872000
2008,6,WA26,"Erze, Schlacken, Aschen",25763000,459836000,485599000
2008,6,WA27,Mineralische Brennstoffe usw.,2666270000,9362489000,12028759000
2008,6,WA28,Anorganische chemische Erzeugnisse,596299000,474435000,1070734000
2008,6,WA29,Organische chemische Erzeugnisse,2673392000,2097838000,4771230000
2008,6,WA30,Pharmazeutische Erzeugnisse,3562673000,2651560000,6214233000
2008,6,WA31,Düngemittel,243734000,152829000,396563000
2008,6,WA32,"Gerb- und Farbstoffe, Farben, Lacke usw.",760264000,334131000,1094395000
2008,6,WA33,"Etherische Öle, Riech-, Schönheitsmittel",574633000,330725000,905358000
2008,6,WA34,"Seifen, Waschmittel usw.",455647000,192229000,647876000
2008,6,WA35,"Eiweißstoffe, Klebstoffe, Enzyme",202066000,135082000,337148000
2008,6,WA36,"Sprengstoffe, pyrotechnische Artikel usw.",21454000,14546000,36000000
2008,6,WA37,Photochemische Erzeugnisse,115282000,61438000,176720000
2008,6,WA38,Verschiedene Erzeugnisse der Chemischen Industrie,1205426000,856277000,2061703000
2008,6,WA39,Kunststoffe und Waren daraus,4086845000,2391086000,6477931000
2008,6,WA40,Kautschuk und Waren daraus,877928000,822266000,1700194000
2008,6,WA41,"Häute, Felle, Leder",89966000,66254000,156220000
2008,6,WA42,"Lederwaren, Sattlerwaren",98814000,194351000,293165000
2008,6,WA43,"Pelzfelle, künstliches Pelzwerk",16005000,15220000,31225000
2008,6,WA44,"Holz, Holzwaren, Holzkohle",693043000,461584000,1154627000
2008,6,WA45,"Kork, Korkwaren",2755000,7642000,10397000
2008,6,WA46,"Flechtwaren, Korbmacherwaren",3423000,10101000,13524000
2008,6,WA47,"Halbstoffe aus Holz usw., Papierabfall",108307000,304917000,413224000
2008,6,WA48,"Papier, Pappe und Waren daraus",1565307000,977283000,2542590000
2008,6,WA49,"Bücher, Zeitungen, Bilddrucke usw.",399690000,169410000,569100000
2008,6,WA50,Seide,7237000,6498000,13735000
2008,6,WA51,"Wolle, feine und grobe Tierhaare",70730000,77064000,147794000
2008,6,WA52,Baumwolle,89463000,85326000,174789000
2008,6,WA53,"Andere pflanzliche Spinnstoffe, Papiergarn",3487000,4983000,8470000
2008,6,WA54,Synthetisches oder künstliches Filament,209924000,136560000,346484000
2008,6,WA55,Synthetische oder künstliche Spinnfaser,172453000,125231000,297684000
2008,6,WA56,"Watte, Filz, Vliesstoff usw., Tauwerk",179644000,91054000,270698000
2008,6,WA57,"Teppiche, Fußbodenbelag aus Spinnstoff",42688000,80193000,122881000
2008,6,WA58,"Spezialgewebe, Spitzen, Tapisserien",45345000,27641000,72986000
2008,6,WA59,"Getränkte, bestrichene usw. Gewebe",156477000,103717000,260194000
2008,6,WA60,Gewirke und Gestricke,76565000,37382000,113947000
2008,6,WA61,"Bekleidung usw. aus Gewirken, Gestricken",345524000,768825000,1114349000
2008,6,WA62,"Andere Bekleidung, Bekleidungszubehör",417424000,823904000,1241328000
2008,6,WA63,"Andere Konfektion, Spinnstoffwaren usw.",133919000,197404000,331323000
2008,6,WA64,"Schuhe, Gamaschen, ähnliche Waren",190267000,375964000,566231000
2008,6,WA65,Kopfbedeckungen und Teile davon,17318000,23243000,40561000
2008,6,WA66,"Schirme, Gehstöcke usw., Peitschen",10265000,11133000,21398000
2008,6,WA67,"Zugerichtete Federn, Daunen, künstliche Blumen",4706000,11183000,15889000
2008,6,WA68,"Waren aus Steinen, Gips, Zement usw.",319760000,201425000,521185000
2008,6,WA69,Keramische Waren,244250000,175127000,419377000
2008,6,WA70,Glas und Glaswaren,436493000,312730000,749223000
2008,6,WA71,"Perlen, Edelsteine, Edelmetalle",810746000,995727000,1806473000
2008,6,WA72,Eisen und Stahl,2611562000,2902542000,5514104000
2008,6,WA73,Waren aus Eisen oder Stahl,2329025000,1461210000,3790235000
2008,6,WA74,Kupfer und Waren daraus,872229000,1073480000,1945709000
2008,6,WA75,Nickel und Waren daraus,111838000,160036000,271874000
2008,6,WA76,Aluminium und Waren daraus,1131902000,1082991000,2214893000
2008,6,WA78,Blei und Waren daraus,37097000,40374000,77471000
2008,6,WA79,Zink und Waren daraus,51750000,65982000,117732000
2008,6,WA80,Zinn und Waren daraus,8294000,34627000,42921000
2008,6,WA81,"Andere unedle Metalle, Cermets usw.",103649000,145015000,248664000
2008,6,WA82,"Werkzeuge, Schneidwaren, Essbestecke",532772000,328329000,861101000
2008,6,WA83,Verschiedene Waren aus unedlen Metallen,571431000,318396000,889827000
2008,6,WA84,"Maschinen, Apparate, mechanische Geräte",16498055000,8639145000,25137200000
2008,6,WA85,Elektrotechnische Erzeugnisse,8562368000,6603306000,15165674000
2008,6,WA86,Schienenfahrzeuge,284107000,133874000,417981000
2008,6,WA87,"Kraftfahrzeuge, Landfahrzeuge",14793765000,5992911000,20786676000
2008,6,WA88,"Luftfahrzeuge, Raumfahrzeuge",1690431000,1227112000,2917543000
2008,6,WA89,Wasserfahrzeuge,316088000,136921000,453009000
2008,6,WA90,"Optische, photografische usw. Erzeugnisse",3404833000,1809305000,5214138000
2008,6,WA91,Uhrmacherwaren,83806000,96546000,180352000
2008,6,WA92,Musikinstrumente,39577000,25056000,64633000
2008,6,WA93,Waffen und Munition,39097000,15119000,54216000
2008,6,WA94,"Möbel, Beleuchtungskörper usw.",1047390000,951430000,1998820000
2008,6,WA95,"Spielzeug, Spiele usw., Sportgeräte",631633000,562159000,1193792000
2008,6,WA96,Verschiedene Waren,164638000,104050000,268688000
2008,6,WA97,"Kunstgegenstände, Sammlungsstücke",44871000,31049000,75920000
2008,6,WA98,Vollständige Fabrikationsanlagen,404260000,2576000,406836000
2008,6,WA99,Zusammenstellungen verschiedener Waren,1180272000,973285000,2153557000
2008,7,WA01,Lebende Tiere,78305000,109498000,187803000
2008,7,WA02,Fleisch,523907000,410615000,934522000
2008,7,WA03,"Fische, Krebs- und Weichtiere",66904000,193491000,260395000
2008,7,WA04,"Milch, Milcherzeugnisse, Eier, Honig",599510000,528586000,1128096000
2008,7,WA05,Andere Waren tierischen Ursprungs,49470000,68060000,117530000
2008,7,WA06,"Pflanzen, Waren des Blumenhandels",38335000,175663000,213998000
2008,7,WA07,"Gemüse, Pflanzen für Ernährung",73513000,350305000,423818000
2008,7,WA08,Genießbare Früchte und Nüsse,103081000,604404000,707485000
2008,7,WA09,"Kaffee, Tee, Mate, Gewürze",128647000,227125000,355772000
2008,7,WA10,Getreide,193008000,130048000,323056000
2008,7,WA11,"Müllereierzeugnisse, Malz usw.",70505000,40023000,110528000
2008,7,WA12,"Ölsamen usw., Heilpflanzen usw.",80636000,299494000,380130000
2008,7,WA13,"Schellack, Gummen, Harz, Pflanzensaft",48215000,33171000,81386000
2008,7,WA14,Flechtstoffe usw. pflanzlichen Ursprungs,892000,2573000,3465000
2008,7,WA15,"Tierische und pflanzliche Fette, Öle, Wachs",170508000,289162000,459670000
2008,7,WA16,"Zubereitungen von Fleisch, Fisch usw.",196145000,146906000,343051000
2008,7,WA17,Zucker und Zuckerwaren,101142000,118005000,219147000
2008,7,WA18,Kakao und Zubereitungen aus Kakao,189710000,180572000,370282000
2008,7,WA19,"Zubereitungen aus Getreide usw., Backwaren",297330000,214050000,511380000
2008,7,WA20,"Zubereitungen von Gemüse, Früchten usw.",178009000,303908000,481917000
2008,7,WA21,Verschiedene Lebensmittelzubereitungen,334240000,215706000,549946000
2008,7,WA22,"Getränke, alkoholhaltige Flüssigkeiten, Essig",374437000,455136000,829573000
2008,7,WA23,"Rückstände der Lebensmittelindustrie, Futter",211764000,229304000,441068000
2008,7,WA24,Tabak,339479000,125905000,465384000
2008,7,WA25,"Salz, Schwefel, Steine, Erden usw.",203111000,149338000,352449000
2008,7,WA26,"Erze, Schlacken, Aschen",26115000,735846000,761961000
2008,7,WA27,Mineralische Brennstoffe usw.,2534593000,11133666000,13668259000
2008,7,WA28,Anorganische chemische Erzeugnisse,719993000,725006000,1444999000
2008,7,WA29,Organische chemische Erzeugnisse,2173526000,1916937000,4090463000
2008,7,WA30,Pharmazeutische Erzeugnisse,4006374000,2853973000,6860347000
2008,7,WA31,Düngemittel,265883000,131810000,397693000
2008,7,WA32,"Gerb- und Farbstoffe, Farben, Lacke usw.",778229000,335809000,1114038000
2008,7,WA33,"Etherische Öle, Riech-, Schönheitsmittel",561414000,346323000,907737000
2008,7,WA34,"Seifen, Waschmittel usw.",453174000,234438000,687612000
2008,7,WA35,"Eiweißstoffe, Klebstoffe, Enzyme",176887000,134617000,311504000
2008,7,WA36,"Sprengstoffe, pyrotechnische Artikel usw.",15998000,15135000,31133000
2008,7,WA37,Photochemische Erzeugnisse,99975000,78834000,178809000
2008,7,WA38,Verschiedene Erzeugnisse der Chemischen Industrie,1336946000,926360000,2263306000
2008,7,WA39,Kunststoffe und Waren daraus,4035056000,2407579000,6442635000
2008,7,WA40,Kautschuk und Waren daraus,875397000,826280000,1701677000
2008,7,WA41,"Häute, Felle, Leder",61261000,58869000,120130000
2008,7,WA42,"Lederwaren, Sattlerwaren",129897000,231691000,361588000
2008,7,WA43,"Pelzfelle, künstliches Pelzwerk",16522000,20842000,37364000
2008,7,WA44,"Holz, Holzwaren, Holzkohle",615693000,444738000,1060431000
2008,7,WA45,"Kork, Korkwaren",4198000,11613000,15811000
2008,7,WA46,"Flechtwaren, Korbmacherwaren",3693000,12698000,16391000
2008,7,WA47,"Halbstoffe aus Holz usw., Papierabfall",99231000,279735000,378966000
2008,7,WA48,"Papier, Pappe und Waren daraus",1561721000,1042309000,2604030000
2008,7,WA49,"Bücher, Zeitungen, Bilddrucke usw.",419301000,165073000,584374000
2008,7,WA50,Seide,6758000,7466000,14224000
2008,7,WA51,"Wolle, feine und grobe Tierhaare",75073000,69604000,144677000
2008,7,WA52,Baumwolle,86639000,78582000,165221000
2008,7,WA53,"Andere pflanzliche Spinnstoffe, Papiergarn",2889000,5856000,8745000
2008,7,WA54,Synthetisches oder künstliches Filament,180313000,122981000,303294000
2008,7,WA55,Synthetische oder künstliche Spinnfaser,143847000,101024000,244871000
2008,7,WA56,"Watte, Filz, Vliesstoff usw., Tauwerk",168546000,94183000,262729000
2008,7,WA57,"Teppiche, Fußbodenbelag aus Spinnstoff",44186000,68961000,113147000
2008,7,WA58,"Spezialgewebe, Spitzen, Tapisserien",42706000,25713000,68419000
2008,7,WA59,"Getränkte, bestrichene usw. Gewebe",142249000,103932000,246181000
2008,7,WA60,Gewirke und Gestricke,66250000,34911000,101161000
2008,7,WA61,"Bekleidung usw. aus Gewirken, Gestricken",464569000,1018979000,1483548000
2008,7,WA62,"Andere Bekleidung, Bekleidungszubehör",618239000,1106962000,1725201000
2008,7,WA63,"Andere Konfektion, Spinnstoffwaren usw.",138253000,217901000,356154000
2008,7,WA64,"Schuhe, Gamaschen, ähnliche Waren",281005000,542153000,823158000
2008,7,WA65,Kopfbedeckungen und Teile davon,18172000,29539000,47711000
2008,7,WA66,"Schirme, Gehstöcke usw., Peitschen",9995000,11798000,21793000
2008,7,WA67,"Zugerichtete Federn, Daunen, künstliche Blumen",4265000,14064000,18329000
2008,7,WA68,"Waren aus Steinen, Gips, Zement usw.",289836000,197393000,487229000
2008,7,WA69,Keramische Waren,289420000,176367000,465787000
2008,7,WA70,Glas und Glaswaren,419421000,319746000,739167000
2008,7,WA71,"Perlen, Edelsteine, Edelmetalle",755570000,839191000,1594761000
2008,7,WA72,Eisen und Stahl,2522449000,2984672000,5507121000
2008,7,WA73,Waren aus Eisen oder Stahl,2308766000,1599470000,3908236000
2008,7,WA74,Kupfer und Waren daraus,928748000,867401000,1796149000
2008,7,WA75,Nickel und Waren daraus,79242000,208537000,287779000
2008,7,WA76,Aluminium und Waren daraus,1074369000,1135203000,2209572000
2008,7,WA78,Blei und Waren daraus,30336000,21985000,52321000
2008,7,WA79,Zink und Waren daraus,50162000,82791000,132953000
2008,7,WA80,Zinn und Waren daraus,8209000,28211000,36420000
2008,7,WA81,"Andere unedle Metalle, Cermets usw.",79373000,145574000,224947000
2008,7,WA82,"Werkzeuge, Schneidwaren, Essbestecke",531783000,340443000,872226000
2008,7,WA83,Verschiedene Waren aus unedlen Metallen,541656000,305713000,847369000
2008,7,WA84,"Maschinen, Apparate, mechanische Geräte",16373762000,8930027000,25303789000
2008,7,WA85,Elektrotechnische Erzeugnisse,8432140000,7236904000,15669044000
2008,7,WA86,Schienenfahrzeuge,267301000,154291000,421592000
2008,7,WA87,"Kraftfahrzeuge, Landfahrzeuge",13847469000,5506588000,19354057000
2008,7,WA88,"Luftfahrzeuge, Raumfahrzeuge",1490179000,1401506000,2891685000
2008,7,WA89,Wasserfahrzeuge,485218000,735295000,1220513000
2008,7,WA90,"Optische, photografische usw. Erzeugnisse",3336751000,1721385000,5058136000
2008,7,WA91,Uhrmacherwaren,93246000,102952000,196198000
2008,7,WA92,Musikinstrumente,36239000,32935000,69174000
2008,7,WA93,Waffen und Munition,31818000,12221000,44039000
2008,7,WA94,"Möbel, Beleuchtungskörper usw.",1027759000,911628000,1939387000
2008,7,WA95,"Spielzeug, Spiele usw., Sportgeräte",550492000,583836000,1134328000
2008,7,WA96,Verschiedene Waren,172642000,105915000,278557000
2008,7,WA97,"Kunstgegenstände, Sammlungsstücke",47199000,41389000,88588000
2008,7,WA98,Vollständige Fabrikationsanlagen,479117000,2337000,481454000
2008,7,WA99,Zusammenstellungen verschiedener Waren,1370511000,870579000,2241090000
2008,8,WA01,Lebende Tiere,74808000,147967000,222775000
2008,8,WA02,Fleisch,515038000,430860000,945898000
2008,8,WA03,"Fische, Krebs- und Weichtiere",71577000,174047000,245624000
2008,8,WA04,"Milch, Milcherzeugnisse, Eier, Honig",594199000,449656000,1043855000
2008,8,WA05,Andere Waren tierischen Ursprungs,50704000,57693000,108397000
2008,8,WA06,"Pflanzen, Waren des Blumenhandels",35400000,170862000,206262000
2008,8,WA07,"Gemüse, Pflanzen für Ernährung",66535000,249457000,315992000
2008,8,WA08,Genießbare Früchte und Nüsse,91135000,519253000,610388000
2008,8,WA09,"Kaffee, Tee, Mate, Gewürze",117333000,206733000,324066000
2008,8,WA10,Getreide,141387000,117767000,259154000
2008,8,WA11,"Müllereierzeugnisse, Malz usw.",89406000,42344000,131750000
2008,8,WA12,"Ölsamen usw., Heilpflanzen usw.",76440000,311281000,387721000
2008,8,WA13,"Schellack, Gummen, Harz, Pflanzensaft",34562000,24921000,59483000
2008,8,WA14,Flechtstoffe usw. pflanzlichen Ursprungs,1258000,1829000,3087000
2008,8,WA15,"Tierische und pflanzliche Fette, Öle, Wachs",155325000,302823000,458148000
2008,8,WA16,"Zubereitungen von Fleisch, Fisch usw.",216845000,155305000,372150000
2008,8,WA17,Zucker und Zuckerwaren,102178000,107009000,209187000
2008,8,WA18,Kakao und Zubereitungen aus Kakao,203944000,186742000,390686000
2008,8,WA19,"Zubereitungen aus Getreide usw., Backwaren",387451000,193786000,581237000
2008,8,WA20,"Zubereitungen von Gemüse, Früchten usw.",175912000,328165000,504077000
2008,8,WA21,Verschiedene Lebensmittelzubereitungen,298931000,192491000,491422000
2008,8,WA22,"Getränke, alkoholhaltige Flüssigkeiten, Essig",380398000,367242000,747640000
2008,8,WA23,"Rückstände der Lebensmittelindustrie, Futter",208216000,212909000,421125000
2008,8,WA24,Tabak,264796000,110859000,375655000
2008,8,WA25,"Salz, Schwefel, Steine, Erden usw.",184223000,158258000,342481000
2008,8,WA26,"Erze, Schlacken, Aschen",22905000,555438000,578343000
2008,8,WA27,Mineralische Brennstoffe usw.,1983526000,10292079000,12275605000
2008,8,WA28,Anorganische chemische Erzeugnisse,615896000,500345000,1116241000
2008,8,WA29,Organische chemische Erzeugnisse,2232651000,1938440000,4171091000
2008,8,WA30,Pharmazeutische Erzeugnisse,3562181000,2289982000,5852163000
2008,8,WA31,Düngemittel,257764000,145774000,403538000
2008,8,WA32,"Gerb- und Farbstoffe, Farben, Lacke usw.",657461000,289551000,947012000
2008,8,WA33,"Etherische Öle, Riech-, Schönheitsmittel",526148000,353673000,879821000
2008,8,WA34,"Seifen, Waschmittel usw.",402876000,180326000,583202000
2008,8,WA35,"Eiweißstoffe, Klebstoffe, Enzyme",160578000,119920000,280498000
2008,8,WA36,"Sprengstoffe, pyrotechnische Artikel usw.",15440000,19846000,35286000
2008,8,WA37,Photochemische Erzeugnisse,83613000,59391000,143004000
2008,8,WA38,Verschiedene Erzeugnisse der Chemischen Industrie,1161609000,817614000,1979223000
2008,8,WA39,Kunststoffe und Waren daraus,3601721000,2248979000,5850700000
2008,8,WA40,Kautschuk und Waren daraus,779549000,764602000,1544151000
2008,8,WA41,"Häute, Felle, Leder",42256000,43123000,85379000
2008,8,WA42,"Lederwaren, Sattlerwaren",125088000,204024000,329112000
2008,8,WA43,"Pelzfelle, künstliches Pelzwerk",17123000,15677000,32800000
2008,8,WA44,"Holz, Holzwaren, Holzkohle",552791000,401020000,953811000
2008,8,WA45,"Kork, Korkwaren",3522000,8920000,12442000
2008,8,WA46,"Flechtwaren, Korbmacherwaren",3755000,10092000,13847000
2008,8,WA47,"Halbstoffe aus Holz usw., Papierabfall",82189000,255389000,337578000
2008,8,WA48,"Papier, Pappe und Waren daraus",1463474000,958867000,2422341000
2008,8,WA49,"Bücher, Zeitungen, Bilddrucke usw.",415578000,177401000,592979000
2008,8,WA50,Seide,4258000,4624000,8882000
2008,8,WA51,"Wolle, feine und grobe Tierhaare",41928000,41579000,83507000
2008,8,WA52,Baumwolle,63887000,61247000,125134000
2008,8,WA53,"Andere pflanzliche Spinnstoffe, Papiergarn",2437000,5253000,7690000
2008,8,WA54,Synthetisches oder künstliches Filament,159032000,109242000,268274000
2008,8,WA55,Synthetische oder künstliche Spinnfaser,122125000,101677000,223802000
2008,8,WA56,"Watte, Filz, Vliesstoff usw., Tauwerk",150115000,83817000,233932000
2008,8,WA57,"Teppiche, Fußbodenbelag aus Spinnstoff",42414000,62365000,104779000
2008,8,WA58,"Spezialgewebe, Spitzen, Tapisserien",35440000,24544000,59984000
2008,8,WA59,"Getränkte, bestrichene usw. Gewebe",131173000,95803000,226976000
2008,8,WA60,Gewirke und Gestricke,49681000,26463000,76144000
2008,8,WA61,"Bekleidung usw. aus Gewirken, Gestricken",563966000,985421000,1549387000
2008,8,WA62,"Andere Bekleidung, Bekleidungszubehör",778170000,1105933000,1884103000
2008,8,WA63,"Andere Konfektion, Spinnstoffwaren usw.",122044000,196303000,318347000
2008,8,WA64,"Schuhe, Gamaschen, ähnliche Waren",301061000,506542000,807603000
2008,8,WA65,Kopfbedeckungen und Teile davon,23915000,29218000,53133000
2008,8,WA66,"Schirme, Gehstöcke usw., Peitschen",9011000,10079000,19090000
2008,8,WA67,"Zugerichtete Federn, Daunen, künstliche Blumen",5192000,13169000,18361000
2008,8,WA68,"Waren aus Steinen, Gips, Zement usw.",311490000,189317000,500807000
2008,8,WA69,Keramische Waren,242614000,169808000,412422000
2008,8,WA70,Glas und Glaswaren,412031000,295525000,707556000
2008,8,WA71,"Perlen, Edelsteine, Edelmetalle",725955000,726385000,1452340000
2008,8,WA72,Eisen und Stahl,2282576000,2534270000,4816846000
2008,8,WA73,Waren aus Eisen oder Stahl,2057699000,1328724000,3386423000
2008,8,WA74,Kupfer und Waren daraus,712074000,843763000,1555837000
2008,8,WA75,Nickel und Waren daraus,87731000,144328000,232059000
2008,8,WA76,Aluminium und Waren daraus,993787000,1079583000,2073370000
2008,8,WA78,Blei und Waren daraus,31656000,13628000,45284000
2008,8,WA79,Zink und Waren daraus,40833000,76634000,117467000
2008,8,WA80,Zinn und Waren daraus,10659000,37453000,48112000
2008,8,WA81,"Andere unedle Metalle, Cermets usw.",127037000,133205000,260242000
2008,8,WA82,"Werkzeuge, Schneidwaren, Essbestecke",450567000,309815000,760382000
2008,8,WA83,Verschiedene Waren aus unedlen Metallen,501305000,285071000,786376000
2008,8,WA84,"Maschinen, Apparate, mechanische Geräte",13987580000,7689116000,21676696000
2008,8,WA85,Elektrotechnische Erzeugnisse,7843656000,6436553000,14280209000
2008,8,WA86,Schienenfahrzeuge,230375000,139947000,370322000
2008,8,WA87,"Kraftfahrzeuge, Landfahrzeuge",10026575000,4359535000,14386110000
2008,8,WA88,"Luftfahrzeuge, Raumfahrzeuge",1460968000,1134022000,2594990000
2008,8,WA89,Wasserfahrzeuge,468260000,793183000,1261443000
2008,8,WA90,"Optische, photografische usw. Erzeugnisse",2867269000,1567507000,4434776000
2008,8,WA91,Uhrmacherwaren,80982000,79724000,160706000
2008,8,WA92,Musikinstrumente,26673000,26968000,53641000
2008,8,WA93,Waffen und Munition,28309000,12184000,40493000
2008,8,WA94,"Möbel, Beleuchtungskörper usw.",938943000,872206000,1811149000
2008,8,WA95,"Spielzeug, Spiele usw., Sportgeräte",480401000,582020000,1062421000
2008,8,WA96,Verschiedene Waren,129095000,91310000,220405000
2008,8,WA97,"Kunstgegenstände, Sammlungsstücke",36273000,20911000,57184000
2008,8,WA98,Vollständige Fabrikationsanlagen,310303000,3005000,313308000
2008,8,WA99,Zusammenstellungen verschiedener Waren,1042301000,736908000,1779209000
2008,9,WA01,Lebende Tiere,82164000,118171000,200335000
2008,9,WA02,Fleisch,591647000,441449000,1033096000
2008,9,WA03,"Fische, Krebs- und Weichtiere",76284000,203207000,279491000
2008,9,WA04,"Milch, Milcherzeugnisse, Eier, Honig",571103000,497581000,1068684000
2008,9,WA05,Andere Waren tierischen Ursprungs,51605000,53461000,105066000
2008,9,WA06,"Pflanzen, Waren des Blumenhandels",63796000,174582000,238378000
2008,9,WA07,"Gemüse, Pflanzen für Ernährung",71412000,268550000,339962000
2008,9,WA08,Genießbare Früchte und Nüsse,96445000,539997000,636442000
2008,9,WA09,"Kaffee, Tee, Mate, Gewürze",119969000,226983000,346952000
2008,9,WA10,Getreide,240468000,131254000,371722000
2008,9,WA11,"Müllereierzeugnisse, Malz usw.",70086000,46477000,116563000
2008,9,WA12,"Ölsamen usw., Heilpflanzen usw.",75581000,394310000,469891000
2008,9,WA13,"Schellack, Gummen, Harz, Pflanzensaft",40052000,22303000,62355000
2008,9,WA14,Flechtstoffe usw. pflanzlichen Ursprungs,994000,3195000,4189000
2008,9,WA15,"Tierische und pflanzliche Fette, Öle, Wachs",187295000,255730000,443025000
2008,9,WA16,"Zubereitungen von Fleisch, Fisch usw.",212550000,168027000,380577000
2008,9,WA17,Zucker und Zuckerwaren,110552000,144805000,255357000
2008,9,WA18,Kakao und Zubereitungen aus Kakao,292269000,210732000,503001000
2008,9,WA19,"Zubereitungen aus Getreide usw., Backwaren",334439000,190716000,525155000
2008,9,WA20,"Zubereitungen von Gemüse, Früchten usw.",190529000,302116000,492645000
2008,9,WA21,Verschiedene Lebensmittelzubereitungen,281264000,204985000,486249000
2008,9,WA22,"Getränke, alkoholhaltige Flüssigkeiten, Essig",374092000,443280000,817372000
2008,9,WA23,"Rückstände der Lebensmittelindustrie, Futter",225834000,198060000,423894000
2008,9,WA24,Tabak,302139000,136120000,438259000
2008,9,WA25,"Salz, Schwefel, Steine, Erden usw.",198838000,162971000,361809000
2008,9,WA26,"Erze, Schlacken, Aschen",22496000,578142000,600638000
2008,9,WA27,Mineralische Brennstoffe usw.,2015585000,10580906000,12596491000
2008,9,WA28,Anorganische chemische Erzeugnisse,670953000,810968000,1481921000
2008,9,WA29,Organische chemische Erzeugnisse,2076755000,1850335000,3927090000
2008,9,WA30,Pharmazeutische Erzeugnisse,3721699000,2802860000,6524559000
2008,9,WA31,Düngemittel,335552000,149557000,485109000
2008,9,WA32,"Gerb- und Farbstoffe, Farben, Lacke usw.",701889000,300389000,1002278000
2008,9,WA33,"Etherische Öle, Riech-, Schönheitsmittel",638058000,366759000,1004817000
2008,9,WA34,"Seifen, Waschmittel usw.",460478000,255767000,716245000
2008,9,WA35,"Eiweißstoffe, Klebstoffe, Enzyme",174169000,136529000,310698000
2008,9,WA36,"Sprengstoffe, pyrotechnische Artikel usw.",16864000,12149000,29013000
2008,9,WA37,Photochemische Erzeugnisse,90556000,72346000,162902000
2008,9,WA38,Verschiedene Erzeugnisse der Chemischen Industrie,1239848000,827555000,2067403000
2008,9,WA39,Kunststoffe und Waren daraus,3959353000,2366096000,6325449000
2008,9,WA40,Kautschuk und Waren daraus,960042000,866491000,1826533000
2008,9,WA41,"Häute, Felle, Leder",71987000,69035000,141022000
2008,9,WA42,"Lederwaren, Sattlerwaren",136949000,214364000,351313000
2008,9,WA43,"Pelzfelle, künstliches Pelzwerk",20991000,18455000,39446000
2008,9,WA44,"Holz, Holzwaren, Holzkohle",640738000,457592000,1098330000
2008,9,WA45,"Kork, Korkwaren",3398000,8725000,12123000
2008,9,WA46,"Flechtwaren, Korbmacherwaren",4258000,10692000,14950000
2008,9,WA47,"Halbstoffe aus Holz usw., Papierabfall",82940000,278380000,361320000
2008,9,WA48,"Papier, Pappe und Waren daraus",1514376000,978480000,2492856000
2008,9,WA49,"Bücher, Zeitungen, Bilddrucke usw.",448686000,181787000,630473000
2008,9,WA50,Seide,5618000,5938000,11556000
2008,9,WA51,"Wolle, feine und grobe Tierhaare",51014000,53845000,104859000
2008,9,WA52,Baumwolle,87414000,79535000,166949000
2008,9,WA53,"Andere pflanzliche Spinnstoffe, Papiergarn",3618000,6638000,10256000
2008,9,WA54,Synthetisches oder künstliches Filament,201244000,132942000,334186000
2008,9,WA55,Synthetische oder künstliche Spinnfaser,144545000,121645000,266190000
2008,9,WA56,"Watte, Filz, Vliesstoff usw., Tauwerk",159140000,89768000,248908000
2008,9,WA57,"Teppiche, Fußbodenbelag aus Spinnstoff",44493000,83361000,127854000
2008,9,WA58,"Spezialgewebe, Spitzen, Tapisserien",42863000,25382000,68245000
2008,9,WA59,"Getränkte, bestrichene usw. Gewebe",157286000,106624000,263910000
2008,9,WA60,Gewirke und Gestricke,70709000,32234000,102943000
2008,9,WA61,"Bekleidung usw. aus Gewirken, Gestricken",516328000,1005819000,1522147000
2008,9,WA62,"Andere Bekleidung, Bekleidungszubehör",760607000,1080562000,1841169000
2008,9,WA63,"Andere Konfektion, Spinnstoffwaren usw.",138381000,216412000,354793000
2008,9,WA64,"Schuhe, Gamaschen, ähnliche Waren",282501000,463477000,745978000
2008,9,WA65,Kopfbedeckungen und Teile davon,23332000,34242000,57574000
2008,9,WA66,"Schirme, Gehstöcke usw., Peitschen",10609000,11178000,21787000
2008,9,WA67,"Zugerichtete Federn, Daunen, künstliche Blumen",7335000,14719000,22054000
2008,9,WA68,"Waren aus Steinen, Gips, Zement usw.",304874000,202532000,507406000
2008,9,WA69,Keramische Waren,249134000,180822000,429956000
2008,9,WA70,Glas und Glaswaren,444086000,313683000,757769000
2008,9,WA71,"Perlen, Edelsteine, Edelmetalle",727878000,843097000,1570975000
2008,9,WA72,Eisen und Stahl,2457361000,2655754000,5113115000
2008,9,WA73,Waren aus Eisen oder Stahl,2299410000,1517653000,3817063000
2008,9,WA74,Kupfer und Waren daraus,925286000,782839000,1708125000
2008,9,WA75,Nickel und Waren daraus,102554000,152433000,254987000
2008,9,WA76,Aluminium und Waren daraus,1080056000,1032507000,2112563000
2008,9,WA78,Blei und Waren daraus,38472000,17402000,55874000
2008,9,WA79,Zink und Waren daraus,49979000,65672000,115651000
2008,9,WA80,Zinn und Waren daraus,11932000,36053000,47985000
2008,9,WA81,"Andere unedle Metalle, Cermets usw.",95775000,126740000,222515000
2008,9,WA82,"Werkzeuge, Schneidwaren, Essbestecke",554638000,349356000,903994000
2008,9,WA83,Verschiedene Waren aus unedlen Metallen,567959000,324734000,892693000
2008,9,WA84,"Maschinen, Apparate, mechanische Geräte",16039275000,9232648000,25271923000
2008,9,WA85,Elektrotechnische Erzeugnisse,8630641000,7633661000,16264302000
2008,9,WA86,Schienenfahrzeuge,325141000,136606000,461747000
2008,9,WA87,"Kraftfahrzeuge, Landfahrzeuge",14386527000,5900449000,20286976000
2008,9,WA88,"Luftfahrzeuge, Raumfahrzeuge",1790878000,1297507000,3088385000
2008,9,WA89,Wasserfahrzeuge,618861000,118626000,737487000
2008,9,WA90,"Optische, photografische usw. Erzeugnisse",3328733000,1804263000,5132996000
2008,9,WA91,Uhrmacherwaren,103351000,125663000,229014000
2008,9,WA92,Musikinstrumente,42464000,36199000,78663000
2008,9,WA93,Waffen und Munition,30084000,9638000,39722000
2008,9,WA94,"Möbel, Beleuchtungskörper usw.",1075399000,1010241000,2085640000
2008,9,WA95,"Spielzeug, Spiele usw., Sportgeräte",533809000,786334000,1320143000
2008,9,WA96,Verschiedene Waren,187153000,103970000,291123000
2008,9,WA97,"Kunstgegenstände, Sammlungsstücke",47549000,19883000,67432000
2008,9,WA98,Vollständige Fabrikationsanlagen,444437000,8541000,452978000
2008,9,WA99,Zusammenstellungen verschiedener Waren,1199428000,873636000,2073064000
2008,10,WA01,Lebende Tiere,78581000,121167000,199748000
2008,10,WA02,Fleisch,615524000,504144000,1119668000
2008,10,WA03,"Fische, Krebs- und Weichtiere",85423000,235810000,321233000
2008,10,WA04,"Milch, Milcherzeugnisse, Eier, Honig",581397000,462771000,1044168000
2008,10,WA05,Andere Waren tierischen Ursprungs,54510000,55120000,109630000
2008,10,WA06,"Pflanzen, Waren des Blumenhandels",60104000,181262000,241366000
2008,10,WA07,"Gemüse, Pflanzen für Ernährung",80161000,278202000,358363000
2008,10,WA08,Genießbare Früchte und Nüsse,97000000,513994000,610994000
2008,10,WA09,"Kaffee, Tee, Mate, Gewürze",167951000,261597000,429548000
2008,10,WA10,Getreide,345165000,180309000,525474000
2008,10,WA11,"Müllereierzeugnisse, Malz usw.",93495000,42565000,136060000
2008,10,WA12,"Ölsamen usw., Heilpflanzen usw.",78462000,337992000,416454000
2008,10,WA13,"Schellack, Gummen, Harz, Pflanzensaft",42133000,26409000,68542000
2008,10,WA14,Flechtstoffe usw. pflanzlichen Ursprungs,1094000,2479000,3573000
2008,10,WA15,"Tierische und pflanzliche Fette, Öle, Wachs",166393000,304536000,470929000
2008,10,WA16,"Zubereitungen von Fleisch, Fisch usw.",195512000,198735000,394247000
2008,10,WA17,Zucker und Zuckerwaren,133685000,136030000,269715000
2008,10,WA18,Kakao und Zubereitungen aus Kakao,335384000,264242000,599626000
2008,10,WA19,"Zubereitungen aus Getreide usw., Backwaren",391954000,197992000,589946000
2008,10,WA20,"Zubereitungen von Gemüse, Früchten usw.",174177000,332456000,506633000
2008,10,WA21,Verschiedene Lebensmittelzubereitungen,319118000,200336000,519454000
2008,10,WA22,"Getränke, alkoholhaltige Flüssigkeiten, Essig",371210000,493230000,864440000
2008,10,WA23,"Rückstände der Lebensmittelindustrie, Futter",276461000,218470000,494931000
2008,10,WA24,Tabak,276318000,129276000,405594000
2008,10,WA25,"Salz, Schwefel, Steine, Erden usw.",225659000,162345000,388004000
2008,10,WA26,"Erze, Schlacken, Aschen",23789000,586098000,609887000
2008,10,WA27,Mineralische Brennstoffe usw.,2151129000,10294078000,12445207000
2008,10,WA28,Anorganische chemische Erzeugnisse,718173000,641878000,1360051000
2008,10,WA29,Organische chemische Erzeugnisse,1995809000,1858312000,3854121000
2008,10,WA30,Pharmazeutische Erzeugnisse,3982551000,2925772000,6908323000
2008,10,WA31,Düngemittel,268288000,159589000,427877000
2008,10,WA32,"Gerb- und Farbstoffe, Farben, Lacke usw.",727842000,343753000,1071595000
2008,10,WA33,"Etherische Öle, Riech-, Schönheitsmittel",611282000,356637000,967919000
2008,10,WA34,"Seifen, Waschmittel usw.",453284000,242194000,695478000
2008,10,WA35,"Eiweißstoffe, Klebstoffe, Enzyme",179747000,136325000,316072000
2008,10,WA36,"Sprengstoffe, pyrotechnische Artikel usw.",19476000,20696000,40172000
2008,10,WA37,Photochemische Erzeugnisse,108109000,54798000,162907000
2008,10,WA38,Verschiedene Erzeugnisse der Chemischen Industrie,1425193000,777123000,2202316000
2008,10,WA39,Kunststoffe und Waren daraus,4051762000,2402604000,6454366000
2008,10,WA40,Kautschuk und Waren daraus,916195000,916414000,1832609000
2008,10,WA41,"Häute, Felle, Leder",94392000,89404000,183796000
2008,10,WA42,"Lederwaren, Sattlerwaren",131253000,212676000,343929000
2008,10,WA43,"Pelzfelle, künstliches Pelzwerk",18873000,13863000,32736000
2008,10,WA44,"Holz, Holzwaren, Holzkohle",671212000,515835000,1187047000
2008,10,WA45,"Kork, Korkwaren",3236000,9395000,12631000
2008,10,WA46,"Flechtwaren, Korbmacherwaren",4225000,10628000,14853000
2008,10,WA47,"Halbstoffe aus Holz usw., Papierabfall",95546000,310118000,405664000
2008,10,WA48,"Papier, Pappe und Waren daraus",1629671000,1076927000,2706598000
2008,10,WA49,"Bücher, Zeitungen, Bilddrucke usw.",489562000,194743000,684305000
2008,10,WA50,Seide,9635000,8849000,18484000
2008,10,WA51,"Wolle, feine und grobe Tierhaare",47572000,63427000,110999000
2008,10,WA52,Baumwolle,98987000,90985000,189972000
2008,10,WA53,"Andere pflanzliche Spinnstoffe, Papiergarn",6680000,10316000,16996000
2008,10,WA54,Synthetisches oder künstliches Filament,198547000,128640000,327187000
2008,10,WA55,Synthetische oder künstliche Spinnfaser,157101000,126102000,283203000
2008,10,WA56,"Watte, Filz, Vliesstoff usw., Tauwerk",167583000,96716000,264299000
2008,10,WA57,"Teppiche, Fußbodenbelag aus Spinnstoff",51239000,91683000,142922000
2008,10,WA58,"Spezialgewebe, Spitzen, Tapisserien",47348000,28160000,75508000
2008,10,WA59,"Getränkte, bestrichene usw. Gewebe",148406000,106800000,255206000
2008,10,WA60,Gewirke und Gestricke,68582000,34846000,103428000
2008,10,WA61,"Bekleidung usw. aus Gewirken, Gestricken",512967000,940328000,1453295000
2008,10,WA62,"Andere Bekleidung, Bekleidungszubehör",650846000,937885000,1588731000
2008,10,WA63,"Andere Konfektion, Spinnstoffwaren usw.",149071000,231743000,380814000
2008,10,WA64,"Schuhe, Gamaschen, ähnliche Waren",212729000,348335000,561064000
2008,10,WA65,Kopfbedeckungen und Teile davon,23716000,29246000,52962000
2008,10,WA66,"Schirme, Gehstöcke usw., Peitschen",9138000,11719000,20857000
2008,10,WA67,"Zugerichtete Federn, Daunen, künstliche Blumen",7433000,12480000,19913000
2008,10,WA68,"Waren aus Steinen, Gips, Zement usw.",311448000,207168000,518616000
2008,10,WA69,Keramische Waren,294643000,198218000,492861000
2008,10,WA70,Glas und Glaswaren,474117000,337915000,812032000
2008,10,WA71,"Perlen, Edelsteine, Edelmetalle",605432000,991989000,1597421000
2008,10,WA72,Eisen und Stahl,2417414000,2679641000,5097055000
2008,10,WA73,Waren aus Eisen oder Stahl,2398588000,1580375000,3978963000
2008,10,WA74,Kupfer und Waren daraus,749231000,722333000,1471564000
2008,10,WA75,Nickel und Waren daraus,94591000,142174000,236765000
2008,10,WA76,Aluminium und Waren daraus,1119824000,1089402000,2209226000
2008,10,WA78,Blei und Waren daraus,42061000,20602000,62663000
2008,10,WA79,Zink und Waren daraus,43894000,68476000,112370000
2008,10,WA80,Zinn und Waren daraus,9681000,29787000,39468000
2008,10,WA81,"Andere unedle Metalle, Cermets usw.",99100000,133748000,232848000
2008,10,WA82,"Werkzeuge, Schneidwaren, Essbestecke",570806000,353125000,923931000
2008,10,WA83,Verschiedene Waren aus unedlen Metallen,535902000,324999000,860901000
2008,10,WA84,"Maschinen, Apparate, mechanische Geräte",16740851000,9504849000,26245700000
2008,10,WA85,Elektrotechnische Erzeugnisse,9039839000,7986942000,17026781000
2008,10,WA86,Schienenfahrzeuge,319556000,132294000,451850000
2008,10,WA87,"Kraftfahrzeuge, Landfahrzeuge",14118088000,5445067000,19563155000
2008,10,WA88,"Luftfahrzeuge, Raumfahrzeuge",2129551000,1516408000,3645959000
2008,10,WA89,Wasserfahrzeuge,155779000,94652000,250431000
2008,10,WA90,"Optische, photografische usw. Erzeugnisse",3443330000,2013360000,5456690000
2008,10,WA91,Uhrmacherwaren,88413000,118082000,206495000
2008,10,WA92,Musikinstrumente,41611000,33553000,75164000
2008,10,WA93,Waffen und Munition,35447000,14029000,49476000
2008,10,WA94,"Möbel, Beleuchtungskörper usw.",1164209000,1067348000,2231557000
2008,10,WA95,"Spielzeug, Spiele usw., Sportgeräte",932387000,875079000,1807466000
2008,10,WA96,Verschiedene Waren,175141000,113532000,288673000
2008,10,WA97,"Kunstgegenstände, Sammlungsstücke",53355000,31104000,84459000
2008,10,WA98,Vollständige Fabrikationsanlagen,525730000,1350000,527080000
2008,10,WA99,Zusammenstellungen verschiedener Waren,1387236000,919262000,2306498000
2008,11,WA01,Lebende Tiere,77929000,122550000,200479000
2008,11,WA02,Fleisch,494709000,522507000,1017216000
2008,11,WA03,"Fische, Krebs- und Weichtiere",80627000,225841000,306468000
2008,11,WA04,"Milch, Milcherzeugnisse, Eier, Honig",496823000,444365000,941188000
2008,11,WA05,Andere Waren tierischen Ursprungs,52679000,56026000,108705000
2008,11,WA06,"Pflanzen, Waren des Blumenhandels",43445000,167923000,211368000
2008,11,WA07,"Gemüse, Pflanzen für Ernährung",66172000,302558000,368730000
2008,11,WA08,Genießbare Früchte und Nüsse,97435000,516452000,613887000
2008,11,WA09,"Kaffee, Tee, Mate, Gewürze",153285000,240345000,393630000
2008,11,WA10,Getreide,295277000,155655000,450932000
2008,11,WA11,"Müllereierzeugnisse, Malz usw.",69479000,40731000,110210000
2008,11,WA12,"Ölsamen usw., Heilpflanzen usw.",58561000,257534000,316095000
2008,11,WA13,"Schellack, Gummen, Harz, Pflanzensaft",36485000,30529000,67014000
2008,11,WA14,Flechtstoffe usw. pflanzlichen Ursprungs,1249000,2237000,3486000
2008,11,WA15,"Tierische und pflanzliche Fette, Öle, Wachs",133682000,332476000,466158000
2008,11,WA16,"Zubereitungen von Fleisch, Fisch usw.",173551000,177156000,350707000
2008,11,WA17,Zucker und Zuckerwaren,125533000,118270000,243803000
2008,11,WA18,Kakao und Zubereitungen aus Kakao,249272000,213605000,462877000
2008,11,WA19,"Zubereitungen aus Getreide usw., Backwaren",374133000,206870000,581003000
2008,11,WA20,"Zubereitungen von Gemüse, Früchten usw.",169533000,321856000,491389000
2008,11,WA21,Verschiedene Lebensmittelzubereitungen,269051000,192165000,461216000
2008,11,WA22,"Getränke, alkoholhaltige Flüssigkeiten, Essig",315651000,466302000,781953000
2008,11,WA23,"Rückstände der Lebensmittelindustrie, Futter",186097000,214268000,400365000
2008,11,WA24,Tabak,265055000,110935000,375990000
2008,11,WA25,"Salz, Schwefel, Steine, Erden usw.",188391000,135896000,324287000
2008,11,WA26,"Erze, Schlacken, Aschen",18577000,341970000,360547000
2008,11,WA27,Mineralische Brennstoffe usw.,1981473000,9245214000,11226687000
2008,11,WA28,Anorganische chemische Erzeugnisse,551182000,583950000,1135132000
2008,11,WA29,Organische chemische Erzeugnisse,1630626000,1700104000,3330730000
2008,11,WA30,Pharmazeutische Erzeugnisse,3946028000,2577779000,6523807000
2008,11,WA31,Düngemittel,238724000,125432000,364156000
2008,11,WA32,"Gerb- und Farbstoffe, Farben, Lacke usw.",567039000,280743000,847782000
2008,11,WA33,"Etherische Öle, Riech-, Schönheitsmittel",540135000,300804000,840939000
2008,11,WA34,"Seifen, Waschmittel usw.",360256000,198856000,559112000
2008,11,WA35,"Eiweißstoffe, Klebstoffe, Enzyme",147536000,127457000,274993000
2008,11,WA36,"Sprengstoffe, pyrotechnische Artikel usw.",19913000,20075000,39988000
2008,11,WA37,Photochemische Erzeugnisse,83064000,64484000,147548000
2008,11,WA38,Verschiedene Erzeugnisse der Chemischen Industrie,1130386000,660157000,1790543000
2008,11,WA39,Kunststoffe und Waren daraus,3129512000,1970870000,5100382000
2008,11,WA40,Kautschuk und Waren daraus,734634000,776260000,1510894000
2008,11,WA41,"Häute, Felle, Leder",69506000,72305000,141811000
2008,11,WA42,"Lederwaren, Sattlerwaren",105940000,218873000,324813000
2008,11,WA43,"Pelzfelle, künstliches Pelzwerk",11248000,11619000,22867000
2008,11,WA44,"Holz, Holzwaren, Holzkohle",551233000,422235000,973468000
2008,11,WA45,"Kork, Korkwaren",3194000,8399000,11593000
2008,11,WA46,"Flechtwaren, Korbmacherwaren",3420000,11451000,14871000
2008,11,WA47,"Halbstoffe aus Holz usw., Papierabfall",62060000,252522000,314582000
2008,11,WA48,"Papier, Pappe und Waren daraus",1437207000,969319000,2406526000
2008,11,WA49,"Bücher, Zeitungen, Bilddrucke usw.",391108000,197753000,588861000
2008,11,WA50,Seide,8096000,8240000,16336000
2008,11,WA51,"Wolle, feine und grobe Tierhaare",49418000,56480000,105898000
2008,11,WA52,Baumwolle,90701000,85334000,176035000
2008,11,WA53,"Andere pflanzliche Spinnstoffe, Papiergarn",7546000,10164000,17710000
2008,11,WA54,Synthetisches oder künstliches Filament,165163000,119548000,284711000
2008,11,WA55,Synthetische oder künstliche Spinnfaser,123637000,108638000,232275000
2008,11,WA56,"Watte, Filz, Vliesstoff usw., Tauwerk",135607000,81706000,217313000
2008,11,WA57,"Teppiche, Fußbodenbelag aus Spinnstoff",37706000,76281000,113987000
2008,11,WA58,"Spezialgewebe, Spitzen, Tapisserien",37902000,25157000,63059000
2008,11,WA59,"Getränkte, bestrichene usw. Gewebe",123508000,100365000,223873000
2008,11,WA60,Gewirke und Gestricke,61575000,33165000,94740000
2008,11,WA61,"Bekleidung usw. aus Gewirken, Gestricken",386998000,907536000,1294534000
2008,11,WA62,"Andere Bekleidung, Bekleidungszubehör",429552000,880681000,1310233000
2008,11,WA63,"Andere Konfektion, Spinnstoffwaren usw.",135632000,208482000,344114000
2008,11,WA64,"Schuhe, Gamaschen, ähnliche Waren",143804000,350096000,493900000
2008,11,WA65,Kopfbedeckungen und Teile davon,14681000,25245000,39926000
2008,11,WA66,"Schirme, Gehstöcke usw., Peitschen",8624000,11919000,20543000
2008,11,WA67,"Zugerichtete Federn, Daunen, künstliche Blumen",4847000,11972000,16819000
2008,11,WA68,"Waren aus Steinen, Gips, Zement usw.",264092000,167664000,431756000
2008,11,WA69,Keramische Waren,218282000,177126000,395408000
2008,11,WA70,Glas und Glaswaren,376017000,286772000,662789000
2008,11,WA71,"Perlen, Edelsteine, Edelmetalle",644188000,929029000,1573217000
2008,11,WA72,Eisen und Stahl,1798792000,2194799000,3993591000
2008,11,WA73,Waren aus Eisen oder Stahl,1984752000,1346874000,3331626000
2008,11,WA74,Kupfer und Waren daraus,559087000,554510000,1113597000
2008,11,WA75,Nickel und Waren daraus,105137000,113931000,219068000
2008,11,WA76,Aluminium und Waren daraus,872814000,805725000,1678539000
2008,11,WA78,Blei und Waren daraus,35621000,24696000,60317000
2008,11,WA79,Zink und Waren daraus,34464000,50454000,84918000
2008,11,WA80,Zinn und Waren daraus,8359000,22224000,30583000
2008,11,WA81,"Andere unedle Metalle, Cermets usw.",87792000,126159000,213951000
2008,11,WA82,"Werkzeuge, Schneidwaren, Essbestecke",479408000,307009000,786417000
2008,11,WA83,Verschiedene Waren aus unedlen Metallen,455718000,274074000,729792000
2008,11,WA84,"Maschinen, Apparate, mechanische Geräte",14282249000,8996409000,23278658000
2008,11,WA85,Elektrotechnische Erzeugnisse,8164005000,7930293000,16094298000
2008,11,WA86,Schienenfahrzeuge,326245000,136570000,462815000
2008,11,WA87,"Kraftfahrzeuge, Landfahrzeuge",12033117000,4931558000,16964675000
2008,11,WA88,"Luftfahrzeuge, Raumfahrzeuge",1733709000,1434994000,3168703000
2008,11,WA89,Wasserfahrzeuge,407875000,465374000,873249000
2008,11,WA90,"Optische, photografische usw. Erzeugnisse",3233146000,1872744000,5105890000
2008,11,WA91,Uhrmacherwaren,98920000,124740000,223660000
2008,11,WA92,Musikinstrumente,39900000,38225000,78125000
2008,11,WA93,Waffen und Munition,35104000,12069000,47173000
2008,11,WA94,"Möbel, Beleuchtungskörper usw.",1014478000,982311000,1996789000
2008,11,WA95,"Spielzeug, Spiele usw., Sportgeräte",809846000,749076000,1558922000
2008,11,WA96,Verschiedene Waren,152120000,111792000,263912000
2008,11,WA97,"Kunstgegenstände, Sammlungsstücke",86880000,18930000,105810000
2008,11,WA98,Vollständige Fabrikationsanlagen,498863000,13313000,512176000
2008,11,WA99,Zusammenstellungen verschiedener Waren,1091052000,1103605000,2194657000
2008,12,WA01,Lebende Tiere,77589000,111043000,188632000
2008,12,WA02,Fleisch,549089000,455782000,1004871000
2008,12,WA03,"Fische, Krebs- und Weichtiere",100851000,211901000,312752000
2008,12,WA04,"Milch, Milcherzeugnisse, Eier, Honig",521311000,477935000,999246000
2008,12,WA05,Andere Waren tierischen Ursprungs,44395000,55337000,99732000
2008,12,WA06,"Pflanzen, Waren des Blumenhandels",44324000,197174000,241498000
2008,12,WA07,"Gemüse, Pflanzen für Ernährung",60553000,335108000,395661000
2008,12,WA08,Genießbare Früchte und Nüsse,111999000,484758000,596757000
2008,12,WA09,"Kaffee, Tee, Mate, Gewürze",129615000,244357000,373972000
2008,12,WA10,Getreide,189486000,182719000,372205000
2008,12,WA11,"Müllereierzeugnisse, Malz usw.",74722000,35437000,110159000
2008,12,WA12,"Ölsamen usw., Heilpflanzen usw.",68135000,335368000,403503000
2008,12,WA13,"Schellack, Gummen, Harz, Pflanzensaft",33687000,20928000,54615000
2008,12,WA14,Flechtstoffe usw. pflanzlichen Ursprungs,754000,2268000,3022000
2008,12,WA15,"Tierische und pflanzliche Fette, Öle, Wachs",166128000,319051000,485179000
2008,12,WA16,"Zubereitungen von Fleisch, Fisch usw.",212870000,206007000,418877000
2008,12,WA17,Zucker und Zuckerwaren,102096000,89924000,192020000
2008,12,WA18,Kakao und Zubereitungen aus Kakao,208810000,189722000,398532000
2008,12,WA19,"Zubereitungen aus Getreide usw., Backwaren",318760000,182470000,501230000
2008,12,WA20,"Zubereitungen von Gemüse, Früchten usw.",167922000,296475000,464397000
2008,12,WA21,Verschiedene Lebensmittelzubereitungen,261394000,184524000,445918000
2008,12,WA22,"Getränke, alkoholhaltige Flüssigkeiten, Essig",303449000,475884000,779333000
2008,12,WA23,"Rückstände der Lebensmittelindustrie, Futter",211169000,214588000,425757000
2008,12,WA24,Tabak,214919000,135336000,350255000
2008,12,WA25,"Salz, Schwefel, Steine, Erden usw.",134821000,114854000,249675000
2008,12,WA26,"Erze, Schlacken, Aschen",12095000,553192000,565287000
2008,12,WA27,Mineralische Brennstoffe usw.,1781445000,8224112000,10005557000
2008,12,WA28,Anorganische chemische Erzeugnisse,529396000,449896000,979292000
2008,12,WA29,Organische chemische Erzeugnisse,1328396000,1306079000,2634475000
2008,12,WA30,Pharmazeutische Erzeugnisse,3368921000,2645332000,6014253000
2008,12,WA31,Düngemittel,180688000,126030000,306718000
2008,12,WA32,"Gerb- und Farbstoffe, Farben, Lacke usw.",443128000,230725000,673853000
2008,12,WA33,"Etherische Öle, Riech-, Schönheitsmittel",492451000,314570000,807021000
2008,12,WA34,"Seifen, Waschmittel usw.",317900000,186938000,504838000
2008,12,WA35,"Eiweißstoffe, Klebstoffe, Enzyme",136684000,109516000,246200000
2008,12,WA36,"Sprengstoffe, pyrotechnische Artikel usw.",18764000,14537000,33301000
2008,12,WA37,Photochemische Erzeugnisse,82335000,55974000,138309000
2008,12,WA38,Verschiedene Erzeugnisse der Chemischen Industrie,943413000,659641000,1603054000
2008,12,WA39,Kunststoffe und Waren daraus,2387381000,1588369000,3975750000
2008,12,WA40,Kautschuk und Waren daraus,561236000,507248000,1068484000
2008,12,WA41,"Häute, Felle, Leder",55446000,53470000,108916000
2008,12,WA42,"Lederwaren, Sattlerwaren",95249000,196095000,291344000
2008,12,WA43,"Pelzfelle, künstliches Pelzwerk",7535000,9936000,17471000
2008,12,WA44,"Holz, Holzwaren, Holzkohle",451102000,341274000,792376000
2008,12,WA45,"Kork, Korkwaren",2091000,5640000,7731000
2008,12,WA46,"Flechtwaren, Korbmacherwaren",3237000,11162000,14399000
2008,12,WA47,"Halbstoffe aus Holz usw., Papierabfall",46897000,224662000,271559000
2008,12,WA48,"Papier, Pappe und Waren daraus",1231169000,911670000,2142839000
2008,12,WA49,"Bücher, Zeitungen, Bilddrucke usw.",429826000,203129000,632955000
2008,12,WA50,Seide,5944000,6755000,12699000
2008,12,WA51,"Wolle, feine und grobe Tierhaare",31868000,42650000,74518000
2008,12,WA52,Baumwolle,83189000,69175000,152364000
2008,12,WA53,"Andere pflanzliche Spinnstoffe, Papiergarn",8064000,8655000,16719000
2008,12,WA54,Synthetisches oder künstliches Filament,129954000,84481000,214435000
2008,12,WA55,Synthetische oder künstliche Spinnfaser,114847000,84275000,199122000
2008,12,WA56,"Watte, Filz, Vliesstoff usw., Tauwerk",112987000,63975000,176962000
2008,12,WA57,"Teppiche, Fußbodenbelag aus Spinnstoff",35196000,76890000,112086000
2008,12,WA58,"Spezialgewebe, Spitzen, Tapisserien",32654000,20854000,53508000
2008,12,WA59,"Getränkte, bestrichene usw. Gewebe",106196000,77086000,183282000
2008,12,WA60,Gewirke und Gestricke,51747000,29488000,81235000
2008,12,WA61,"Bekleidung usw. aus Gewirken, Gestricken",337446000,802515000,1139961000
2008,12,WA62,"Andere Bekleidung, Bekleidungszubehör",398918000,880101000,1279019000
2008,12,WA63,"Andere Konfektion, Spinnstoffwaren usw.",118561000,187557000,306118000
2008,12,WA64,"Schuhe, Gamaschen, ähnliche Waren",148335000,382341000,530676000
2008,12,WA65,Kopfbedeckungen und Teile davon,15412000,25011000,40423000
2008,12,WA66,"Schirme, Gehstöcke usw., Peitschen",11763000,13061000,24824000
2008,12,WA67,"Zugerichtete Federn, Daunen, künstliche Blumen",4084000,13350000,17434000
2008,12,WA68,"Waren aus Steinen, Gips, Zement usw.",195645000,138480000,334125000
2008,12,WA69,Keramische Waren,188396000,137748000,326144000
2008,12,WA70,Glas und Glaswaren,333842000,291885000,625727000
2008,12,WA71,"Perlen, Edelsteine, Edelmetalle",470528000,664787000,1135315000
2008,12,WA72,Eisen und Stahl,1308216000,1635474000,2943690000
2008,12,WA73,Waren aus Eisen oder Stahl,1655899000,1097016000,2752915000
2008,12,WA74,Kupfer und Waren daraus,479309000,547191000,1026500000
2008,12,WA75,Nickel und Waren daraus,57281000,99445000,156726000
2008,12,WA76,Aluminium und Waren daraus,716868000,639359000,1356227000
2008,12,WA78,Blei und Waren daraus,31746000,10513000,42259000
2008,12,WA79,Zink und Waren daraus,24560000,39863000,64423000
2008,12,WA80,Zinn und Waren daraus,4530000,13818000,18348000
2008,12,WA81,"Andere unedle Metalle, Cermets usw.",68714000,90988000,159702000
2008,12,WA82,"Werkzeuge, Schneidwaren, Essbestecke",410360000,255354000,665714000
2008,12,WA83,Verschiedene Waren aus unedlen Metallen,337156000,233189000,570345000
2008,12,WA84,"Maschinen, Apparate, mechanische Geräte",13813675000,8105488000,21919163000
2008,12,WA85,Elektrotechnische Erzeugnisse,6998234000,6295737000,13293971000
2008,12,WA86,Schienenfahrzeuge,399528000,135956000,535484000
2008,12,WA87,"Kraftfahrzeuge, Landfahrzeuge",8936371000,3769549000,12705920000
2008,12,WA88,"Luftfahrzeuge, Raumfahrzeuge",2227030000,1872420000,4099450000
2008,12,WA89,Wasserfahrzeuge,294162000,1466482000,1760644000
2008,12,WA90,"Optische, photografische usw. Erzeugnisse",3097838000,1779025000,4876863000
2008,12,WA91,Uhrmacherwaren,106139000,120124000,226263000
2008,12,WA92,Musikinstrumente,42220000,38544000,80764000
2008,12,WA93,Waffen und Munition,34473000,13295000,47768000
2008,12,WA94,"Möbel, Beleuchtungskörper usw.",872794000,937639000,1810433000
2008,12,WA95,"Spielzeug, Spiele usw., Sportgeräte",689341000,597273000,1286614000
2008,12,WA96,Verschiedene Waren,137350000,94414000,231764000
2008,12,WA97,"Kunstgegenstände, Sammlungsstücke",55543000,32939000,88482000
2008,12,WA98,Vollständige Fabrikationsanlagen,498221000,7518000,505739000
2008,12,WA99,Zusammenstellungen verschiedener Waren,1264260000,856551000,2120811000
2009,1,WA01,Lebende Tiere,86147000,142375000,228522000
2009,1,WA02,Fleisch,542081000,411362000,953443000
2009,1,WA03,"Fische, Krebs- und Weichtiere",78613000,233902000,312515000
2009,1,WA04,"Milch, Milcherzeugnisse, Eier, Honig",510208000,426284000,936492000
2009,1,WA05,Andere Waren tierischen Ursprungs,49307000,54056000,103363000
2009,1,WA06,"Pflanzen, Waren des Blumenhandels",36410000,166346000,202756000
2009,1,WA07,"Gemüse, Pflanzen für Ernährung",70261000,403394000,473655000
2009,1,WA08,Genießbare Früchte und Nüsse,99308000,488414000,587722000
2009,1,WA09,"Kaffee, Tee, Mate, Gewürze",123399000,215043000,338442000
2009,1,WA10,Getreide,156638000,145422000,302060000
2009,1,WA11,"Müllereierzeugnisse, Malz usw.",86804000,34059000,120863000
2009,1,WA12,"Ölsamen usw., Heilpflanzen usw.",87912000,293117000,381029000
2009,1,WA13,"Schellack, Gummen, Harz, Pflanzensaft",35699000,30611000,66310000
2009,1,WA14,Flechtstoffe usw. pflanzlichen Ursprungs,695000,2071000,2766000
2009,1,WA15,"Tierische und pflanzliche Fette, Öle, Wachs",133051000,248318000,381369000
2009,1,WA16,"Zubereitungen von Fleisch, Fisch usw.",192627000,181439000,374066000
2009,1,WA17,Zucker und Zuckerwaren,92782000,97168000,189950000
2009,1,WA18,Kakao und Zubereitungen aus Kakao,195293000,197500000,392793000
2009,1,WA19,"Zubereitungen aus Getreide usw., Backwaren",308760000,186364000,495124000
2009,1,WA20,"Zubereitungen von Gemüse, Früchten usw.",164895000,312957000,477852000
2009,1,WA21,Verschiedene Lebensmittelzubereitungen,275298000,199599000,474897000
2009,1,WA22,"Getränke, alkoholhaltige Flüssigkeiten, Essig",263361000,413777000,677138000
2009,1,WA23,"Rückstände der Lebensmittelindustrie, Futter",200920000,230272000,431192000
2009,1,WA24,Tabak,346712000,138394000,485106000
2009,1,WA25,"Salz, Schwefel, Steine, Erden usw.",130569000,111711000,242280000
2009,1,WA26,"Erze, Schlacken, Aschen",31513000,504980000,536493000
2009,1,WA27,Mineralische Brennstoffe usw.,1731039000,7396246000,9127285000
2009,1,WA28,Anorganische chemische Erzeugnisse,466213000,404955000,871168000
2009,1,WA29,Organische chemische Erzeugnisse,1343196000,1601978000,2945174000
2009,1,WA30,Pharmazeutische Erzeugnisse,3796480000,2702188000,6498668000
2009,1,WA31,Düngemittel,103433000,89947000,193380000
2009,1,WA32,"Gerb- und Farbstoffe, Farben, Lacke usw.",496285000,254736000,751021000
2009,1,WA33,"Etherische Öle, Riech-, Schönheitsmittel",495695000,299587000,795282000
2009,1,WA34,"Seifen, Waschmittel usw.",348296000,181966000,530262000
2009,1,WA35,"Eiweißstoffe, Klebstoffe, Enzyme",146356000,122303000,268659000
2009,1,WA36,"Sprengstoffe, pyrotechnische Artikel usw.",12541000,18567000,31108000
2009,1,WA37,Photochemische Erzeugnisse,79033000,56278000,135311000
2009,1,WA38,Verschiedene Erzeugnisse der Chemischen Industrie,1129769000,737220000,1866989000
2009,1,WA39,Kunststoffe und Waren daraus,2734669000,1747963000,4482632000
2009,1,WA40,Kautschuk und Waren daraus,673704000,596431000,1270135000
2009,1,WA41,"Häute, Felle, Leder",52760000,47809000,100569000
2009,1,WA42,"Lederwaren, Sattlerwaren",108217000,216456000,324673000
2009,1,WA43,"Pelzfelle, künstliches Pelzwerk",7278000,6254000,13532000
2009,1,WA44,"Holz, Holzwaren, Holzkohle",441076000,379480000,820556000
2009,1,WA45,"Kork, Korkwaren",2588000,6158000,8746000
2009,1,WA46,"Flechtwaren, Korbmacherwaren",3747000,12832000,16579000
2009,1,WA47,"Halbstoffe aus Holz usw., Papierabfall",58932000,216463000,275395000
2009,1,WA48,"Papier, Pappe und Waren daraus",1299533000,870920000,2170453000
2009,1,WA49,"Bücher, Zeitungen, Bilddrucke usw.",408250000,180178000,588428000
2009,1,WA50,Seide,5334000,6790000,12124000
2009,1,WA51,"Wolle, feine und grobe Tierhaare",42604000,42987000,85591000
2009,1,WA52,Baumwolle,77828000,69097000,146925000
2009,1,WA53,"Andere pflanzliche Spinnstoffe, Papiergarn",7545000,7090000,14635000
2009,1,WA54,Synthetisches oder künstliches Filament,133497000,94951000,228448000
2009,1,WA55,Synthetische oder künstliche Spinnfaser,112697000,101606000,214303000
2009,1,WA56,"Watte, Filz, Vliesstoff usw., Tauwerk",118650000,75682000,194332000
2009,1,WA57,"Teppiche, Fußbodenbelag aus Spinnstoff",40530000,98354000,138884000
2009,1,WA58,"Spezialgewebe, Spitzen, Tapisserien",34093000,25152000,59245000
2009,1,WA59,"Getränkte, bestrichene usw. Gewebe",113606000,90367000,203973000
2009,1,WA60,Gewirke und Gestricke,52696000,28070000,80766000
2009,1,WA61,"Bekleidung usw. aus Gewirken, Gestricken",455942000,958652000,1414594000
2009,1,WA62,"Andere Bekleidung, Bekleidungszubehör",667610000,1155408000,1823018000
2009,1,WA63,"Andere Konfektion, Spinnstoffwaren usw.",121744000,216900000,338644000
2009,1,WA64,"Schuhe, Gamaschen, ähnliche Waren",273085000,509619000,782704000
2009,1,WA65,Kopfbedeckungen und Teile davon,15261000,30912000,46173000
2009,1,WA66,"Schirme, Gehstöcke usw., Peitschen",9311000,17486000,26797000
2009,1,WA67,"Zugerichtete Federn, Daunen, künstliche Blumen",6514000,12949000,19463000
2009,1,WA68,"Waren aus Steinen, Gips, Zement usw.",203002000,141530000,344532000
2009,1,WA69,Keramische Waren,206687000,158477000,365164000
2009,1,WA70,Glas und Glaswaren,349164000,250426000,599590000
2009,1,WA71,"Perlen, Edelsteine, Edelmetalle",464504000,683088000,1147592000
2009,1,WA72,Eisen und Stahl,1393690000,1478390000,2872080000
2009,1,WA73,Waren aus Eisen oder Stahl,1711221000,1149720000,2860941000
2009,1,WA74,Kupfer und Waren daraus,462195000,360389000,822584000
2009,1,WA75,Nickel und Waren daraus,74976000,73252000,148228000
2009,1,WA76,Aluminium und Waren daraus,716277000,670868000,1387145000
2009,1,WA78,Blei und Waren daraus,23043000,8273000,31316000
2009,1,WA79,Zink und Waren daraus,26499000,38293000,64792000
2009,1,WA80,Zinn und Waren daraus,7087000,15590000,22677000
2009,1,WA81,"Andere unedle Metalle, Cermets usw.",57380000,83573000,140953000
2009,1,WA82,"Werkzeuge, Schneidwaren, Essbestecke",432164000,273325000,705489000
2009,1,WA83,Verschiedene Waren aus unedlen Metallen,390026000,239488000,629514000
2009,1,WA84,"Maschinen, Apparate, mechanische Geräte",12224983000,7375878000,19600861000
2009,1,WA85,Elektrotechnische Erzeugnisse,6433943000,5853112000,12287055000
2009,1,WA86,Schienenfahrzeuge,279227000,174040000,453267000
2009,1,WA87,"Kraftfahrzeuge, Landfahrzeuge",8028190000,3691418000,11719608000
2009,1,WA88,"Luftfahrzeuge, Raumfahrzeuge",1715451000,1549722000,3265173000
2009,1,WA89,Wasserfahrzeuge,237008000,53108000,290116000
2009,1,WA90,"Optische, photografische usw. Erzeugnisse",2630366000,1627006000,4257372000
2009,1,WA91,Uhrmacherwaren,66584000,96195000,162779000
2009,1,WA92,Musikinstrumente,25121000,31723000,56844000
2009,1,WA93,Waffen und Munition,26320000,8047000,34367000
2009,1,WA94,"Möbel, Beleuchtungskörper usw.",811627000,929539000,1741166000
2009,1,WA95,"Spielzeug, Spiele usw., Sportgeräte",416136000,566295000,982431000
2009,1,WA96,Verschiedene Waren,132519000,100350000,232869000
2009,1,WA97,"Kunstgegenstände, Sammlungsstücke",46779000,24113000,70892000
2009,1,WA98,Vollständige Fabrikationsanlagen,464665000,1837000,466502000
2009,1,WA99,Zusammenstellungen verschiedener Waren,974948000,889220000,1864168000
2009,2,WA01,Lebende Tiere,78166000,130082000,208248000
2009,2,WA02,Fleisch,462249000,369054000,831303000
2009,2,WA03,"Fische, Krebs- und Weichtiere",77714000,220285000,297999000
2009,2,WA04,"Milch, Milcherzeugnisse, Eier, Honig",465951000,377192000,843143000
2009,2,WA05,Andere Waren tierischen Ursprungs,39779000,49389000,89168000
2009,2,WA06,"Pflanzen, Waren des Blumenhandels",44920000,214093000,259013000
2009,2,WA07,"Gemüse, Pflanzen für Ernährung",64454000,394087000,458541000
2009,2,WA08,Genießbare Früchte und Nüsse,84103000,429190000,513293000
2009,2,WA09,"Kaffee, Tee, Mate, Gewürze",121484000,214443000,335927000
2009,2,WA10,Getreide,181400000,182958000,364358000
2009,2,WA11,"Müllereierzeugnisse, Malz usw.",72599000,34592000,107191000
2009,2,WA12,"Ölsamen usw., Heilpflanzen usw.",106841000,222750000,329591000
2009,2,WA13,"Schellack, Gummen, Harz, Pflanzensaft",41510000,26805000,68315000
2009,2,WA14,Flechtstoffe usw. pflanzlichen Ursprungs,651000,1672000,2323000
2009,2,WA15,"Tierische und pflanzliche Fette, Öle, Wachs",139121000,192888000,332009000
2009,2,WA16,"Zubereitungen von Fleisch, Fisch usw.",180978000,146198000,327176000
2009,2,WA17,Zucker und Zuckerwaren,111096000,100064000,211160000
2009,2,WA18,Kakao und Zubereitungen aus Kakao,217462000,198714000,416176000
2009,2,WA19,"Zubereitungen aus Getreide usw., Backwaren",310285000,196298000,506583000
2009,2,WA20,"Zubereitungen von Gemüse, Früchten usw.",154364000,300779000,455143000
2009,2,WA21,Verschiedene Lebensmittelzubereitungen,284875000,194941000,479816000
2009,2,WA22,"Getränke, alkoholhaltige Flüssigkeiten, Essig",282748000,387689000,670437000
2009,2,WA23,"Rückstände der Lebensmittelindustrie, Futter",190315000,210152000,400467000
2009,2,WA24,Tabak,248287000,140118000,388405000
2009,2,WA25,"Salz, Schwefel, Steine, Erden usw.",149565000,105446000,255011000
2009,2,WA26,"Erze, Schlacken, Aschen",12379000,337603000,349982000
2009,2,WA27,Mineralische Brennstoffe usw.,1523606000,6749424000,8273030000
2009,2,WA28,Anorganische chemische Erzeugnisse,458671000,442460000,901131000
2009,2,WA29,Organische chemische Erzeugnisse,1549546000,1433931000,2983477000
2009,2,WA30,Pharmazeutische Erzeugnisse,3931356000,2839400000,6770756000
2009,2,WA31,Düngemittel,178789000,76490000,255279000
2009,2,WA32,"Gerb- und Farbstoffe, Farben, Lacke usw.",509356000,237083000,746439000
2009,2,WA33,"Etherische Öle, Riech-, Schönheitsmittel",484182000,284930000,769112000
2009,2,WA34,"Seifen, Waschmittel usw.",352101000,190904000,543005000
2009,2,WA35,"Eiweißstoffe, Klebstoffe, Enzyme",161148000,105023000,266171000
2009,2,WA36,"Sprengstoffe, pyrotechnische Artikel usw.",15809000,8393000,24202000
2009,2,WA37,Photochemische Erzeugnisse,86012000,52424000,138436000
2009,2,WA38,Verschiedene Erzeugnisse der Chemischen Industrie,1080826000,774416000,1855242000
2009,2,WA39,Kunststoffe und Waren daraus,2670176000,1652127000,4322303000
2009,2,WA40,Kautschuk und Waren daraus,640142000,629341000,1269483000
2009,2,WA41,"Häute, Felle, Leder",50473000,49051000,99524000
2009,2,WA42,"Lederwaren, Sattlerwaren",108888000,215967000,324855000
2009,2,WA43,"Pelzfelle, künstliches Pelzwerk",5813000,6800000,12613000
2009,2,WA44,"Holz, Holzwaren, Holzkohle",443271000,374714000,817985000
2009,2,WA45,"Kork, Korkwaren",2813000,7168000,9981000
2009,2,WA46,"Flechtwaren, Korbmacherwaren",4148000,11129000,15277000
2009,2,WA47,"Halbstoffe aus Holz usw., Papierabfall",58083000,158009000,216092000
2009,2,WA48,"Papier, Pappe und Waren daraus",1219935000,830943000,2050878000
2009,2,WA49,"Bücher, Zeitungen, Bilddrucke usw.",376886000,171668000,548554000
2009,2,WA50,Seide,5751000,5004000,10755000
2009,2,WA51,"Wolle, feine und grobe Tierhaare",34998000,44418000,79416000
2009,2,WA52,Baumwolle,70349000,63578000,133927000
2009,2,WA53,"Andere pflanzliche Spinnstoffe, Papiergarn",5149000,5175000,10324000
2009,2,WA54,Synthetisches oder künstliches Filament,123644000,85164000,208808000
2009,2,WA55,Synthetische oder künstliche Spinnfaser,111875000,88933000,200808000
2009,2,WA56,"Watte, Filz, Vliesstoff usw., Tauwerk",120760000,76568000,197328000
2009,2,WA57,"Teppiche, Fußbodenbelag aus Spinnstoff",36953000,97510000,134463000
2009,2,WA58,"Spezialgewebe, Spitzen, Tapisserien",30747000,22925000,53672000
2009,2,WA59,"Getränkte, bestrichene usw. Gewebe",109662000,74840000,184502000
2009,2,WA60,Gewirke und Gestricke,56744000,27273000,84017000
2009,2,WA61,"Bekleidung usw. aus Gewirken, Gestricken",487864000,894490000,1382354000
2009,2,WA62,"Andere Bekleidung, Bekleidungszubehör",732650000,1169738000,1902388000
2009,2,WA63,"Andere Konfektion, Spinnstoffwaren usw.",128465000,195272000,323737000
2009,2,WA64,"Schuhe, Gamaschen, ähnliche Waren",303238000,549258000,852496000
2009,2,WA65,Kopfbedeckungen und Teile davon,19464000,33720000,53184000
2009,2,WA66,"Schirme, Gehstöcke usw., Peitschen",16118000,18380000,34498000
2009,2,WA67,"Zugerichtete Federn, Daunen, künstliche Blumen",6407000,10648000,17055000
2009,2,WA68,"Waren aus Steinen, Gips, Zement usw.",196388000,137643000,334031000
2009,2,WA69,Keramische Waren,193995000,146754000,340749000
2009,2,WA70,Glas und Glaswaren,334649000,233390000,568039000
2009,2,WA71,"Perlen, Edelsteine, Edelmetalle",547349000,904144000,1451493000
2009,2,WA72,Eisen und Stahl,1397875000,1335004000,2732879000
2009,2,WA73,Waren aus Eisen oder Stahl,1734017000,1056468000,2790485000
2009,2,WA74,Kupfer und Waren daraus,421628000,364266000,785894000
2009,2,WA75,Nickel und Waren daraus,54482000,95307000,149789000
2009,2,WA76,Aluminium und Waren daraus,742616000,632674000,1375290000
2009,2,WA78,Blei und Waren daraus,21845000,11040000,32885000
2009,2,WA79,Zink und Waren daraus,28021000,37292000,65313000
2009,2,WA80,Zinn und Waren daraus,4726000,16237000,20963000
2009,2,WA81,"Andere unedle Metalle, Cermets usw.",48335000,72297000,120632000
2009,2,WA82,"Werkzeuge, Schneidwaren, Essbestecke",397747000,260996000,658743000
2009,2,WA83,Verschiedene Waren aus unedlen Metallen,375223000,218098000,593321000
2009,2,WA84,"Maschinen, Apparate, mechanische Geräte",11968576000,6795888000,18764464000
2009,2,WA85,Elektrotechnische Erzeugnisse,6413087000,5428114000,11841201000
2009,2,WA86,Schienenfahrzeuge,296212000,125728000,421940000
2009,2,WA87,"Kraftfahrzeuge, Landfahrzeuge",8348735000,4239346000,12588081000
2009,2,WA88,"Luftfahrzeuge, Raumfahrzeuge",1696429000,1868477000,3564906000
2009,2,WA89,Wasserfahrzeuge,401523000,785690000,1187213000
2009,2,WA90,"Optische, photografische usw. Erzeugnisse",2757740000,1573419000,4331159000
2009,2,WA91,Uhrmacherwaren,70576000,76093000,146669000
2009,2,WA92,Musikinstrumente,31008000,28932000,59940000
2009,2,WA93,Waffen und Munition,25334000,11323000,36657000
2009,2,WA94,"Möbel, Beleuchtungskörper usw.",852892000,890512000,1743404000
2009,2,WA95,"Spielzeug, Spiele usw., Sportgeräte",389240000,509585000,898825000
2009,2,WA96,Verschiedene Waren,130435000,87915000,218350000
2009,2,WA97,"Kunstgegenstände, Sammlungsstücke",42992000,16698000,59690000
2009,2,WA98,Vollständige Fabrikationsanlagen,435237000,4684000,439921000
2009,2,WA99,Zusammenstellungen verschiedener Waren,993595000,912019000,1905614000
2009,3,WA01,Lebende Tiere,79377000,128546000,207923000
2009,3,WA02,Fleisch,455543000,381897000,837440000
2009,3,WA03,"Fische, Krebs- und Weichtiere",88800000,222259000,311059000
2009,3,WA04,"Milch, Milcherzeugnisse, Eier, Honig",494883000,435487000,930370000
2009,3,WA05,Andere Waren tierischen Ursprungs,43478000,48704000,92182000
2009,3,WA06,"Pflanzen, Waren des Blumenhandels",69709000,272214000,341923000
2009,3,WA07,"Gemüse, Pflanzen für Ernährung",69534000,433788000,503322000
2009,3,WA08,Genießbare Früchte und Nüsse,109935000,448870000,558805000
2009,3,WA09,"Kaffee, Tee, Mate, Gewürze",142804000,248305000,391109000
2009,3,WA10,Getreide,200944000,231984000,432928000
2009,3,WA11,"Müllereierzeugnisse, Malz usw.",70260000,35614000,105874000
2009,3,WA12,"Ölsamen usw., Heilpflanzen usw.",103739000,308596000,412335000
2009,3,WA13,"Schellack, Gummen, Harz, Pflanzensaft",43826000,29196000,73022000
2009,3,WA14,Flechtstoffe usw. pflanzlichen Ursprungs,776000,1777000,2553000
2009,3,WA15,"Tierische und pflanzliche Fette, Öle, Wachs",140650000,214829000,355479000
2009,3,WA16,"Zubereitungen von Fleisch, Fisch usw.",188663000,151586000,340249000
2009,3,WA17,Zucker und Zuckerwaren,107740000,105666000,213406000
2009,3,WA18,Kakao und Zubereitungen aus Kakao,190239000,178376000,368615000
2009,3,WA19,"Zubereitungen aus Getreide usw., Backwaren",351616000,201455000,553071000
2009,3,WA20,"Zubereitungen von Gemüse, Früchten usw.",182051000,309336000,491387000
2009,3,WA21,Verschiedene Lebensmittelzubereitungen,320373000,230715000,551088000
2009,3,WA22,"Getränke, alkoholhaltige Flüssigkeiten, Essig",304947000,439674000,744621000
2009,3,WA23,"Rückstände der Lebensmittelindustrie, Futter",202063000,236603000,438666000
2009,3,WA24,Tabak,287280000,141886000,429166000
2009,3,WA25,"Salz, Schwefel, Steine, Erden usw.",156766000,106167000,262933000
2009,3,WA26,"Erze, Schlacken, Aschen",11907000,314094000,326001000
2009,3,WA27,Mineralische Brennstoffe usw.,1433899000,6732961000,8166860000
2009,3,WA28,Anorganische chemische Erzeugnisse,527337000,424216000,951553000
2009,3,WA29,Organische chemische Erzeugnisse,1914329000,1513866000,3428195000
2009,3,WA30,Pharmazeutische Erzeugnisse,4131887000,2659889000,6791776000
2009,3,WA31,Düngemittel,261944000,119454000,381398000
2009,3,WA32,"Gerb- und Farbstoffe, Farben, Lacke usw.",571093000,260365000,831458000
2009,3,WA33,"Etherische Öle, Riech-, Schönheitsmittel",537443000,323342000,860785000
2009,3,WA34,"Seifen, Waschmittel usw.",369171000,194334000,563505000
2009,3,WA35,"Eiweißstoffe, Klebstoffe, Enzyme",159555000,127551000,287106000
2009,3,WA36,"Sprengstoffe, pyrotechnische Artikel usw.",14681000,11008000,25689000
2009,3,WA37,Photochemische Erzeugnisse,88399000,66976000,155375000
2009,3,WA38,Verschiedene Erzeugnisse der Chemischen Industrie,1202868000,837094000,2039962000
2009,3,WA39,Kunststoffe und Waren daraus,2975337000,1715646000,4690983000
2009,3,WA40,Kautschuk und Waren daraus,730765000,688224000,1418989000
2009,3,WA41,"Häute, Felle, Leder",48584000,53419000,102003000
2009,3,WA42,"Lederwaren, Sattlerwaren",111753000,161342000,273095000
2009,3,WA43,"Pelzfelle, künstliches Pelzwerk",7738000,9712000,17450000
2009,3,WA44,"Holz, Holzwaren, Holzkohle",523539000,389847000,913386000
2009,3,WA45,"Kork, Korkwaren",2858000,12143000,15001000
2009,3,WA46,"Flechtwaren, Korbmacherwaren",4431000,8181000,12612000
2009,3,WA47,"Halbstoffe aus Holz usw., Papierabfall",65388000,179611000,244999000
2009,3,WA48,"Papier, Pappe und Waren daraus",1272622000,884514000,2157136000
2009,3,WA49,"Bücher, Zeitungen, Bilddrucke usw.",394147000,180198000,574345000
2009,3,WA50,Seide,5347000,4929000,10276000
2009,3,WA51,"Wolle, feine und grobe Tierhaare",44341000,49335000,93676000
2009,3,WA52,Baumwolle,72067000,62840000,134907000
2009,3,WA53,"Andere pflanzliche Spinnstoffe, Papiergarn",3957000,4729000,8686000
2009,3,WA54,Synthetisches oder künstliches Filament,136613000,90381000,226994000
2009,3,WA55,Synthetische oder künstliche Spinnfaser,123972000,95519000,219491000
2009,3,WA56,"Watte, Filz, Vliesstoff usw., Tauwerk",131463000,85146000,216609000
2009,3,WA57,"Teppiche, Fußbodenbelag aus Spinnstoff",41079000,93923000,135002000
2009,3,WA58,"Spezialgewebe, Spitzen, Tapisserien",36618000,25657000,62275000
2009,3,WA59,"Getränkte, bestrichene usw. Gewebe",124575000,87003000,211578000
2009,3,WA60,Gewirke und Gestricke,60431000,31896000,92327000
2009,3,WA61,"Bekleidung usw. aus Gewirken, Gestricken",463747000,836777000,1300524000
2009,3,WA62,"Andere Bekleidung, Bekleidungszubehör",674009000,978002000,1652011000
2009,3,WA63,"Andere Konfektion, Spinnstoffwaren usw.",147366000,200048000,347414000
2009,3,WA64,"Schuhe, Gamaschen, ähnliche Waren",288522000,444847000,733369000
2009,3,WA65,Kopfbedeckungen und Teile davon,23064000,24202000,47266000
2009,3,WA66,"Schirme, Gehstöcke usw., Peitschen",24106000,16218000,40324000
2009,3,WA67,"Zugerichtete Federn, Daunen, künstliche Blumen",5675000,7015000,12690000
2009,3,WA68,"Waren aus Steinen, Gips, Zement usw.",225524000,146867000,372391000
2009,3,WA69,Keramische Waren,201436000,152973000,354409000
2009,3,WA70,Glas und Glaswaren,384753000,258761000,643514000
2009,3,WA71,"Perlen, Edelsteine, Edelmetalle",669655000,1065703000,1735358000
2009,3,WA72,Eisen und Stahl,1412885000,1365589000,2778474000
2009,3,WA73,Waren aus Eisen oder Stahl,1774306000,1041999000,2816305000
2009,3,WA74,Kupfer und Waren daraus,488909000,418476000,907385000
2009,3,WA75,Nickel und Waren daraus,62468000,68433000,130901000
2009,3,WA76,Aluminium und Waren daraus,752127000,617353000,1369480000
2009,3,WA78,Blei und Waren daraus,20632000,11268000,31900000
2009,3,WA79,Zink und Waren daraus,31680000,41332000,73012000
2009,3,WA80,Zinn und Waren daraus,5499000,14075000,19574000
2009,3,WA81,"Andere unedle Metalle, Cermets usw.",61757000,77220000,138977000
2009,3,WA82,"Werkzeuge, Schneidwaren, Essbestecke",405137000,233790000,638927000
2009,3,WA83,Verschiedene Waren aus unedlen Metallen,399162000,222956000,622118000
2009,3,WA84,"Maschinen, Apparate, mechanische Geräte",13350473000,7540422000,20890895000
2009,3,WA85,Elektrotechnische Erzeugnisse,6823415000,6145070000,12968485000
2009,3,WA86,Schienenfahrzeuge,358426000,168432000,526858000
2009,3,WA87,"Kraftfahrzeuge, Landfahrzeuge",9816554000,6033079000,15849633000
2009,3,WA88,"Luftfahrzeuge, Raumfahrzeuge",2093165000,1716123000,3809288000
2009,3,WA89,Wasserfahrzeuge,389503000,119180000,508683000
2009,3,WA90,"Optische, photografische usw. Erzeugnisse",2941880000,1685113000,4626993000
2009,3,WA91,Uhrmacherwaren,76590000,91254000,167844000
2009,3,WA92,Musikinstrumente,28696000,33631000,62327000
2009,3,WA93,Waffen und Munition,36725000,12845000,49570000
2009,3,WA94,"Möbel, Beleuchtungskörper usw.",949922000,953778000,1903700000
2009,3,WA95,"Spielzeug, Spiele usw., Sportgeräte",423424000,522921000,946345000
2009,3,WA96,Verschiedene Waren,143939000,85161000,229100000
2009,3,WA97,"Kunstgegenstände, Sammlungsstücke",37458000,26108000,63566000
2009,3,WA98,Vollständige Fabrikationsanlagen,471181000,2297000,473478000
2009,3,WA99,Zusammenstellungen verschiedener Waren,1151987000,1340909000,2492896000
2009,4,WA01,Lebende Tiere,91210000,124640000,215850000
2009,4,WA02,Fleisch,472450000,408250000,880700000
2009,4,WA03,"Fische, Krebs- und Weichtiere",79259000,210137000,289396000
2009,4,WA04,"Milch, Milcherzeugnisse, Eier, Honig",513227000,465980000,979207000
2009,4,WA05,Andere Waren tierischen Ursprungs,50804000,47970000,98774000
2009,4,WA06,"Pflanzen, Waren des Blumenhandels",93270000,324225000,417495000
2009,4,WA07,"Gemüse, Pflanzen für Ernährung",73972000,501992000,575964000
2009,4,WA08,Genießbare Früchte und Nüsse,98037000,461978000,560015000
2009,4,WA09,"Kaffee, Tee, Mate, Gewürze",129118000,208444000,337562000
2009,4,WA10,Getreide,181861000,193854000,375715000
2009,4,WA11,"Müllereierzeugnisse, Malz usw.",75816000,37676000,113492000
2009,4,WA12,"Ölsamen usw., Heilpflanzen usw.",78156000,277835000,355991000
2009,4,WA13,"Schellack, Gummen, Harz, Pflanzensaft",45028000,30019000,75047000
2009,4,WA14,Flechtstoffe usw. pflanzlichen Ursprungs,1195000,2405000,3600000
2009,4,WA15,"Tierische und pflanzliche Fette, Öle, Wachs",109679000,187196000,296875000
2009,4,WA16,"Zubereitungen von Fleisch, Fisch usw.",175745000,157275000,333020000
2009,4,WA17,Zucker und Zuckerwaren,113533000,109196000,222729000
2009,4,WA18,Kakao und Zubereitungen aus Kakao,154031000,187527000,341558000
2009,4,WA19,"Zubereitungen aus Getreide usw., Backwaren",336124000,196955000,533079000
2009,4,WA20,"Zubereitungen von Gemüse, Früchten usw.",160224000,334961000,495185000
2009,4,WA21,Verschiedene Lebensmittelzubereitungen,290869000,217148000,508017000
2009,4,WA22,"Getränke, alkoholhaltige Flüssigkeiten, Essig",358457000,429659000,788116000
2009,4,WA23,"Rückstände der Lebensmittelindustrie, Futter",199424000,199517000,398941000
2009,4,WA24,Tabak,233147000,139531000,372678000
2009,4,WA25,"Salz, Schwefel, Steine, Erden usw.",164494000,108633000,273127000
2009,4,WA26,"Erze, Schlacken, Aschen",19451000,305139000,324590000
2009,4,WA27,Mineralische Brennstoffe usw.,1347593000,5745376000,7092969000
2009,4,WA28,Anorganische chemische Erzeugnisse,493895000,390360000,884255000
2009,4,WA29,Organische chemische Erzeugnisse,2120406000,1534814000,3655220000
2009,4,WA30,Pharmazeutische Erzeugnisse,3563548000,2733757000,6297305000
2009,4,WA31,Düngemittel,187003000,78971000,265974000
2009,4,WA32,"Gerb- und Farbstoffe, Farben, Lacke usw.",576707000,248081000,824788000
2009,4,WA33,"Etherische Öle, Riech-, Schönheitsmittel",508516000,290640000,799156000
2009,4,WA34,"Seifen, Waschmittel usw.",367299000,174660000,541959000
2009,4,WA35,"Eiweißstoffe, Klebstoffe, Enzyme",162279000,125678000,287957000
2009,4,WA36,"Sprengstoffe, pyrotechnische Artikel usw.",13758000,11665000,25423000
2009,4,WA37,Photochemische Erzeugnisse,68608000,59630000,128238000
2009,4,WA38,Verschiedene Erzeugnisse der Chemischen Industrie,1074017000,729654000,1803671000
2009,4,WA39,Kunststoffe und Waren daraus,2980666000,1706078000,4686744000
2009,4,WA40,Kautschuk und Waren daraus,701276000,653339000,1354615000
2009,4,WA41,"Häute, Felle, Leder",50084000,47607000,97691000
2009,4,WA42,"Lederwaren, Sattlerwaren",88408000,164163000,252571000
2009,4,WA43,"Pelzfelle, künstliches Pelzwerk",10440000,10760000,21200000
2009,4,WA44,"Holz, Holzwaren, Holzkohle",496665000,401054000,897719000
2009,4,WA45,"Kork, Korkwaren",2668000,9675000,12343000
2009,4,WA46,"Flechtwaren, Korbmacherwaren",3639000,9692000,13331000
2009,4,WA47,"Halbstoffe aus Holz usw., Papierabfall",60634000,183268000,243902000
2009,4,WA48,"Papier, Pappe und Waren daraus",1235531000,834962000,2070493000
2009,4,WA49,"Bücher, Zeitungen, Bilddrucke usw.",354862000,182527000,537389000
2009,4,WA50,Seide,5826000,5565000,11391000
2009,4,WA51,"Wolle, feine und grobe Tierhaare",50519000,52131000,102650000
2009,4,WA52,Baumwolle,71529000,67757000,139286000
2009,4,WA53,"Andere pflanzliche Spinnstoffe, Papiergarn",2702000,4663000,7365000
2009,4,WA54,Synthetisches oder künstliches Filament,144999000,96529000,241528000
2009,4,WA55,Synthetische oder künstliche Spinnfaser,128526000,85400000,213926000
2009,4,WA56,"Watte, Filz, Vliesstoff usw., Tauwerk",127215000,87005000,214220000
2009,4,WA57,"Teppiche, Fußbodenbelag aus Spinnstoff",37004000,82503000,119507000
2009,4,WA58,"Spezialgewebe, Spitzen, Tapisserien",38042000,24981000,63023000
2009,4,WA59,"Getränkte, bestrichene usw. Gewebe",113218000,81457000,194675000
2009,4,WA60,Gewirke und Gestricke,62908000,32669000,95577000
2009,4,WA61,"Bekleidung usw. aus Gewirken, Gestricken",367734000,754203000,1121937000
2009,4,WA62,"Andere Bekleidung, Bekleidungszubehör",484463000,849323000,1333786000
2009,4,WA63,"Andere Konfektion, Spinnstoffwaren usw.",137563000,211059000,348622000
2009,4,WA64,"Schuhe, Gamaschen, ähnliche Waren",200714000,356441000,557155000
2009,4,WA65,Kopfbedeckungen und Teile davon,16947000,23322000,40269000
2009,4,WA66,"Schirme, Gehstöcke usw., Peitschen",15701000,19166000,34867000
2009,4,WA67,"Zugerichtete Federn, Daunen, künstliche Blumen",4482000,7717000,12199000
2009,4,WA68,"Waren aus Steinen, Gips, Zement usw.",235383000,155961000,391344000
2009,4,WA69,Keramische Waren,218230000,148737000,366967000
2009,4,WA70,Glas und Glaswaren,356398000,233543000,589941000
2009,4,WA71,"Perlen, Edelsteine, Edelmetalle",617776000,1011147000,1628923000
2009,4,WA72,Eisen und Stahl,1203136000,1088250000,2291386000
2009,4,WA73,Waren aus Eisen oder Stahl,1722039000,1010316000,2732355000
2009,4,WA74,Kupfer und Waren daraus,550607000,358924000,909531000
2009,4,WA75,Nickel und Waren daraus,46588000,55857000,102445000
2009,4,WA76,Aluminium und Waren daraus,751760000,639599000,1391359000
2009,4,WA78,Blei und Waren daraus,21190000,10676000,31866000
2009,4,WA79,Zink und Waren daraus,34278000,42079000,76357000
2009,4,WA80,Zinn und Waren daraus,4635000,12959000,17594000
2009,4,WA81,"Andere unedle Metalle, Cermets usw.",46301000,78366000,124667000
2009,4,WA82,"Werkzeuge, Schneidwaren, Essbestecke",366711000,229967000,596678000
2009,4,WA83,Verschiedene Waren aus unedlen Metallen,401791000,235794000,637585000
2009,4,WA84,"Maschinen, Apparate, mechanische Geräte",12131141000,6576283000,18707424000
2009,4,WA85,Elektrotechnische Erzeugnisse,6221510000,5537920000,11759430000
2009,4,WA86,Schienenfahrzeuge,321508000,166851000,488359000
2009,4,WA87,"Kraftfahrzeuge, Landfahrzeuge",8511895000,5182937000,13694832000
2009,4,WA88,"Luftfahrzeuge, Raumfahrzeuge",1884844000,1574150000,3458994000
2009,4,WA89,Wasserfahrzeuge,52823000,561956000,614779000
2009,4,WA90,"Optische, photografische usw. Erzeugnisse",2807043000,1691493000,4498536000
2009,4,WA91,Uhrmacherwaren,71999000,86135000,158134000
2009,4,WA92,Musikinstrumente,29399000,33348000,62747000
2009,4,WA93,Waffen und Munition,31141000,11078000,42219000
2009,4,WA94,"Möbel, Beleuchtungskörper usw.",882161000,945352000,1827513000
2009,4,WA95,"Spielzeug, Spiele usw., Sportgeräte",420116000,480479000,900595000
2009,4,WA96,Verschiedene Waren,131382000,95847000,227229000
2009,4,WA97,"Kunstgegenstände, Sammlungsstücke",57302000,17588000,74890000
2009,4,WA98,Vollständige Fabrikationsanlagen,378379000,2833000,381212000
2009,4,WA99,Zusammenstellungen verschiedener Waren,1114511000,1022296000,2136807000
2009,5,WA01,Lebende Tiere,80265000,157768000,238033000
2009,5,WA02,Fleisch,490835000,377968000,868803000
2009,5,WA03,"Fische, Krebs- und Weichtiere",76621000,195519000,272140000
2009,5,WA04,"Milch, Milcherzeugnisse, Eier, Honig",476108000,378671000,854779000
2009,5,WA05,Andere Waren tierischen Ursprungs,39933000,51566000,91499000
2009,5,WA06,"Pflanzen, Waren des Blumenhandels",56373000,255560000,311933000
2009,5,WA07,"Gemüse, Pflanzen für Ernährung",68634000,417658000,486292000
2009,5,WA08,Genießbare Früchte und Nüsse,101698000,487840000,589538000
2009,5,WA09,"Kaffee, Tee, Mate, Gewürze",125531000,186203000,311734000
2009,5,WA10,Getreide,179087000,163291000,342378000
2009,5,WA11,"Müllereierzeugnisse, Malz usw.",71281000,33012000,104293000
2009,5,WA12,"Ölsamen usw., Heilpflanzen usw.",50656000,257156000,307812000
2009,5,WA13,"Schellack, Gummen, Harz, Pflanzensaft",34743000,24044000,58787000
2009,5,WA14,Flechtstoffe usw. pflanzlichen Ursprungs,777000,1735000,2512000
2009,5,WA15,"Tierische und pflanzliche Fette, Öle, Wachs",131315000,178954000,310269000
2009,5,WA16,"Zubereitungen von Fleisch, Fisch usw.",182187000,149657000,331844000
2009,5,WA17,Zucker und Zuckerwaren,109026000,106747000,215773000
2009,5,WA18,Kakao und Zubereitungen aus Kakao,150768000,158289000,309057000
2009,5,WA19,"Zubereitungen aus Getreide usw., Backwaren",325354000,195929000,521283000
2009,5,WA20,"Zubereitungen von Gemüse, Früchten usw.",177947000,274714000,452661000
2009,5,WA21,Verschiedene Lebensmittelzubereitungen,331251000,211701000,542952000
2009,5,WA22,"Getränke, alkoholhaltige Flüssigkeiten, Essig",320392000,410705000,731097000
2009,5,WA23,"Rückstände der Lebensmittelindustrie, Futter",194699000,211925000,406624000
2009,5,WA24,Tabak,301153000,119781000,420934000
2009,5,WA25,"Salz, Schwefel, Steine, Erden usw.",155028000,100974000,256002000
2009,5,WA26,"Erze, Schlacken, Aschen",13837000,236183000,250020000
2009,5,WA27,Mineralische Brennstoffe usw.,1249276000,5812071000,7061347000
2009,5,WA28,Anorganische chemische Erzeugnisse,467090000,327919000,795009000
2009,5,WA29,Organische chemische Erzeugnisse,1381170000,1473588000,2854758000
2009,5,WA30,Pharmazeutische Erzeugnisse,3504556000,2499397000,6003953000
2009,5,WA31,Düngemittel,155281000,50597000,205878000
2009,5,WA32,"Gerb- und Farbstoffe, Farben, Lacke usw.",580763000,239684000,820447000
2009,5,WA33,"Etherische Öle, Riech-, Schönheitsmittel",475752000,274617000,750369000
2009,5,WA34,"Seifen, Waschmittel usw.",353536000,174153000,527689000
2009,5,WA35,"Eiweißstoffe, Klebstoffe, Enzyme",149727000,108790000,258517000
2009,5,WA36,"Sprengstoffe, pyrotechnische Artikel usw.",11098000,11044000,22142000
2009,5,WA37,Photochemische Erzeugnisse,89795000,68331000,158126000
2009,5,WA38,Verschiedene Erzeugnisse der Chemischen Industrie,948714000,669264000,1617978000
2009,5,WA39,Kunststoffe und Waren daraus,2911934000,1656873000,4568807000
2009,5,WA40,Kautschuk und Waren daraus,676776000,573741000,1250517000
2009,5,WA41,"Häute, Felle, Leder",45024000,44637000,89661000
2009,5,WA42,"Lederwaren, Sattlerwaren",83249000,166584000,249833000
2009,5,WA43,"Pelzfelle, künstliches Pelzwerk",9974000,10241000,20215000
2009,5,WA44,"Holz, Holzwaren, Holzkohle",483042000,369617000,852659000
2009,5,WA45,"Kork, Korkwaren",2672000,7392000,10064000
2009,5,WA46,"Flechtwaren, Korbmacherwaren",3271000,9778000,13049000
2009,5,WA47,"Halbstoffe aus Holz usw., Papierabfall",75696000,170196000,245892000
2009,5,WA48,"Papier, Pappe und Waren daraus",1179239000,830333000,2009572000
2009,5,WA49,"Bücher, Zeitungen, Bilddrucke usw.",302798000,138837000,441635000
2009,5,WA50,Seide,4680000,4457000,9137000
2009,5,WA51,"Wolle, feine und grobe Tierhaare",58872000,55262000,114134000
2009,5,WA52,Baumwolle,67243000,61697000,128940000
2009,5,WA53,"Andere pflanzliche Spinnstoffe, Papiergarn",2584000,4085000,6669000
2009,5,WA54,Synthetisches oder künstliches Filament,134643000,85528000,220171000
2009,5,WA55,Synthetische oder künstliche Spinnfaser,132317000,85172000,217489000
2009,5,WA56,"Watte, Filz, Vliesstoff usw., Tauwerk",132823000,71364000,204187000
2009,5,WA57,"Teppiche, Fußbodenbelag aus Spinnstoff",31526000,75444000,106970000
2009,5,WA58,"Spezialgewebe, Spitzen, Tapisserien",35154000,22983000,58137000
2009,5,WA59,"Getränkte, bestrichene usw. Gewebe",107229000,61846000,169075000
2009,5,WA60,Gewirke und Gestricke,62974000,32667000,95641000
2009,5,WA61,"Bekleidung usw. aus Gewirken, Gestricken",309295000,683918000,993213000
2009,5,WA62,"Andere Bekleidung, Bekleidungszubehör",359847000,753909000,1113756000
2009,5,WA63,"Andere Konfektion, Spinnstoffwaren usw.",130711000,186748000,317459000
2009,5,WA64,"Schuhe, Gamaschen, ähnliche Waren",146659000,335702000,482361000
2009,5,WA65,Kopfbedeckungen und Teile davon,14083000,22937000,37020000
2009,5,WA66,"Schirme, Gehstöcke usw., Peitschen",13099000,13327000,26426000
2009,5,WA67,"Zugerichtete Federn, Daunen, künstliche Blumen",4719000,10211000,14930000
2009,5,WA68,"Waren aus Steinen, Gips, Zement usw.",205533000,144767000,350300000
2009,5,WA69,Keramische Waren,190460000,142196000,332656000
2009,5,WA70,Glas und Glaswaren,347757000,266592000,614349000
2009,5,WA71,"Perlen, Edelsteine, Edelmetalle",598606000,703896000,1302502000
2009,5,WA72,Eisen und Stahl,1267072000,1020514000,2287586000
2009,5,WA73,Waren aus Eisen oder Stahl,1616035000,889473000,2505508000
2009,5,WA74,Kupfer und Waren daraus,528368000,394764000,923132000
2009,5,WA75,Nickel und Waren daraus,48997000,46499000,95496000
2009,5,WA76,Aluminium und Waren daraus,694733000,589542000,1284275000
2009,5,WA78,Blei und Waren daraus,27261000,9653000,36914000
2009,5,WA79,Zink und Waren daraus,34153000,46651000,80804000
2009,5,WA80,Zinn und Waren daraus,5334000,14995000,20329000
2009,5,WA81,"Andere unedle Metalle, Cermets usw.",50119000,55608000,105727000
2009,5,WA82,"Werkzeuge, Schneidwaren, Essbestecke",353926000,204563000,558489000
2009,5,WA83,Verschiedene Waren aus unedlen Metallen,391402000,227867000,619269000
2009,5,WA84,"Maschinen, Apparate, mechanische Geräte",10810818000,6229692000,17040510000
2009,5,WA85,Elektrotechnische Erzeugnisse,5933570000,5151962000,11085532000
2009,5,WA86,Schienenfahrzeuge,354301000,125153000,479454000
2009,5,WA87,"Kraftfahrzeuge, Landfahrzeuge",8822945000,4770991000,13593936000
2009,5,WA88,"Luftfahrzeuge, Raumfahrzeuge",2025352000,1565056000,3590408000
2009,5,WA89,Wasserfahrzeuge,25909000,58327000,84236000
2009,5,WA90,"Optische, photografische usw. Erzeugnisse",2535952000,1525806000,4061758000
2009,5,WA91,Uhrmacherwaren,71229000,87118000,158347000
2009,5,WA92,Musikinstrumente,26100000,30080000,56180000
2009,5,WA93,Waffen und Munition,24058000,10929000,34987000
2009,5,WA94,"Möbel, Beleuchtungskörper usw.",786221000,852330000,1638551000
2009,5,WA95,"Spielzeug, Spiele usw., Sportgeräte",317797000,498077000,815874000
2009,5,WA96,Verschiedene Waren,139669000,94538000,234207000
2009,5,WA97,"Kunstgegenstände, Sammlungsstücke",38945000,37727000,76672000
2009,5,WA98,Vollständige Fabrikationsanlagen,267139000,1347000,268486000
2009,5,WA99,Zusammenstellungen verschiedener Waren,978432000,930318000,1908750000
2009,6,WA01,Lebende Tiere,79186000,96489000,175675000
2009,6,WA02,Fleisch,458449000,372895000,831344000
2009,6,WA03,"Fische, Krebs- und Weichtiere",71906000,205004000,276910000
2009,6,WA04,"Milch, Milcherzeugnisse, Eier, Honig",499169000,411730000,910899000
2009,6,WA05,Andere Waren tierischen Ursprungs,53137000,57631000,110768000
2009,6,WA06,"Pflanzen, Waren des Blumenhandels",44684000,201130000,245814000
2009,6,WA07,"Gemüse, Pflanzen für Ernährung",65311000,315911000,381222000
2009,6,WA08,Genießbare Früchte und Nüsse,106372000,475435000,581807000
2009,6,WA09,"Kaffee, Tee, Mate, Gewürze",119727000,203397000,323124000
2009,6,WA10,Getreide,262550000,143192000,405742000
2009,6,WA11,"Müllereierzeugnisse, Malz usw.",72342000,37534000,109876000
2009,6,WA12,"Ölsamen usw., Heilpflanzen usw.",48462000,248104000,296566000
2009,6,WA13,"Schellack, Gummen, Harz, Pflanzensaft",40504000,25531000,66035000
2009,6,WA14,Flechtstoffe usw. pflanzlichen Ursprungs,577000,1467000,2044000
2009,6,WA15,"Tierische und pflanzliche Fette, Öle, Wachs",141343000,185040000,326383000
2009,6,WA16,"Zubereitungen von Fleisch, Fisch usw.",181686000,150924000,332610000
2009,6,WA17,Zucker und Zuckerwaren,123048000,106728000,229776000
2009,6,WA18,Kakao und Zubereitungen aus Kakao,166159000,157283000,323442000
2009,6,WA19,"Zubereitungen aus Getreide usw., Backwaren",309631000,169910000,479541000
2009,6,WA20,"Zubereitungen von Gemüse, Früchten usw.",176028000,287208000,463236000
2009,6,WA21,Verschiedene Lebensmittelzubereitungen,312665000,214728000,527393000
2009,6,WA22,"Getränke, alkoholhaltige Flüssigkeiten, Essig",367048000,431776000,798824000
2009,6,WA23,"Rückstände der Lebensmittelindustrie, Futter",188042000,204258000,392300000
2009,6,WA24,Tabak,273997000,137608000,411605000
2009,6,WA25,"Salz, Schwefel, Steine, Erden usw.",167826000,106611000,274437000
2009,6,WA26,"Erze, Schlacken, Aschen",14944000,332583000,347527000
2009,6,WA27,Mineralische Brennstoffe usw.,1478160000,5764439000,7242599000
2009,6,WA28,Anorganische chemische Erzeugnisse,606044000,498852000,1104896000
2009,6,WA29,Organische chemische Erzeugnisse,1522621000,1514356000,3036977000
2009,6,WA30,Pharmazeutische Erzeugnisse,3590721000,2423279000,6014000000
2009,6,WA31,Düngemittel,141705000,58850000,200555000
2009,6,WA32,"Gerb- und Farbstoffe, Farben, Lacke usw.",666748000,262299000,929047000
2009,6,WA33,"Etherische Öle, Riech-, Schönheitsmittel",492672000,288485000,781157000
2009,6,WA34,"Seifen, Waschmittel usw.",385290000,194996000,580286000
2009,6,WA35,"Eiweißstoffe, Klebstoffe, Enzyme",161045000,110476000,271521000
2009,6,WA36,"Sprengstoffe, pyrotechnische Artikel usw.",14988000,15382000,30370000
2009,6,WA37,Photochemische Erzeugnisse,102180000,66290000,168470000
2009,6,WA38,Verschiedene Erzeugnisse der Chemischen Industrie,1039692000,719454000,1759146000
2009,6,WA39,Kunststoffe und Waren daraus,3226173000,1772522000,4998695000
2009,6,WA40,Kautschuk und Waren daraus,762628000,616822000,1379450000
2009,6,WA41,"Häute, Felle, Leder",49187000,45938000,95125000
2009,6,WA42,"Lederwaren, Sattlerwaren",98517000,197634000,296151000
2009,6,WA43,"Pelzfelle, künstliches Pelzwerk",9721000,11954000,21675000
2009,6,WA44,"Holz, Holzwaren, Holzkohle",518011000,382459000,900470000
2009,6,WA45,"Kork, Korkwaren",2534000,5367000,7901000
2009,6,WA46,"Flechtwaren, Korbmacherwaren",3299000,10509000,13808000
2009,6,WA47,"Halbstoffe aus Holz usw., Papierabfall",78008000,171315000,249323000
2009,6,WA48,"Papier, Pappe und Waren daraus",1274206000,799803000,2074009000
2009,6,WA49,"Bücher, Zeitungen, Bilddrucke usw.",340543000,156893000,497436000
2009,6,WA50,Seide,4504000,4366000,8870000
2009,6,WA51,"Wolle, feine und grobe Tierhaare",58157000,46331000,104488000
2009,6,WA52,Baumwolle,69763000,58653000,128416000
2009,6,WA53,"Andere pflanzliche Spinnstoffe, Papiergarn",2251000,4444000,6695000
2009,6,WA54,Synthetisches oder künstliches Filament,134745000,92233000,226978000
2009,6,WA55,Synthetische oder künstliche Spinnfaser,136857000,88875000,225732000
2009,6,WA56,"Watte, Filz, Vliesstoff usw., Tauwerk",146208000,70961000,217169000
2009,6,WA57,"Teppiche, Fußbodenbelag aus Spinnstoff",37750000,71970000,109720000
2009,6,WA58,"Spezialgewebe, Spitzen, Tapisserien",39519000,24847000,64366000
2009,6,WA59,"Getränkte, bestrichene usw. Gewebe",127865000,99748000,227613000
2009,6,WA60,Gewirke und Gestricke,56287000,29384000,85671000
2009,6,WA61,"Bekleidung usw. aus Gewirken, Gestricken",340580000,864224000,1204804000
2009,6,WA62,"Andere Bekleidung, Bekleidungszubehör",389386000,872614000,1262000000
2009,6,WA63,"Andere Konfektion, Spinnstoffwaren usw.",130578000,187295000,317873000
2009,6,WA64,"Schuhe, Gamaschen, ähnliche Waren",190021000,430598000,620619000
2009,6,WA65,Kopfbedeckungen und Teile davon,16128000,26595000,42723000
2009,6,WA66,"Schirme, Gehstöcke usw., Peitschen",18142000,8966000,27108000
2009,6,WA67,"Zugerichtete Federn, Daunen, künstliche Blumen",3963000,10873000,14836000
2009,6,WA68,"Waren aus Steinen, Gips, Zement usw.",245576000,155770000,401346000
2009,6,WA69,Keramische Waren,216184000,150461000,366645000
2009,6,WA70,Glas und Glaswaren,374098000,264432000,638530000
2009,6,WA71,"Perlen, Edelsteine, Edelmetalle",603543000,695062000,1298605000
2009,6,WA72,Eisen und Stahl,1342361000,1103996000,2446357000
2009,6,WA73,Waren aus Eisen oder Stahl,1621206000,983385000,2604591000
2009,6,WA74,Kupfer und Waren daraus,496607000,480257000,976864000
2009,6,WA75,Nickel und Waren daraus,51321000,62439000,113760000
2009,6,WA76,Aluminium und Waren daraus,738499000,621165000,1359664000
2009,6,WA78,Blei und Waren daraus,30377000,17027000,47404000
2009,6,WA79,Zink und Waren daraus,37260000,45509000,82769000
2009,6,WA80,Zinn und Waren daraus,6505000,13360000,19865000
2009,6,WA81,"Andere unedle Metalle, Cermets usw.",51385000,58325000,109710000
2009,6,WA82,"Werkzeuge, Schneidwaren, Essbestecke",379441000,220147000,599588000
2009,6,WA83,Verschiedene Waren aus unedlen Metallen,436964000,241037000,678001000
2009,6,WA84,"Maschinen, Apparate, mechanische Geräte",11922201000,6784024000,18706225000
2009,6,WA85,Elektrotechnische Erzeugnisse,6597520000,5783302000,12380822000
2009,6,WA86,Schienenfahrzeuge,265975000,139088000,405063000
2009,6,WA87,"Kraftfahrzeuge, Landfahrzeuge",10145093000,5134225000,15279318000
2009,6,WA88,"Luftfahrzeuge, Raumfahrzeuge",2050317000,1446443000,3496760000
2009,6,WA89,Wasserfahrzeuge,544837000,271794000,816631000
2009,6,WA90,"Optische, photografische usw. Erzeugnisse",2765985000,1674930000,4440915000
2009,6,WA91,Uhrmacherwaren,68987000,77664000,146651000
2009,6,WA92,Musikinstrumente,32836000,29069000,61905000
2009,6,WA93,Waffen und Munition,28433000,12847000,41280000
2009,6,WA94,"Möbel, Beleuchtungskörper usw.",889034000,857965000,1746999000
2009,6,WA95,"Spielzeug, Spiele usw., Sportgeräte",317778000,312407000,630185000
2009,6,WA96,Verschiedene Waren,141226000,87894000,229120000
2009,6,WA97,"Kunstgegenstände, Sammlungsstücke",43114000,51083000,94197000
2009,6,WA98,Vollständige Fabrikationsanlagen,414901000,4645000,419546000
2009,6,WA99,Zusammenstellungen verschiedener Waren,1226971000,1031614000,2258585000
2009,7,WA01,Lebende Tiere,81706000,133040000,214746000
2009,7,WA02,Fleisch,539521000,364780000,904301000
2009,7,WA03,"Fische, Krebs- und Weichtiere",79657000,198089000,277746000
2009,7,WA04,"Milch, Milcherzeugnisse, Eier, Honig",505847000,383830000,889677000
2009,7,WA05,Andere Waren tierischen Ursprungs,50725000,52431000,103156000
2009,7,WA06,"Pflanzen, Waren des Blumenhandels",33749000,153932000,187681000
2009,7,WA07,"Gemüse, Pflanzen für Ernährung",71389000,295531000,366920000
2009,7,WA08,Genießbare Früchte und Nüsse,96498000,473111000,569609000
2009,7,WA09,"Kaffee, Tee, Mate, Gewürze",128460000,209511000,337971000
2009,7,WA10,Getreide,224290000,129419000,353709000
2009,7,WA11,"Müllereierzeugnisse, Malz usw.",78333000,37082000,115415000
2009,7,WA12,"Ölsamen usw., Heilpflanzen usw.",57356000,256404000,313760000
2009,7,WA13,"Schellack, Gummen, Harz, Pflanzensaft",37276000,26418000,63694000
2009,7,WA14,Flechtstoffe usw. pflanzlichen Ursprungs,652000,1593000,2245000
2009,7,WA15,"Tierische und pflanzliche Fette, Öle, Wachs",119307000,182816000,302123000
2009,7,WA16,"Zubereitungen von Fleisch, Fisch usw.",200226000,159597000,359823000
2009,7,WA17,Zucker und Zuckerwaren,130573000,119590000,250163000
2009,7,WA18,Kakao und Zubereitungen aus Kakao,187232000,237749000,424981000
2009,7,WA19,"Zubereitungen aus Getreide usw., Backwaren",341529000,208506000,550035000
2009,7,WA20,"Zubereitungen von Gemüse, Früchten usw.",185151000,288569000,473720000
2009,7,WA21,Verschiedene Lebensmittelzubereitungen,344105000,249872000,593977000
2009,7,WA22,"Getränke, alkoholhaltige Flüssigkeiten, Essig",380841000,464998000,845839000
2009,7,WA23,"Rückstände der Lebensmittelindustrie, Futter",210893000,236536000,447429000
2009,7,WA24,Tabak,323298000,160149000,483447000
2009,7,WA25,"Salz, Schwefel, Steine, Erden usw.",159440000,118368000,277808000
2009,7,WA26,"Erze, Schlacken, Aschen",13880000,286066000,299946000
2009,7,WA27,Mineralische Brennstoffe usw.,1505169000,6265121000,7770290000
2009,7,WA28,Anorganische chemische Erzeugnisse,551327000,411615000,962942000
2009,7,WA29,Organische chemische Erzeugnisse,1556019000,1586165000,3142184000
2009,7,WA30,Pharmazeutische Erzeugnisse,4169610000,2896890000,7066500000
2009,7,WA31,Düngemittel,134802000,79594000,214396000
2009,7,WA32,"Gerb- und Farbstoffe, Farben, Lacke usw.",685679000,272028000,957707000
2009,7,WA33,"Etherische Öle, Riech-, Schönheitsmittel",582108000,345284000,927392000
2009,7,WA34,"Seifen, Waschmittel usw.",425216000,222735000,647951000
2009,7,WA35,"Eiweißstoffe, Klebstoffe, Enzyme",180746000,121668000,302414000
2009,7,WA36,"Sprengstoffe, pyrotechnische Artikel usw.",14217000,17667000,31884000
2009,7,WA37,Photochemische Erzeugnisse,102379000,66710000,169089000
2009,7,WA38,Verschiedene Erzeugnisse der Chemischen Industrie,1118974000,750370000,1869344000
2009,7,WA39,Kunststoffe und Waren daraus,3420252000,1883539000,5303791000
2009,7,WA40,Kautschuk und Waren daraus,786835000,693210000,1480045000
2009,7,WA41,"Häute, Felle, Leder",54546000,47761000,102307000
2009,7,WA42,"Lederwaren, Sattlerwaren",118927000,202863000,321790000
2009,7,WA43,"Pelzfelle, künstliches Pelzwerk",14459000,13591000,28050000
2009,7,WA44,"Holz, Holzwaren, Holzkohle",507244000,387425000,894669000
2009,7,WA45,"Kork, Korkwaren",3291000,10098000,13389000
2009,7,WA46,"Flechtwaren, Korbmacherwaren",3379000,9678000,13057000
2009,7,WA47,"Halbstoffe aus Holz usw., Papierabfall",74341000,183940000,258281000
2009,7,WA48,"Papier, Pappe und Waren daraus",1447519000,890119000,2337638000
2009,7,WA49,"Bücher, Zeitungen, Bilddrucke usw.",346568000,190278000,536846000
2009,7,WA50,Seide,4565000,4255000,8820000
2009,7,WA51,"Wolle, feine und grobe Tierhaare",43408000,42591000,85999000
2009,7,WA52,Baumwolle,67548000,52227000,119775000
2009,7,WA53,"Andere pflanzliche Spinnstoffe, Papiergarn",2675000,4530000,7205000
2009,7,WA54,Synthetisches oder künstliches Filament,155568000,88555000,244123000
2009,7,WA55,Synthetische oder künstliche Spinnfaser,137659000,84088000,221747000
2009,7,WA56,"Watte, Filz, Vliesstoff usw., Tauwerk",150094000,78626000,228720000
2009,7,WA57,"Teppiche, Fußbodenbelag aus Spinnstoff",36996000,70883000,107879000
2009,7,WA58,"Spezialgewebe, Spitzen, Tapisserien",39030000,24376000,63406000
2009,7,WA59,"Getränkte, bestrichene usw. Gewebe",132033000,80218000,212251000
2009,7,WA60,Gewirke und Gestricke,60235000,27857000,88092000
2009,7,WA61,"Bekleidung usw. aus Gewirken, Gestricken",492642000,1059777000,1552419000
2009,7,WA62,"Andere Bekleidung, Bekleidungszubehör",584906000,1104309000,1689215000
2009,7,WA63,"Andere Konfektion, Spinnstoffwaren usw.",145516000,193244000,338760000
2009,7,WA64,"Schuhe, Gamaschen, ähnliche Waren",275776000,540486000,816262000
2009,7,WA65,Kopfbedeckungen und Teile davon,17145000,29945000,47090000
2009,7,WA66,"Schirme, Gehstöcke usw., Peitschen",18015000,7968000,25983000
2009,7,WA67,"Zugerichtete Federn, Daunen, künstliche Blumen",4531000,11587000,16118000
2009,7,WA68,"Waren aus Steinen, Gips, Zement usw.",244257000,162640000,406897000
2009,7,WA69,Keramische Waren,211315000,149440000,360755000
2009,7,WA70,Glas und Glaswaren,392772000,285667000,678439000
2009,7,WA71,"Perlen, Edelsteine, Edelmetalle",674459000,861698000,1536157000
2009,7,WA72,Eisen und Stahl,1366848000,1138326000,2505174000
2009,7,WA73,Waren aus Eisen oder Stahl,1713143000,1023614000,2736757000
2009,7,WA74,Kupfer und Waren daraus,624308000,428846000,1053154000
2009,7,WA75,Nickel und Waren daraus,46077000,66912000,112989000
2009,7,WA76,Aluminium und Waren daraus,858429000,657307000,1515736000
2009,7,WA78,Blei und Waren daraus,22837000,12870000,35707000
2009,7,WA79,Zink und Waren daraus,42259000,53762000,96021000
2009,7,WA80,Zinn und Waren daraus,6647000,13266000,19913000
2009,7,WA81,"Andere unedle Metalle, Cermets usw.",55256000,72307000,127563000
2009,7,WA82,"Werkzeuge, Schneidwaren, Essbestecke",417365000,244689000,662054000
2009,7,WA83,Verschiedene Waren aus unedlen Metallen,468675000,260606000,729281000
2009,7,WA84,"Maschinen, Apparate, mechanische Geräte",13156167000,6781774000,19937941000
2009,7,WA85,Elektrotechnische Erzeugnisse,6914309000,5913867000,12828176000
2009,7,WA86,Schienenfahrzeuge,301690000,122297000,423987000
2009,7,WA87,"Kraftfahrzeuge, Landfahrzeuge",10220681000,4651983000,14872664000
2009,7,WA88,"Luftfahrzeuge, Raumfahrzeuge",1604563000,1001210000,2605773000
2009,7,WA89,Wasserfahrzeuge,136296000,349894000,486190000
2009,7,WA90,"Optische, photografische usw. Erzeugnisse",3095090000,1589227000,4684317000
2009,7,WA91,Uhrmacherwaren,90884000,103206000,194090000
2009,7,WA92,Musikinstrumente,33001000,29871000,62872000
2009,7,WA93,Waffen und Munition,38664000,13599000,52263000
2009,7,WA94,"Möbel, Beleuchtungskörper usw.",896678000,826040000,1722718000
2009,7,WA95,"Spielzeug, Spiele usw., Sportgeräte",377476000,649307000,1026783000
2009,7,WA96,Verschiedene Waren,161679000,98650000,260329000
2009,7,WA97,"Kunstgegenstände, Sammlungsstücke",30285000,26522000,56807000
2009,7,WA98,Vollständige Fabrikationsanlagen,373423000,1489000,374912000
2009,7,WA99,Zusammenstellungen verschiedener Waren,1247916000,912875000,2160791000
2009,8,WA01,Lebende Tiere,96098000,127725000,223823000
2009,8,WA02,Fleisch,513345000,394075000,907420000
2009,8,WA03,"Fische, Krebs- und Weichtiere",80637000,189023000,269660000
2009,8,WA04,"Milch, Milcherzeugnisse, Eier, Honig",500667000,422182000,922849000
2009,8,WA05,Andere Waren tierischen Ursprungs,40946000,49308000,90254000
2009,8,WA06,"Pflanzen, Waren des Blumenhandels",37692000,159253000,196945000
2009,8,WA07,"Gemüse, Pflanzen für Ernährung",63472000,242949000,306421000
2009,8,WA08,Genießbare Früchte und Nüsse,81923000,473606000,555529000
2009,8,WA09,"Kaffee, Tee, Mate, Gewürze",109307000,178935000,288242000
2009,8,WA10,Getreide,152392000,111453000,263845000
2009,8,WA11,"Müllereierzeugnisse, Malz usw.",71977000,37445000,109422000
2009,8,WA12,"Ölsamen usw., Heilpflanzen usw.",58789000,287163000,345952000
2009,8,WA13,"Schellack, Gummen, Harz, Pflanzensaft",32641000,26750000,59391000
2009,8,WA14,Flechtstoffe usw. pflanzlichen Ursprungs,499000,2008000,2507000
2009,8,WA15,"Tierische und pflanzliche Fette, Öle, Wachs",128676000,226891000,355567000
2009,8,WA16,"Zubereitungen von Fleisch, Fisch usw.",172517000,157131000,329648000
2009,8,WA17,Zucker und Zuckerwaren,115923000,106804000,222727000
2009,8,WA18,Kakao und Zubereitungen aus Kakao,237676000,237032000,474708000
2009,8,WA19,"Zubereitungen aus Getreide usw., Backwaren",339702000,184833000,524535000
2009,8,WA20,"Zubereitungen von Gemüse, Früchten usw.",154660000,280572000,435232000
2009,8,WA21,Verschiedene Lebensmittelzubereitungen,276938000,196609000,473547000
2009,8,WA22,"Getränke, alkoholhaltige Flüssigkeiten, Essig",347618000,402085000,749703000
2009,8,WA23,"Rückstände der Lebensmittelindustrie, Futter",215526000,210923000,426449000
2009,8,WA24,Tabak,288831000,142248000,431079000
2009,8,WA25,"Salz, Schwefel, Steine, Erden usw.",131710000,116836000,248546000
2009,8,WA26,"Erze, Schlacken, Aschen",14025000,508481000,522506000
2009,8,WA27,Mineralische Brennstoffe usw.,1435503000,6435998000,7871501000
2009,8,WA28,Anorganische chemische Erzeugnisse,490498000,356348000,846846000
2009,8,WA29,Organische chemische Erzeugnisse,1396772000,1460420000,2857192000
2009,8,WA30,Pharmazeutische Erzeugnisse,3356804000,2515743000,5872547000
2009,8,WA31,Düngemittel,97536000,63971000,161507000
2009,8,WA32,"Gerb- und Farbstoffe, Farben, Lacke usw.",567193000,265239000,832432000
2009,8,WA33,"Etherische Öle, Riech-, Schönheitsmittel",524417000,290727000,815144000
2009,8,WA34,"Seifen, Waschmittel usw.",368258000,167910000,536168000
2009,8,WA35,"Eiweißstoffe, Klebstoffe, Enzyme",154839000,109104000,263943000
2009,8,WA36,"Sprengstoffe, pyrotechnische Artikel usw.",13923000,18658000,32581000
2009,8,WA37,Photochemische Erzeugnisse,85026000,50744000,135770000
2009,8,WA38,Verschiedene Erzeugnisse der Chemischen Industrie,971252000,665502000,1636754000
2009,8,WA39,Kunststoffe und Waren daraus,2835750000,1714895000,4550645000
2009,8,WA40,Kautschuk und Waren daraus,698483000,654322000,1352805000
2009,8,WA41,"Häute, Felle, Leder",36378000,35623000,72001000
2009,8,WA42,"Lederwaren, Sattlerwaren",112748000,179420000,292168000
2009,8,WA43,"Pelzfelle, künstliches Pelzwerk",12572000,9935000,22507000
2009,8,WA44,"Holz, Holzwaren, Holzkohle",482715000,360319000,843034000
2009,8,WA45,"Kork, Korkwaren",3475000,7152000,10627000
2009,8,WA46,"Flechtwaren, Korbmacherwaren",3922000,9023000,12945000
2009,8,WA47,"Halbstoffe aus Holz usw., Papierabfall",73416000,177867000,251283000
2009,8,WA48,"Papier, Pappe und Waren daraus",1242815000,811316000,2054131000
2009,8,WA49,"Bücher, Zeitungen, Bilddrucke usw.",374961000,155906000,530867000
2009,8,WA50,Seide,2938000,3270000,6208000
2009,8,WA51,"Wolle, feine und grobe Tierhaare",31799000,26067000,57866000
2009,8,WA52,Baumwolle,49150000,47876000,97026000
2009,8,WA53,"Andere pflanzliche Spinnstoffe, Papiergarn",1867000,3891000,5758000
2009,8,WA54,Synthetisches oder künstliches Filament,109617000,76612000,186229000
2009,8,WA55,Synthetische oder künstliche Spinnfaser,111448000,82296000,193744000
2009,8,WA56,"Watte, Filz, Vliesstoff usw., Tauwerk",128718000,68941000,197659000
2009,8,WA57,"Teppiche, Fußbodenbelag aus Spinnstoff",35374000,67115000,102489000
2009,8,WA58,"Spezialgewebe, Spitzen, Tapisserien",29925000,17745000,47670000
2009,8,WA59,"Getränkte, bestrichene usw. Gewebe",101486000,74902000,176388000
2009,8,WA60,Gewirke und Gestricke,39285000,21450000,60735000
2009,8,WA61,"Bekleidung usw. aus Gewirken, Gestricken",539038000,1028527000,1567565000
2009,8,WA62,"Andere Bekleidung, Bekleidungszubehör",677464000,1099008000,1776472000
2009,8,WA63,"Andere Konfektion, Spinnstoffwaren usw.",121134000,189837000,310971000
2009,8,WA64,"Schuhe, Gamaschen, ähnliche Waren",265802000,497420000,763222000
2009,8,WA65,Kopfbedeckungen und Teile davon,21929000,29863000,51792000
2009,8,WA66,"Schirme, Gehstöcke usw., Peitschen",5188000,9959000,15147000
2009,8,WA67,"Zugerichtete Federn, Daunen, künstliche Blumen",4628000,10490000,15118000
2009,8,WA68,"Waren aus Steinen, Gips, Zement usw.",218971000,149185000,368156000
2009,8,WA69,Keramische Waren,190097000,138430000,328527000
2009,8,WA70,Glas und Glaswaren,349490000,253542000,603032000
2009,8,WA71,"Perlen, Edelsteine, Edelmetalle",533551000,547935000,1081486000
2009,8,WA72,Eisen und Stahl,1277179000,976481000,2253660000
2009,8,WA73,Waren aus Eisen oder Stahl,1508654000,908755000,2417409000
2009,8,WA74,Kupfer und Waren daraus,545878000,504389000,1050267000
2009,8,WA75,Nickel und Waren daraus,41115000,63225000,104340000
2009,8,WA76,Aluminium und Waren daraus,720680000,663299000,1383979000
2009,8,WA78,Blei und Waren daraus,32683000,19916000,52599000
2009,8,WA79,Zink und Waren daraus,34385000,56933000,91318000
2009,8,WA80,Zinn und Waren daraus,5014000,14537000,19551000
2009,8,WA81,"Andere unedle Metalle, Cermets usw.",39306000,54093000,93399000
2009,8,WA82,"Werkzeuge, Schneidwaren, Essbestecke",348689000,213275000,561964000
2009,8,WA83,Verschiedene Waren aus unedlen Metallen,414082000,225392000,639474000
2009,8,WA84,"Maschinen, Apparate, mechanische Geräte",10772714000,5836236000,16608950000
2009,8,WA85,Elektrotechnische Erzeugnisse,5990263000,5612736000,11602999000
2009,8,WA86,Schienenfahrzeuge,253659000,120264000,373923000
2009,8,WA87,"Kraftfahrzeuge, Landfahrzeuge",7736790000,3616975000,11353765000
2009,8,WA88,"Luftfahrzeuge, Raumfahrzeuge",1756194000,1629542000,3385736000
2009,8,WA89,Wasserfahrzeuge,145726000,444253000,589979000
2009,8,WA90,"Optische, photografische usw. Erzeugnisse",2576162000,1494259000,4070421000
2009,8,WA91,Uhrmacherwaren,64772000,78938000,143710000
2009,8,WA92,Musikinstrumente,24971000,36166000,61137000
2009,8,WA93,Waffen und Munition,36484000,10532000,47016000
2009,8,WA94,"Möbel, Beleuchtungskörper usw.",773332000,778109000,1551441000
2009,8,WA95,"Spielzeug, Spiele usw., Sportgeräte",320308000,434948000,755256000
2009,8,WA96,Verschiedene Waren,115795000,73875000,189670000
2009,8,WA97,"Kunstgegenstände, Sammlungsstücke",30916000,12384000,43300000
2009,8,WA98,Vollständige Fabrikationsanlagen,290172000,7280000,297452000
2009,8,WA99,Zusammenstellungen verschiedener Waren,1059850000,769768000,1829618000
2009,9,WA01,Lebende Tiere,90786000,110521000,201307000
2009,9,WA02,Fleisch,492522000,377599000,870121000
2009,9,WA03,"Fische, Krebs- und Weichtiere",85089000,211548000,296637000
2009,9,WA04,"Milch, Milcherzeugnisse, Eier, Honig",487382000,438486000,925868000
2009,9,WA05,Andere Waren tierischen Ursprungs,45707000,54919000,100626000
2009,9,WA06,"Pflanzen, Waren des Blumenhandels",55713000,180635000,236348000
2009,9,WA07,"Gemüse, Pflanzen für Ernährung",66422000,249065000,315487000
2009,9,WA08,Genießbare Früchte und Nüsse,85683000,438684000,524367000
2009,9,WA09,"Kaffee, Tee, Mate, Gewürze",121875000,221860000,343735000
2009,9,WA10,Getreide,171388000,112001000,283389000
2009,9,WA11,"Müllereierzeugnisse, Malz usw.",76210000,35296000,111506000
2009,9,WA12,"Ölsamen usw., Heilpflanzen usw.",59129000,271366000,330495000
2009,9,WA13,"Schellack, Gummen, Harz, Pflanzensaft",30448000,25465000,55913000
2009,9,WA14,Flechtstoffe usw. pflanzlichen Ursprungs,973000,2309000,3282000
2009,9,WA15,"Tierische und pflanzliche Fette, Öle, Wachs",123413000,237873000,361286000
2009,9,WA16,"Zubereitungen von Fleisch, Fisch usw.",183433000,162225000,345658000
2009,9,WA17,Zucker und Zuckerwaren,125397000,101658000,227055000
2009,9,WA18,Kakao und Zubereitungen aus Kakao,311268000,250476000,561744000
2009,9,WA19,"Zubereitungen aus Getreide usw., Backwaren",353563000,188985000,542548000
2009,9,WA20,"Zubereitungen von Gemüse, Früchten usw.",159937000,278153000,438090000
2009,9,WA21,Verschiedene Lebensmittelzubereitungen,281955000,232208000,514163000
2009,9,WA22,"Getränke, alkoholhaltige Flüssigkeiten, Essig",329038000,452340000,781378000
2009,9,WA23,"Rückstände der Lebensmittelindustrie, Futter",220362000,266696000,487058000
2009,9,WA24,Tabak,274020000,150036000,424056000
2009,9,WA25,"Salz, Schwefel, Steine, Erden usw.",165604000,119195000,284799000
2009,9,WA26,"Erze, Schlacken, Aschen",32348000,382252000,414600000
2009,9,WA27,Mineralische Brennstoffe usw.,1383606000,7258189000,8641795000
2009,9,WA28,Anorganische chemische Erzeugnisse,529446000,343343000,872789000
2009,9,WA29,Organische chemische Erzeugnisse,1479049000,1589784000,3068833000
2009,9,WA30,Pharmazeutische Erzeugnisse,3801643000,2810815000,6612458000
2009,9,WA31,Düngemittel,169598000,57184000,226782000
2009,9,WA32,"Gerb- und Farbstoffe, Farben, Lacke usw.",666144000,298463000,964607000
2009,9,WA33,"Etherische Öle, Riech-, Schönheitsmittel",547446000,385693000,933139000
2009,9,WA34,"Seifen, Waschmittel usw.",419714000,250449000,670163000
2009,9,WA35,"Eiweißstoffe, Klebstoffe, Enzyme",169154000,116023000,285177000
2009,9,WA36,"Sprengstoffe, pyrotechnische Artikel usw.",15361000,23397000,38758000
2009,9,WA37,Photochemische Erzeugnisse,96397000,76070000,172467000
2009,9,WA38,Verschiedene Erzeugnisse der Chemischen Industrie,1074593000,658260000,1732853000
2009,9,WA39,Kunststoffe und Waren daraus,3433511000,1983886000,5417397000
2009,9,WA40,Kautschuk und Waren daraus,845639000,792360000,1637999000
2009,9,WA41,"Häute, Felle, Leder",53048000,47072000,100120000
2009,9,WA42,"Lederwaren, Sattlerwaren",110548000,179863000,290411000
2009,9,WA43,"Pelzfelle, künstliches Pelzwerk",13606000,13179000,26785000
2009,9,WA44,"Holz, Holzwaren, Holzkohle",510815000,418904000,929719000
2009,9,WA45,"Kork, Korkwaren",2970000,8707000,11677000
2009,9,WA46,"Flechtwaren, Korbmacherwaren",4456000,10120000,14576000
2009,9,WA47,"Halbstoffe aus Holz usw., Papierabfall",69164000,197970000,267134000
2009,9,WA48,"Papier, Pappe und Waren daraus",1397861000,919435000,2317296000
2009,9,WA49,"Bücher, Zeitungen, Bilddrucke usw.",396863000,179380000,576243000
2009,9,WA50,Seide,4496000,4802000,9298000
2009,9,WA51,"Wolle, feine und grobe Tierhaare",39999000,42407000,82406000
2009,9,WA52,Baumwolle,70587000,58901000,129488000
2009,9,WA53,"Andere pflanzliche Spinnstoffe, Papiergarn",2915000,4702000,7617000
2009,9,WA54,Synthetisches oder künstliches Filament,153694000,95159000,248853000
2009,9,WA55,Synthetische oder künstliche Spinnfaser,133397000,93278000,226675000
2009,9,WA56,"Watte, Filz, Vliesstoff usw., Tauwerk",148242000,84395000,232637000
2009,9,WA57,"Teppiche, Fußbodenbelag aus Spinnstoff",38684000,81961000,120645000
2009,9,WA58,"Spezialgewebe, Spitzen, Tapisserien",36381000,22889000,59270000
2009,9,WA59,"Getränkte, bestrichene usw. Gewebe",135692000,91136000,226828000
2009,9,WA60,Gewirke und Gestricke,61034000,30304000,91338000
2009,9,WA61,"Bekleidung usw. aus Gewirken, Gestricken",524890000,993355000,1518245000
2009,9,WA62,"Andere Bekleidung, Bekleidungszubehör",658935000,1013788000,1672723000
2009,9,WA63,"Andere Konfektion, Spinnstoffwaren usw.",142842000,203359000,346201000
2009,9,WA64,"Schuhe, Gamaschen, ähnliche Waren",234426000,431349000,665775000
2009,9,WA65,Kopfbedeckungen und Teile davon,25052000,36031000,61083000
2009,9,WA66,"Schirme, Gehstöcke usw., Peitschen",14798000,7303000,22101000
2009,9,WA67,"Zugerichtete Federn, Daunen, künstliche Blumen",7139000,12734000,19873000
2009,9,WA68,"Waren aus Steinen, Gips, Zement usw.",253103000,172505000,425608000
2009,9,WA69,Keramische Waren,218015000,150496000,368511000
2009,9,WA70,Glas und Glaswaren,403843000,303673000,707516000
2009,9,WA71,"Perlen, Edelsteine, Edelmetalle",633196000,737053000,1370249000
2009,9,WA72,Eisen und Stahl,1484255000,1366044000,2850299000
2009,9,WA73,Waren aus Eisen oder Stahl,1697696000,1014634000,2712330000
2009,9,WA74,Kupfer und Waren daraus,676035000,554896000,1230931000
2009,9,WA75,Nickel und Waren daraus,49520000,81782000,131302000
2009,9,WA76,Aluminium und Waren daraus,830815000,756292000,1587107000
2009,9,WA78,Blei und Waren daraus,50362000,17302000,67664000
2009,9,WA79,Zink und Waren daraus,46178000,71261000,117439000
2009,9,WA80,Zinn und Waren daraus,6032000,15690000,21722000
2009,9,WA81,"Andere unedle Metalle, Cermets usw.",56476000,69894000,126370000
2009,9,WA82,"Werkzeuge, Schneidwaren, Essbestecke",411157000,236648000,647805000
2009,9,WA83,Verschiedene Waren aus unedlen Metallen,468465000,275130000,743595000
2009,9,WA84,"Maschinen, Apparate, mechanische Geräte",12289857000,7305604000,19595461000
2009,9,WA85,Elektrotechnische Erzeugnisse,7300111000,6932737000,14232848000
2009,9,WA86,Schienenfahrzeuge,257819000,121795000,379614000
2009,9,WA87,"Kraftfahrzeuge, Landfahrzeuge",11764161000,5051687000,16815848000
2009,9,WA88,"Luftfahrzeuge, Raumfahrzeuge",1459104000,1269105000,2728209000
2009,9,WA89,Wasserfahrzeuge,22793000,896180000,918973000
2009,9,WA90,"Optische, photografische usw. Erzeugnisse",3023127000,1641352000,4664479000
2009,9,WA91,Uhrmacherwaren,92289000,97018000,189307000
2009,9,WA92,Musikinstrumente,37533000,39230000,76763000
2009,9,WA93,Waffen und Munition,33462000,13702000,47164000
2009,9,WA94,"Möbel, Beleuchtungskörper usw.",954394000,965477000,1919871000
2009,9,WA95,"Spielzeug, Spiele usw., Sportgeräte",545074000,660361000,1205435000
2009,9,WA96,Verschiedene Waren,146763000,102240000,249003000
2009,9,WA97,"Kunstgegenstände, Sammlungsstücke",37767000,24255000,62022000
2009,9,WA98,Vollständige Fabrikationsanlagen,301316000,6693000,308009000
2009,9,WA99,Zusammenstellungen verschiedener Waren,1309277000,983117000,2292394000
2009,10,WA01,Lebende Tiere,86146000,106406000,192552000
2009,10,WA02,Fleisch,522553000,421045000,943598000
2009,10,WA03,"Fische, Krebs- und Weichtiere",93743000,247979000,341722000
2009,10,WA04,"Milch, Milcherzeugnisse, Eier, Honig",516022000,437573000,953595000
2009,10,WA05,Andere Waren tierischen Ursprungs,55531000,57786000,113317000
2009,10,WA06,"Pflanzen, Waren des Blumenhandels",57216000,170638000,227854000
2009,10,WA07,"Gemüse, Pflanzen für Ernährung",67465000,245814000,313279000
2009,10,WA08,Genießbare Früchte und Nüsse,97453000,475524000,572977000
2009,10,WA09,"Kaffee, Tee, Mate, Gewürze",142212000,211482000,353694000
2009,10,WA10,Getreide,146520000,112684000,259204000
2009,10,WA11,"Müllereierzeugnisse, Malz usw.",79979000,36045000,116024000
2009,10,WA12,"Ölsamen usw., Heilpflanzen usw.",49235000,226273000,275508000
2009,10,WA13,"Schellack, Gummen, Harz, Pflanzensaft",33724000,23581000,57305000
2009,10,WA14,Flechtstoffe usw. pflanzlichen Ursprungs,750000,1950000,2700000
2009,10,WA15,"Tierische und pflanzliche Fette, Öle, Wachs",125692000,224189000,349881000
2009,10,WA16,"Zubereitungen von Fleisch, Fisch usw.",184875000,180787000,365662000
2009,10,WA17,Zucker und Zuckerwaren,134101000,106406000,240507000
2009,10,WA18,Kakao und Zubereitungen aus Kakao,308344000,269631000,577975000
2009,10,WA19,"Zubereitungen aus Getreide usw., Backwaren",373536000,207883000,581419000
2009,10,WA20,"Zubereitungen von Gemüse, Früchten usw.",170217000,289475000,459692000
2009,10,WA21,Verschiedene Lebensmittelzubereitungen,283052000,216628000,499680000
2009,10,WA22,"Getränke, alkoholhaltige Flüssigkeiten, Essig",331228000,455119000,786347000
2009,10,WA23,"Rückstände der Lebensmittelindustrie, Futter",216925000,207415000,424340000
2009,10,WA24,Tabak,274026000,148265000,422291000
2009,10,WA25,"Salz, Schwefel, Steine, Erden usw.",160630000,131369000,291999000
2009,10,WA26,"Erze, Schlacken, Aschen",25764000,472595000,498359000
2009,10,WA27,Mineralische Brennstoffe usw.,1366041000,6537762000,7903803000
2009,10,WA28,Anorganische chemische Erzeugnisse,597847000,542420000,1140267000
2009,10,WA29,Organische chemische Erzeugnisse,1577415000,1670316000,3247731000
2009,10,WA30,Pharmazeutische Erzeugnisse,3931536000,2907426000,6838962000
2009,10,WA31,Düngemittel,136194000,51860000,188054000
2009,10,WA32,"Gerb- und Farbstoffe, Farben, Lacke usw.",679890000,320654000,1000544000
2009,10,WA33,"Etherische Öle, Riech-, Schönheitsmittel",591828000,348651000,940479000
2009,10,WA34,"Seifen, Waschmittel usw.",425478000,227552000,653030000
2009,10,WA35,"Eiweißstoffe, Klebstoffe, Enzyme",173866000,114723000,288589000
2009,10,WA36,"Sprengstoffe, pyrotechnische Artikel usw.",20893000,24652000,45545000
2009,10,WA37,Photochemische Erzeugnisse,94767000,64726000,159493000
2009,10,WA38,Verschiedene Erzeugnisse der Chemischen Industrie,1128712000,653437000,1782149000
2009,10,WA39,Kunststoffe und Waren daraus,3473406000,2007541000,5480947000
2009,10,WA40,Kautschuk und Waren daraus,891372000,821116000,1712488000
2009,10,WA41,"Häute, Felle, Leder",58231000,62125000,120356000
2009,10,WA42,"Lederwaren, Sattlerwaren",100860000,169568000,270428000
2009,10,WA43,"Pelzfelle, künstliches Pelzwerk",12626000,12378000,25004000
2009,10,WA44,"Holz, Holzwaren, Holzkohle",551737000,442807000,994544000
2009,10,WA45,"Kork, Korkwaren",2973000,8193000,11166000
2009,10,WA46,"Flechtwaren, Korbmacherwaren",4921000,9689000,14610000
2009,10,WA47,"Halbstoffe aus Holz usw., Papierabfall",67432000,238025000,305457000
2009,10,WA48,"Papier, Pappe und Waren daraus",1450568000,870267000,2320835000
2009,10,WA49,"Bücher, Zeitungen, Bilddrucke usw.",394652000,194564000,589216000
2009,10,WA50,Seide,6352000,5945000,12297000
2009,10,WA51,"Wolle, feine und grobe Tierhaare",42880000,47408000,90288000
2009,10,WA52,Baumwolle,86529000,73994000,160523000
2009,10,WA53,"Andere pflanzliche Spinnstoffe, Papiergarn",4698000,6687000,11385000
2009,10,WA54,Synthetisches oder künstliches Filament,166385000,105504000,271889000
2009,10,WA55,Synthetische oder künstliche Spinnfaser,139198000,101974000,241172000
2009,10,WA56,"Watte, Filz, Vliesstoff usw., Tauwerk",161932000,84140000,246072000
2009,10,WA57,"Teppiche, Fußbodenbelag aus Spinnstoff",41797000,83665000,125462000
2009,10,WA58,"Spezialgewebe, Spitzen, Tapisserien",40368000,24215000,64583000
2009,10,WA59,"Getränkte, bestrichene usw. Gewebe",130405000,90491000,220896000
2009,10,WA60,Gewirke und Gestricke,61787000,35582000,97369000
2009,10,WA61,"Bekleidung usw. aus Gewirken, Gestricken",452764000,884874000,1337638000
2009,10,WA62,"Andere Bekleidung, Bekleidungszubehör",490044000,813826000,1303870000
2009,10,WA63,"Andere Konfektion, Spinnstoffwaren usw.",141896000,211975000,353871000
2009,10,WA64,"Schuhe, Gamaschen, ähnliche Waren",175676000,311334000,487010000
2009,10,WA65,Kopfbedeckungen und Teile davon,22072000,31707000,53779000
2009,10,WA66,"Schirme, Gehstöcke usw., Peitschen",16619000,8133000,24752000
2009,10,WA67,"Zugerichtete Federn, Daunen, künstliche Blumen",6764000,10658000,17422000
2009,10,WA68,"Waren aus Steinen, Gips, Zement usw.",259417000,162454000,421871000
2009,10,WA69,Keramische Waren,221615000,159339000,380954000
2009,10,WA70,Glas und Glaswaren,406254000,307690000,713944000
2009,10,WA71,"Perlen, Edelsteine, Edelmetalle",649433000,622433000,1271866000
2009,10,WA72,Eisen und Stahl,1616844000,1387190000,3004034000
2009,10,WA73,Waren aus Eisen oder Stahl,1740937000,1063744000,2804681000
2009,10,WA74,Kupfer und Waren daraus,563769000,667098000,1230867000
2009,10,WA75,Nickel und Waren daraus,49738000,75861000,125599000
2009,10,WA76,Aluminium und Waren daraus,862898000,838490000,1701388000
2009,10,WA78,Blei und Waren daraus,49619000,24256000,73875000
2009,10,WA79,Zink und Waren daraus,49394000,68170000,117564000
2009,10,WA80,Zinn und Waren daraus,6380000,20657000,27037000
2009,10,WA81,"Andere unedle Metalle, Cermets usw.",61675000,69360000,131035000
2009,10,WA82,"Werkzeuge, Schneidwaren, Essbestecke",430696000,233499000,664195000
2009,10,WA83,Verschiedene Waren aus unedlen Metallen,481697000,272685000,754382000
2009,10,WA84,"Maschinen, Apparate, mechanische Geräte",12793493000,7411297000,20204790000
2009,10,WA85,Elektrotechnische Erzeugnisse,7820800000,7786054000,15606854000
2009,10,WA86,Schienenfahrzeuge,167801000,115966000,283767000
2009,10,WA87,"Kraftfahrzeuge, Landfahrzeuge",11171967000,4944091000,16116058000
2009,10,WA88,"Luftfahrzeuge, Raumfahrzeuge",1812597000,1849425000,3662022000
2009,10,WA89,Wasserfahrzeuge,223862000,299730000,523592000
2009,10,WA90,"Optische, photografische usw. Erzeugnisse",3145703000,1674645000,4820348000
2009,10,WA91,Uhrmacherwaren,97750000,113185000,210935000
2009,10,WA92,Musikinstrumente,41999000,30161000,72160000
2009,10,WA93,Waffen und Munition,32382000,12347000,44729000
2009,10,WA94,"Möbel, Beleuchtungskörper usw.",995188000,1007716000,2002904000
2009,10,WA95,"Spielzeug, Spiele usw., Sportgeräte",672886000,730345000,1403231000
2009,10,WA96,Verschiedene Waren,156580000,90544000,247124000
2009,10,WA97,"Kunstgegenstände, Sammlungsstücke",38824000,16929000,55753000
2009,10,WA98,Vollständige Fabrikationsanlagen,256035000,5020000,261055000
2009,10,WA99,Zusammenstellungen verschiedener Waren,1123591000,1016587000,2140178000
2009,11,WA01,Lebende Tiere,85390000,109602000,194992000
2009,11,WA02,Fleisch,507315000,399711000,907026000
2009,11,WA03,"Fische, Krebs- und Weichtiere",91434000,230070000,321504000
2009,11,WA04,"Milch, Milcherzeugnisse, Eier, Honig",469781000,408987000,878768000
2009,11,WA05,Andere Waren tierischen Ursprungs,44634000,48265000,92899000
2009,11,WA06,"Pflanzen, Waren des Blumenhandels",50164000,171975000,222139000
2009,11,WA07,"Gemüse, Pflanzen für Ernährung",51204000,257695000,308899000
2009,11,WA08,Genießbare Früchte und Nüsse,88891000,479472000,568363000
2009,11,WA09,"Kaffee, Tee, Mate, Gewürze",139784000,208447000,348231000
2009,11,WA10,Getreide,159844000,121242000,281086000
2009,11,WA11,"Müllereierzeugnisse, Malz usw.",76235000,32363000,108598000
2009,11,WA12,"Ölsamen usw., Heilpflanzen usw.",60731000,209199000,269930000
2009,11,WA13,"Schellack, Gummen, Harz, Pflanzensaft",31089000,25427000,56516000
2009,11,WA14,Flechtstoffe usw. pflanzlichen Ursprungs,873000,1616000,2489000
2009,11,WA15,"Tierische und pflanzliche Fette, Öle, Wachs",121546000,204997000,326543000
2009,11,WA16,"Zubereitungen von Fleisch, Fisch usw.",184702000,159646000,344348000
2009,11,WA17,Zucker und Zuckerwaren,145582000,95257000,240839000
2009,11,WA18,Kakao und Zubereitungen aus Kakao,289609000,265223000,554832000
2009,11,WA19,"Zubereitungen aus Getreide usw., Backwaren",331469000,181095000,512564000
2009,11,WA20,"Zubereitungen von Gemüse, Früchten usw.",140183000,262894000,403077000
2009,11,WA21,Verschiedene Lebensmittelzubereitungen,286134000,194689000,480823000
2009,11,WA22,"Getränke, alkoholhaltige Flüssigkeiten, Essig",327291000,513744000,841035000
2009,11,WA23,"Rückstände der Lebensmittelindustrie, Futter",219591000,237512000,457103000
2009,11,WA24,Tabak,283171000,124165000,407336000
2009,11,WA25,"Salz, Schwefel, Steine, Erden usw.",154405000,125813000,280218000
2009,11,WA26,"Erze, Schlacken, Aschen",18704000,374108000,392812000
2009,11,WA27,Mineralische Brennstoffe usw.,1397092000,6258700000,7655792000
2009,11,WA28,Anorganische chemische Erzeugnisse,515693000,367597000,883290000
2009,11,WA29,Organische chemische Erzeugnisse,1729188000,1379835000,3109023000
2009,11,WA30,Pharmazeutische Erzeugnisse,3864883000,2972205000,6837088000
2009,11,WA31,Düngemittel,125308000,51018000,176326000
2009,11,WA32,"Gerb- und Farbstoffe, Farben, Lacke usw.",648265000,279443000,927708000
2009,11,WA33,"Etherische Öle, Riech-, Schönheitsmittel",611338000,326663000,938001000
2009,11,WA34,"Seifen, Waschmittel usw.",395839000,223144000,618983000
2009,11,WA35,"Eiweißstoffe, Klebstoffe, Enzyme",171184000,116129000,287313000
2009,11,WA36,"Sprengstoffe, pyrotechnische Artikel usw.",20433000,23634000,44067000
2009,11,WA37,Photochemische Erzeugnisse,98532000,69829000,168361000
2009,11,WA38,Verschiedene Erzeugnisse der Chemischen Industrie,1093839000,616105000,1709944000
2009,11,WA39,Kunststoffe und Waren daraus,3255806000,1871397000,5127203000
2009,11,WA40,Kautschuk und Waren daraus,820059000,711550000,1531609000
2009,11,WA41,"Häute, Felle, Leder",67223000,62041000,129264000
2009,11,WA42,"Lederwaren, Sattlerwaren",100056000,174045000,274101000
2009,11,WA43,"Pelzfelle, künstliches Pelzwerk",9852000,10025000,19877000
2009,11,WA44,"Holz, Holzwaren, Holzkohle",532182000,407766000,939948000
2009,11,WA45,"Kork, Korkwaren",2679000,8140000,10819000
2009,11,WA46,"Flechtwaren, Korbmacherwaren",4002000,8219000,12221000
2009,11,WA47,"Halbstoffe aus Holz usw., Papierabfall",67706000,216729000,284435000
2009,11,WA48,"Papier, Pappe und Waren daraus",1348551000,910057000,2258608000
2009,11,WA49,"Bücher, Zeitungen, Bilddrucke usw.",340025000,168151000,508176000
2009,11,WA50,Seide,5526000,5917000,11443000
2009,11,WA51,"Wolle, feine und grobe Tierhaare",44184000,45630000,89814000
2009,11,WA52,Baumwolle,82565000,76416000,158981000
2009,11,WA53,"Andere pflanzliche Spinnstoffe, Papiergarn",5954000,7853000,13807000
2009,11,WA54,Synthetisches oder künstliches Filament,151358000,99575000,250933000
2009,11,WA55,Synthetische oder künstliche Spinnfaser,143531000,98851000,242382000
2009,11,WA56,"Watte, Filz, Vliesstoff usw., Tauwerk",144524000,78631000,223155000
2009,11,WA57,"Teppiche, Fußbodenbelag aus Spinnstoff",37441000,79535000,116976000
2009,11,WA58,"Spezialgewebe, Spitzen, Tapisserien",40421000,24481000,64902000
2009,11,WA59,"Getränkte, bestrichene usw. Gewebe",137635000,84182000,221817000
2009,11,WA60,Gewirke und Gestricke,61283000,31532000,92815000
2009,11,WA61,"Bekleidung usw. aus Gewirken, Gestricken",396780000,805489000,1202269000
2009,11,WA62,"Andere Bekleidung, Bekleidungszubehör",407769000,751627000,1159396000
2009,11,WA63,"Andere Konfektion, Spinnstoffwaren usw.",144049000,204459000,348508000
2009,11,WA64,"Schuhe, Gamaschen, ähnliche Waren",131765000,312417000,444182000
2009,11,WA65,Kopfbedeckungen und Teile davon,18851000,26918000,45769000
2009,11,WA66,"Schirme, Gehstöcke usw., Peitschen",16160000,8243000,24403000
2009,11,WA67,"Zugerichtete Federn, Daunen, künstliche Blumen",4865000,8240000,13105000
2009,11,WA68,"Waren aus Steinen, Gips, Zement usw.",269856000,158675000,428531000
2009,11,WA69,Keramische Waren,225161000,152754000,377915000
2009,11,WA70,Glas und Glaswaren,383535000,292320000,675855000
2009,11,WA71,"Perlen, Edelsteine, Edelmetalle",649394000,756129000,1405523000
2009,11,WA72,Eisen und Stahl,1482836000,1296338000,2779174000
2009,11,WA73,Waren aus Eisen oder Stahl,1649184000,1006609000,2655793000
2009,11,WA74,Kupfer und Waren daraus,697266000,542761000,1240027000
2009,11,WA75,Nickel und Waren daraus,43518000,70025000,113543000
2009,11,WA76,Aluminium und Waren daraus,750919000,711528000,1462447000
2009,11,WA78,Blei und Waren daraus,50993000,28487000,79480000
2009,11,WA79,Zink und Waren daraus,50615000,71963000,122578000
2009,11,WA80,Zinn und Waren daraus,5598000,17891000,23489000
2009,11,WA81,"Andere unedle Metalle, Cermets usw.",54082000,68157000,122239000
2009,11,WA82,"Werkzeuge, Schneidwaren, Essbestecke",444301000,241143000,685444000
2009,11,WA83,Verschiedene Waren aus unedlen Metallen,427840000,257530000,685370000
2009,11,WA84,"Maschinen, Apparate, mechanische Geräte",12420290000,7372736000,19793026000
2009,11,WA85,Elektrotechnische Erzeugnisse,7517664000,7573483000,15091147000
2009,11,WA86,Schienenfahrzeuge,277746000,100648000,378394000
2009,11,WA87,"Kraftfahrzeuge, Landfahrzeuge",12535565000,4466135000,17001700000
2009,11,WA88,"Luftfahrzeuge, Raumfahrzeuge",1879305000,747191000,2626496000
2009,11,WA89,Wasserfahrzeuge,215196000,338312000,553508000
2009,11,WA90,"Optische, photografische usw. Erzeugnisse",3263197000,1793766000,5056963000
2009,11,WA91,Uhrmacherwaren,91583000,111573000,203156000
2009,11,WA92,Musikinstrumente,33485000,38849000,72334000
2009,11,WA93,Waffen und Munition,34738000,16549000,51287000
2009,11,WA94,"Möbel, Beleuchtungskörper usw.",903312000,909018000,1812330000
2009,11,WA95,"Spielzeug, Spiele usw., Sportgeräte",731110000,685679000,1416789000
2009,11,WA96,Verschiedene Waren,136982000,106948000,243930000
2009,11,WA97,"Kunstgegenstände, Sammlungsstücke",45779000,17394000,63173000
2009,11,WA98,Vollständige Fabrikationsanlagen,347096000,24706000,371802000
2009,11,WA99,Zusammenstellungen verschiedener Waren,1122441000,931967000,2054408000
2009,12,WA01,Lebende Tiere,87155000,123755000,210910000
2009,12,WA02,Fleisch,561789000,441999000,1003788000
2009,12,WA03,"Fische, Krebs- und Weichtiere",83883000,235457000,319340000
2009,12,WA04,"Milch, Milcherzeugnisse, Eier, Honig",532976000,512339000,1045315000
2009,12,WA05,Andere Waren tierischen Ursprungs,41497000,56601000,98098000
2009,12,WA06,"Pflanzen, Waren des Blumenhandels",35921000,182251000,218172000
2009,12,WA07,"Gemüse, Pflanzen für Ernährung",63556000,343097000,406653000
2009,12,WA08,Genießbare Früchte und Nüsse,111385000,526173000,637558000
2009,12,WA09,"Kaffee, Tee, Mate, Gewürze",117592000,208981000,326573000
2009,12,WA10,Getreide,141733000,123780000,265513000
2009,12,WA11,"Müllereierzeugnisse, Malz usw.",67853000,32608000,100461000
2009,12,WA12,"Ölsamen usw., Heilpflanzen usw.",54954000,228029000,282983000
2009,12,WA13,"Schellack, Gummen, Harz, Pflanzensaft",28001000,27583000,55584000
2009,12,WA14,Flechtstoffe usw. pflanzlichen Ursprungs,831000,1391000,2222000
2009,12,WA15,"Tierische und pflanzliche Fette, Öle, Wachs",136528000,185090000,321618000
2009,12,WA16,"Zubereitungen von Fleisch, Fisch usw.",194492000,179395000,373887000
2009,12,WA17,Zucker und Zuckerwaren,126873000,91879000,218752000
2009,12,WA18,Kakao und Zubereitungen aus Kakao,241063000,214073000,455136000
2009,12,WA19,"Zubereitungen aus Getreide usw., Backwaren",323353000,191239000,514592000
2009,12,WA20,"Zubereitungen von Gemüse, Früchten usw.",169444000,286874000,456318000
2009,12,WA21,Verschiedene Lebensmittelzubereitungen,279741000,219733000,499474000
2009,12,WA22,"Getränke, alkoholhaltige Flüssigkeiten, Essig",351264000,458478000,809742000
2009,12,WA23,"Rückstände der Lebensmittelindustrie, Futter",225805000,214781000,440586000
2009,12,WA24,Tabak,228992000,95937000,324929000
2009,12,WA25,"Salz, Schwefel, Steine, Erden usw.",131130000,122701000,253831000
2009,12,WA26,"Erze, Schlacken, Aschen",19946000,447891000,467837000
2009,12,WA27,Mineralische Brennstoffe usw.,1523072000,6936402000,8459474000
2009,12,WA28,Anorganische chemische Erzeugnisse,505386000,560564000,1065950000
2009,12,WA29,Organische chemische Erzeugnisse,1435049000,1551800000,2986849000
2009,12,WA30,Pharmazeutische Erzeugnisse,3576486000,2431110000,6007596000
2009,12,WA31,Düngemittel,161641000,59170000,220811000
2009,12,WA32,"Gerb- und Farbstoffe, Farben, Lacke usw.",530300000,275929000,806229000
2009,12,WA33,"Etherische Öle, Riech-, Schönheitsmittel",514935000,310418000,825353000
2009,12,WA34,"Seifen, Waschmittel usw.",339043000,214053000,553096000
2009,12,WA35,"Eiweißstoffe, Klebstoffe, Enzyme",147198000,107293000,254491000
2009,12,WA36,"Sprengstoffe, pyrotechnische Artikel usw.",19663000,15440000,35103000
2009,12,WA37,Photochemische Erzeugnisse,90997000,61100000,152097000
2009,12,WA38,Verschiedene Erzeugnisse der Chemischen Industrie,998246000,707866000,1706112000
2009,12,WA39,Kunststoffe und Waren daraus,2756047000,1687682000,4443729000
2009,12,WA40,Kautschuk und Waren daraus,694181000,605668000,1299849000
2009,12,WA41,"Häute, Felle, Leder",52874000,54845000,107719000
2009,12,WA42,"Lederwaren, Sattlerwaren",91340000,169341000,260681000
2009,12,WA43,"Pelzfelle, künstliches Pelzwerk",8558000,11645000,20203000
2009,12,WA44,"Holz, Holzwaren, Holzkohle",423406000,362706000,786112000
2009,12,WA45,"Kork, Korkwaren",2512000,5895000,8407000
2009,12,WA46,"Flechtwaren, Korbmacherwaren",3628000,9784000,13412000
2009,12,WA47,"Halbstoffe aus Holz usw., Papierabfall",61992000,214235000,276227000
2009,12,WA48,"Papier, Pappe und Waren daraus",1300928000,825625000,2126553000
2009,12,WA49,"Bücher, Zeitungen, Bilddrucke usw.",379720000,180672000,560392000
2009,12,WA50,Seide,4849000,4254000,9103000
2009,12,WA51,"Wolle, feine und grobe Tierhaare",38735000,34515000,73250000
2009,12,WA52,Baumwolle,77315000,58546000,135861000
2009,12,WA53,"Andere pflanzliche Spinnstoffe, Papiergarn",5943000,6661000,12604000
2009,12,WA54,Synthetisches oder künstliches Filament,128467000,78697000,207164000
2009,12,WA55,Synthetische oder künstliche Spinnfaser,122834000,82070000,204904000
2009,12,WA56,"Watte, Filz, Vliesstoff usw., Tauwerk",119940000,73983000,193923000
2009,12,WA57,"Teppiche, Fußbodenbelag aus Spinnstoff",32134000,82776000,114910000
2009,12,WA58,"Spezialgewebe, Spitzen, Tapisserien",31712000,21105000,52817000
2009,12,WA59,"Getränkte, bestrichene usw. Gewebe",110833000,77990000,188823000
2009,12,WA60,Gewirke und Gestricke,56896000,24043000,80939000
2009,12,WA61,"Bekleidung usw. aus Gewirken, Gestricken",337318000,756914000,1094232000
2009,12,WA62,"Andere Bekleidung, Bekleidungszubehör",361438000,786950000,1148388000
2009,12,WA63,"Andere Konfektion, Spinnstoffwaren usw.",129436000,207487000,336923000
2009,12,WA64,"Schuhe, Gamaschen, ähnliche Waren",135791000,305847000,441638000
2009,12,WA65,Kopfbedeckungen und Teile davon,14282000,24437000,38719000
2009,12,WA66,"Schirme, Gehstöcke usw., Peitschen",13787000,8208000,21995000
2009,12,WA67,"Zugerichtete Federn, Daunen, künstliche Blumen",4129000,11934000,16063000
2009,12,WA68,"Waren aus Steinen, Gips, Zement usw.",198833000,133219000,332052000
2009,12,WA69,Keramische Waren,213891000,145996000,359887000
2009,12,WA70,Glas und Glaswaren,322104000,246075000,568179000
2009,12,WA71,"Perlen, Edelsteine, Edelmetalle",608744000,655819000,1264563000
2009,12,WA72,Eisen und Stahl,1227403000,1083874000,2311277000
2009,12,WA73,Waren aus Eisen oder Stahl,1463704000,954294000,2417998000
2009,12,WA74,Kupfer und Waren daraus,576305000,573826000,1150131000
2009,12,WA75,Nickel und Waren daraus,44235000,65615000,109850000
2009,12,WA76,Aluminium und Waren daraus,760219000,691500000,1451719000
2009,12,WA78,Blei und Waren daraus,39581000,27428000,67009000
2009,12,WA79,Zink und Waren daraus,33548000,62391000,95939000
2009,12,WA80,Zinn und Waren daraus,4527000,10125000,14652000
2009,12,WA81,"Andere unedle Metalle, Cermets usw.",63088000,63800000,126888000
2009,12,WA82,"Werkzeuge, Schneidwaren, Essbestecke",423223000,239447000,662670000
2009,12,WA83,Verschiedene Waren aus unedlen Metallen,381311000,225303000,606614000
2009,12,WA84,"Maschinen, Apparate, mechanische Geräte",13082502000,6943492000,20025994000
2009,12,WA85,Elektrotechnische Erzeugnisse,7182819000,6954006000,14136825000
2009,12,WA86,Schienenfahrzeuge,374560000,137053000,511613000
2009,12,WA87,"Kraftfahrzeuge, Landfahrzeuge",9781615000,3931620000,13713235000
2009,12,WA88,"Luftfahrzeuge, Raumfahrzeuge",2338513000,1181266000,3519779000
2009,12,WA89,Wasserfahrzeuge,38260000,580408000,618668000
2009,12,WA90,"Optische, photografische usw. Erzeugnisse",3266719000,1733703000,5000422000
2009,12,WA91,Uhrmacherwaren,90276000,90173000,180449000
2009,12,WA92,Musikinstrumente,38193000,40552000,78745000
2009,12,WA93,Waffen und Munition,32621000,9474000,42095000
2009,12,WA94,"Möbel, Beleuchtungskörper usw.",894059000,948057000,1842116000
2009,12,WA95,"Spielzeug, Spiele usw., Sportgeräte",641869000,529674000,1171543000
2009,12,WA96,Verschiedene Waren,139382000,86367000,225749000
2009,12,WA97,"Kunstgegenstände, Sammlungsstücke",45961000,29911000,75872000
2009,12,WA98,Vollständige Fabrikationsanlagen,328344000,21015000,349359000
2009,12,WA99,Zusammenstellungen verschiedener Waren,1175925000,877521000,2053446000
2010,1,WA01,Lebende Tiere,86734000,118775000,205509000
2010,1,WA02,Fleisch,468415000,393871000,862286000
2010,1,WA03,"Fische, Krebs- und Weichtiere",80288000,230289000,310577000
2010,1,WA04,"Milch, Milcherzeugnisse, Eier, Honig",504718000,388968000,893686000
2010,1,WA05,Andere Waren tierischen Ursprungs,43617000,48884000,92501000
2010,1,WA06,"Pflanzen, Waren des Blumenhandels",33007000,152859000,185866000
2010,1,WA07,"Gemüse, Pflanzen für Ernährung",65452000,375482000,440934000
2010,1,WA08,Genießbare Früchte und Nüsse,92466000,476175000,568641000
2010,1,WA09,"Kaffee, Tee, Mate, Gewürze",121518000,211193000,332711000
2010,1,WA10,Getreide,121209000,122539000,243748000
2010,1,WA11,"Müllereierzeugnisse, Malz usw.",70138000,28951000,99089000
2010,1,WA12,"Ölsamen usw., Heilpflanzen usw.",91898000,247957000,339855000
2010,1,WA13,"Schellack, Gummen, Harz, Pflanzensaft",31264000,25036000,56300000
2010,1,WA14,Flechtstoffe usw. pflanzlichen Ursprungs,857000,1864000,2721000
2010,1,WA15,"Tierische und pflanzliche Fette, Öle, Wachs",134787000,186533000,321320000
2010,1,WA16,"Zubereitungen von Fleisch, Fisch usw.",170171000,163082000,333253000
2010,1,WA17,Zucker und Zuckerwaren,107454000,89449000,196903000
2010,1,WA18,Kakao und Zubereitungen aus Kakao,219980000,244159000,464139000
2010,1,WA19,"Zubereitungen aus Getreide usw., Backwaren",288211000,179350000,467561000
2010,1,WA20,"Zubereitungen von Gemüse, Früchten usw.",138123000,255980000,394103000
2010,1,WA21,Verschiedene Lebensmittelzubereitungen,253608000,172443000,426051000
2010,1,WA22,"Getränke, alkoholhaltige Flüssigkeiten, Essig",259509000,397959000,657468000
2010,1,WA23,"Rückstände der Lebensmittelindustrie, Futter",222903000,243088000,465991000
2010,1,WA24,Tabak,254377000,130988000,385365000
2010,1,WA25,"Salz, Schwefel, Steine, Erden usw.",113357000,108198000,221555000
2010,1,WA26,"Erze, Schlacken, Aschen",16048000,500941000,516989000
2010,1,WA27,Mineralische Brennstoffe usw.,1517017000,6766560000,8283577000
2010,1,WA28,Anorganische chemische Erzeugnisse,550426000,339953000,890379000
2010,1,WA29,Organische chemische Erzeugnisse,1742640000,1580419000,3323059000
2010,1,WA30,Pharmazeutische Erzeugnisse,3629618000,3184104000,6813722000
2010,1,WA31,Düngemittel,153608000,68513000,222121000
2010,1,WA32,"Gerb- und Farbstoffe, Farben, Lacke usw.",597920000,303247000,901167000
2010,1,WA33,"Etherische Öle, Riech-, Schönheitsmittel",532068000,325684000,857752000
2010,1,WA34,"Seifen, Waschmittel usw.",383929000,197544000,581473000
2010,1,WA35,"Eiweißstoffe, Klebstoffe, Enzyme",160488000,114406000,274894000
2010,1,WA36,"Sprengstoffe, pyrotechnische Artikel usw.",11414000,18052000,29466000
2010,1,WA37,Photochemische Erzeugnisse,83084000,57478000,140562000
2010,1,WA38,Verschiedene Erzeugnisse der Chemischen Industrie,1201537000,671885000,1873422000
2010,1,WA39,Kunststoffe und Waren daraus,3166460000,1866356000,5032816000
2010,1,WA40,Kautschuk und Waren daraus,758478000,681594000,1440072000
2010,1,WA41,"Häute, Felle, Leder",55737000,53312000,109049000
2010,1,WA42,"Lederwaren, Sattlerwaren",99966000,185274000,285240000
2010,1,WA43,"Pelzfelle, künstliches Pelzwerk",6355000,6906000,13261000
2010,1,WA44,"Holz, Holzwaren, Holzkohle",422808000,403994000,826802000
2010,1,WA45,"Kork, Korkwaren",2137000,13253000,15390000
2010,1,WA46,"Flechtwaren, Korbmacherwaren",3186000,10729000,13915000
2010,1,WA47,"Halbstoffe aus Holz usw., Papierabfall",78332000,236559000,314891000
2010,1,WA48,"Papier, Pappe und Waren daraus",1319980000,813958000,2133938000
2010,1,WA49,"Bücher, Zeitungen, Bilddrucke usw.",337465000,143711000,481176000
2010,1,WA50,Seide,4589000,5387000,9976000
2010,1,WA51,"Wolle, feine und grobe Tierhaare",41377000,41582000,82959000
2010,1,WA52,Baumwolle,69838000,64312000,134150000
2010,1,WA53,"Andere pflanzliche Spinnstoffe, Papiergarn",6217000,6222000,12439000
2010,1,WA54,Synthetisches oder künstliches Filament,145704000,102602000,248306000
2010,1,WA55,Synthetische oder künstliche Spinnfaser,135012000,95788000,230800000
2010,1,WA56,"Watte, Filz, Vliesstoff usw., Tauwerk",135340000,78643000,213983000
2010,1,WA57,"Teppiche, Fußbodenbelag aus Spinnstoff",36949000,84672000,121621000
2010,1,WA58,"Spezialgewebe, Spitzen, Tapisserien",35445000,22671000,58116000
2010,1,WA59,"Getränkte, bestrichene usw. Gewebe",125567000,68666000,194233000
2010,1,WA60,Gewirke und Gestricke,56046000,28722000,84768000
2010,1,WA61,"Bekleidung usw. aus Gewirken, Gestricken",441994000,865089000,1307083000
2010,1,WA62,"Andere Bekleidung, Bekleidungszubehör",566809000,990592000,1557401000
2010,1,WA63,"Andere Konfektion, Spinnstoffwaren usw.",121750000,218736000,340486000
2010,1,WA64,"Schuhe, Gamaschen, ähnliche Waren",250218000,502725000,752943000
2010,1,WA65,Kopfbedeckungen und Teile davon,17005000,29431000,46436000
2010,1,WA66,"Schirme, Gehstöcke usw., Peitschen",10707000,13486000,24193000
2010,1,WA67,"Zugerichtete Federn, Daunen, künstliche Blumen",5605000,10790000,16395000
2010,1,WA68,"Waren aus Steinen, Gips, Zement usw.",197170000,143939000,341109000
2010,1,WA69,Keramische Waren,182775000,147115000,329890000
2010,1,WA70,Glas und Glaswaren,356868000,273479000,630347000
2010,1,WA71,"Perlen, Edelsteine, Edelmetalle",622133000,818734000,1440867000
2010,1,WA72,Eisen und Stahl,1430613000,1327799000,2758412000
2010,1,WA73,Waren aus Eisen oder Stahl,1429006000,941451000,2370457000
2010,1,WA74,Kupfer und Waren daraus,686360000,523436000,1209796000
2010,1,WA75,Nickel und Waren daraus,48182000,72227000,120409000
2010,1,WA76,Aluminium und Waren daraus,681541000,735913000,1417454000
2010,1,WA78,Blei und Waren daraus,37786000,19155000,56941000
2010,1,WA79,Zink und Waren daraus,43133000,65977000,109110000
2010,1,WA80,Zinn und Waren daraus,6393000,19142000,25535000
2010,1,WA81,"Andere unedle Metalle, Cermets usw.",63156000,73187000,136343000
2010,1,WA82,"Werkzeuge, Schneidwaren, Essbestecke",384977000,242582000,627559000
2010,1,WA83,Verschiedene Waren aus unedlen Metallen,428284000,252282000,680566000
2010,1,WA84,"Maschinen, Apparate, mechanische Geräte",10458903000,6696034000,17154937000
2010,1,WA85,Elektrotechnische Erzeugnisse,6599273000,6230198000,12829471000
2010,1,WA86,Schienenfahrzeuge,208856000,102525000,311381000
2010,1,WA87,"Kraftfahrzeuge, Landfahrzeuge",9571783000,3565918000,13137701000
2010,1,WA88,"Luftfahrzeuge, Raumfahrzeuge",1465767000,1455458000,2921225000
2010,1,WA89,Wasserfahrzeuge,44775000,562728000,607503000
2010,1,WA90,"Optische, photografische usw. Erzeugnisse",2794128000,1633007000,4427135000
2010,1,WA91,Uhrmacherwaren,76832000,85879000,162711000
2010,1,WA92,Musikinstrumente,23524000,26366000,49890000
2010,1,WA93,Waffen und Munition,23413000,8590000,32003000
2010,1,WA94,"Möbel, Beleuchtungskörper usw.",797309000,953770000,1751079000
2010,1,WA95,"Spielzeug, Spiele usw., Sportgeräte",282551000,378354000,660905000
2010,1,WA96,Verschiedene Waren,122156000,96062000,218218000
2010,1,WA97,"Kunstgegenstände, Sammlungsstücke",38749000,29847000,68596000
2010,1,WA98,Vollständige Fabrikationsanlagen,235284000,1166000,236450000
2010,1,WA99,Zusammenstellungen verschiedener Waren,1005261000,829834000,1835095000
2010,2,WA01,Lebende Tiere,72568000,131328000,203896000
2010,2,WA02,Fleisch,423293000,333971000,757264000
2010,2,WA03,"Fische, Krebs- und Weichtiere",91293000,217250000,308543000
2010,2,WA04,"Milch, Milcherzeugnisse, Eier, Honig",530800000,452419000,983219000
2010,2,WA05,Andere Waren tierischen Ursprungs,48821000,50709000,99530000
2010,2,WA06,"Pflanzen, Waren des Blumenhandels",45195000,201859000,247054000
2010,2,WA07,"Gemüse, Pflanzen für Ernährung",64052000,410970000,475022000
2010,2,WA08,Genießbare Früchte und Nüsse,84623000,435336000,519959000
2010,2,WA09,"Kaffee, Tee, Mate, Gewürze",123292000,223330000,346622000
2010,2,WA10,Getreide,134730000,141638000,276368000
2010,2,WA11,"Müllereierzeugnisse, Malz usw.",72200000,28713000,100913000
2010,2,WA12,"Ölsamen usw., Heilpflanzen usw.",123091000,204584000,327675000
2010,2,WA13,"Schellack, Gummen, Harz, Pflanzensaft",34517000,30742000,65259000
2010,2,WA14,Flechtstoffe usw. pflanzlichen Ursprungs,631000,1495000,2126000
2010,2,WA15,"Tierische und pflanzliche Fette, Öle, Wachs",121557000,202290000,323847000
2010,2,WA16,"Zubereitungen von Fleisch, Fisch usw.",160175000,134737000,294912000
2010,2,WA17,Zucker und Zuckerwaren,128378000,92037000,220415000
2010,2,WA18,Kakao und Zubereitungen aus Kakao,255623000,244182000,499805000
2010,2,WA19,"Zubereitungen aus Getreide usw., Backwaren",314384000,180234000,494618000
2010,2,WA20,"Zubereitungen von Gemüse, Früchten usw.",145683000,272125000,417808000
2010,2,WA21,Verschiedene Lebensmittelzubereitungen,281294000,224631000,505925000
2010,2,WA22,"Getränke, alkoholhaltige Flüssigkeiten, Essig",299140000,376095000,675235000
2010,2,WA23,"Rückstände der Lebensmittelindustrie, Futter",212980000,220821000,433801000
2010,2,WA24,Tabak,259314000,121407000,380721000
2010,2,WA25,"Salz, Schwefel, Steine, Erden usw.",120960000,134833000,255793000
2010,2,WA26,"Erze, Schlacken, Aschen",26234000,487698000,513932000
2010,2,WA27,Mineralische Brennstoffe usw.,1557473000,6787091000,8344564000
2010,2,WA28,Anorganische chemische Erzeugnisse,563294000,512095000,1075389000
2010,2,WA29,Organische chemische Erzeugnisse,1688623000,1543358000,3231981000
2010,2,WA30,Pharmazeutische Erzeugnisse,3701565000,2831356000,6532921000
2010,2,WA31,Düngemittel,161876000,83144000,245020000
2010,2,WA32,"Gerb- und Farbstoffe, Farben, Lacke usw.",625929000,300638000,926567000
2010,2,WA33,"Etherische Öle, Riech-, Schönheitsmittel",573529000,325769000,899298000
2010,2,WA34,"Seifen, Waschmittel usw.",421045000,214002000,635047000
2010,2,WA35,"Eiweißstoffe, Klebstoffe, Enzyme",177795000,123601000,301396000
2010,2,WA36,"Sprengstoffe, pyrotechnische Artikel usw.",14620000,12739000,27359000
2010,2,WA37,Photochemische Erzeugnisse,83569000,60583000,144152000
2010,2,WA38,Verschiedene Erzeugnisse der Chemischen Industrie,1182637000,777051000,1959688000
2010,2,WA39,Kunststoffe und Waren daraus,3370048000,1983542000,5353590000
2010,2,WA40,Kautschuk und Waren daraus,820243000,777349000,1597592000
2010,2,WA41,"Häute, Felle, Leder",51222000,53485000,104707000
2010,2,WA42,"Lederwaren, Sattlerwaren",107220000,176780000,284000000
2010,2,WA43,"Pelzfelle, künstliches Pelzwerk",5541000,6460000,12001000
2010,2,WA44,"Holz, Holzwaren, Holzkohle",469696000,412582000,882278000
2010,2,WA45,"Kork, Korkwaren",2300000,5936000,8236000
2010,2,WA46,"Flechtwaren, Korbmacherwaren",4059000,9376000,13435000
2010,2,WA47,"Halbstoffe aus Holz usw., Papierabfall",67444000,237909000,305353000
2010,2,WA48,"Papier, Pappe und Waren daraus",1340000000,886221000,2226221000
2010,2,WA49,"Bücher, Zeitungen, Bilddrucke usw.",345481000,147263000,492744000
2010,2,WA50,Seide,4508000,4201000,8709000
2010,2,WA51,"Wolle, feine und grobe Tierhaare",40408000,50732000,91140000
2010,2,WA52,Baumwolle,71326000,61524000,132850000
2010,2,WA53,"Andere pflanzliche Spinnstoffe, Papiergarn",4153000,4965000,9118000
2010,2,WA54,Synthetisches oder künstliches Filament,147542000,103887000,251429000
2010,2,WA55,Synthetische oder künstliche Spinnfaser,141879000,97185000,239064000
2010,2,WA56,"Watte, Filz, Vliesstoff usw., Tauwerk",145812000,80351000,226163000
2010,2,WA57,"Teppiche, Fußbodenbelag aus Spinnstoff",36325000,89579000,125904000
2010,2,WA58,"Spezialgewebe, Spitzen, Tapisserien",36700000,23045000,59745000
2010,2,WA59,"Getränkte, bestrichene usw. Gewebe",134444000,68199000,202643000
2010,2,WA60,Gewirke und Gestricke,57707000,26880000,84587000
2010,2,WA61,"Bekleidung usw. aus Gewirken, Gestricken",461428000,812058000,1273486000
2010,2,WA62,"Andere Bekleidung, Bekleidungszubehör",642955000,998705000,1641660000
2010,2,WA63,"Andere Konfektion, Spinnstoffwaren usw.",127137000,202379000,329516000
2010,2,WA64,"Schuhe, Gamaschen, ähnliche Waren",290403000,509296000,799699000
2010,2,WA65,Kopfbedeckungen und Teile davon,18767000,30575000,49342000
2010,2,WA66,"Schirme, Gehstöcke usw., Peitschen",16285000,17312000,33597000
2010,2,WA67,"Zugerichtete Federn, Daunen, künstliche Blumen",6688000,11484000,18172000
2010,2,WA68,"Waren aus Steinen, Gips, Zement usw.",221177000,147799000,368976000
2010,2,WA69,Keramische Waren,193346000,153968000,347314000
2010,2,WA70,Glas und Glaswaren,356963000,274164000,631127000
2010,2,WA71,"Perlen, Edelsteine, Edelmetalle",834426000,767990000,1602416000
2010,2,WA72,Eisen und Stahl,1570592000,1360809000,2931401000
2010,2,WA73,Waren aus Eisen oder Stahl,1620113000,994654000,2614767000
2010,2,WA74,Kupfer und Waren daraus,676172000,641826000,1317998000
2010,2,WA75,Nickel und Waren daraus,49991000,105975000,155966000
2010,2,WA76,Aluminium und Waren daraus,767379000,823157000,1590536000
2010,2,WA78,Blei und Waren daraus,38032000,30375000,68407000
2010,2,WA79,Zink und Waren daraus,42300000,75574000,117874000
2010,2,WA80,Zinn und Waren daraus,7591000,23229000,30820000
2010,2,WA81,"Andere unedle Metalle, Cermets usw.",74212000,73466000,147678000
2010,2,WA82,"Werkzeuge, Schneidwaren, Essbestecke",447234000,250709000,697943000
2010,2,WA83,Verschiedene Waren aus unedlen Metallen,437014000,266895000,703909000
2010,2,WA84,"Maschinen, Apparate, mechanische Geräte",11570906000,6929550000,18500456000
2010,2,WA85,Elektrotechnische Erzeugnisse,7047014000,6463315000,13510329000
2010,2,WA86,Schienenfahrzeuge,291258000,147679000,438937000
2010,2,WA87,"Kraftfahrzeuge, Landfahrzeuge",11401676000,3991352000,15393028000
2010,2,WA88,"Luftfahrzeuge, Raumfahrzeuge",1938153000,1704911000,3643064000
2010,2,WA89,Wasserfahrzeuge,413057000,411258000,824315000
2010,2,WA90,"Optische, photografische usw. Erzeugnisse",3102771000,1677814000,4780585000
2010,2,WA91,Uhrmacherwaren,87475000,84074000,171549000
2010,2,WA92,Musikinstrumente,31071000,41812000,72883000
2010,2,WA93,Waffen und Munition,29019000,10302000,39321000
2010,2,WA94,"Möbel, Beleuchtungskörper usw.",872671000,933741000,1806412000
2010,2,WA95,"Spielzeug, Spiele usw., Sportgeräte",331514000,410580000,742094000
2010,2,WA96,Verschiedene Waren,140937000,86678000,227615000
2010,2,WA97,"Kunstgegenstände, Sammlungsstücke",29712000,16776000,46488000
2010,2,WA98,Vollständige Fabrikationsanlagen,373365000,597000,373962000
2010,2,WA99,Zusammenstellungen verschiedener Waren,1093724000,852857000,1946581000
2010,3,WA01,Lebende Tiere,85929000,115441000,201370000
2010,3,WA02,Fleisch,542355000,460056000,1002411000
2010,3,WA03,"Fische, Krebs- und Weichtiere",91315000,242329000,333644000
2010,3,WA04,"Milch, Milcherzeugnisse, Eier, Honig",600642000,537002000,1137644000
2010,3,WA05,Andere Waren tierischen Ursprungs,51920000,55610000,107530000
2010,3,WA06,"Pflanzen, Waren des Blumenhandels",76635000,304286000,380921000
2010,3,WA07,"Gemüse, Pflanzen für Ernährung",83308000,517439000,600747000
2010,3,WA08,Genießbare Früchte und Nüsse,109220000,485534000,594754000
2010,3,WA09,"Kaffee, Tee, Mate, Gewürze",164518000,251485000,416003000
2010,3,WA10,Getreide,175159000,149104000,324263000
2010,3,WA11,"Müllereierzeugnisse, Malz usw.",76993000,34631000,111624000
2010,3,WA12,"Ölsamen usw., Heilpflanzen usw.",130250000,242290000,372540000
2010,3,WA13,"Schellack, Gummen, Harz, Pflanzensaft",43130000,30803000,73933000
2010,3,WA14,Flechtstoffe usw. pflanzlichen Ursprungs,927000,2456000,3383000
2010,3,WA15,"Tierische und pflanzliche Fette, Öle, Wachs",154852000,267536000,422388000
2010,3,WA16,"Zubereitungen von Fleisch, Fisch usw.",205241000,169512000,374753000
2010,3,WA17,Zucker und Zuckerwaren,141741000,109120000,250861000
2010,3,WA18,Kakao und Zubereitungen aus Kakao,247093000,246608000,493701000
2010,3,WA19,"Zubereitungen aus Getreide usw., Backwaren",372195000,214764000,586959000
2010,3,WA20,"Zubereitungen von Gemüse, Früchten usw.",173046000,301133000,474179000
2010,3,WA21,Verschiedene Lebensmittelzubereitungen,337184000,231743000,568927000
2010,3,WA22,"Getränke, alkoholhaltige Flüssigkeiten, Essig",362557000,453899000,816456000
2010,3,WA23,"Rückstände der Lebensmittelindustrie, Futter",242469000,212224000,454693000
2010,3,WA24,Tabak,286998000,138988000,425986000
2010,3,WA25,"Salz, Schwefel, Steine, Erden usw.",181721000,144998000,326719000
2010,3,WA26,"Erze, Schlacken, Aschen",32350000,484880000,517230000
2010,3,WA27,Mineralische Brennstoffe usw.,1752335000,7955998000,9708333000
2010,3,WA28,Anorganische chemische Erzeugnisse,695015000,513037000,1208052000
2010,3,WA29,Organische chemische Erzeugnisse,1981016000,1906069000,3887085000
2010,3,WA30,Pharmazeutische Erzeugnisse,4425800000,3245944000,7671744000
2010,3,WA31,Düngemittel,199445000,99416000,298861000
2010,3,WA32,"Gerb- und Farbstoffe, Farben, Lacke usw.",757290000,379445000,1136735000
2010,3,WA33,"Etherische Öle, Riech-, Schönheitsmittel",638011000,361106000,999117000
2010,3,WA34,"Seifen, Waschmittel usw.",467392000,247045000,714437000
2010,3,WA35,"Eiweißstoffe, Klebstoffe, Enzyme",195981000,132051000,328032000
2010,3,WA36,"Sprengstoffe, pyrotechnische Artikel usw.",18930000,14144000,33074000
2010,3,WA37,Photochemische Erzeugnisse,101842000,72734000,174576000
2010,3,WA38,Verschiedene Erzeugnisse der Chemischen Industrie,1435683000,962353000,2398036000
2010,3,WA39,Kunststoffe und Waren daraus,4020492000,2359640000,6380132000
2010,3,WA40,Kautschuk und Waren daraus,1006561000,947069000,1953630000
2010,3,WA41,"Häute, Felle, Leder",78577000,69663000,148240000
2010,3,WA42,"Lederwaren, Sattlerwaren",116129000,199115000,315244000
2010,3,WA43,"Pelzfelle, künstliches Pelzwerk",12467000,11017000,23484000
2010,3,WA44,"Holz, Holzwaren, Holzkohle",572368000,526885000,1099253000
2010,3,WA45,"Kork, Korkwaren",3249000,13939000,17188000
2010,3,WA46,"Flechtwaren, Korbmacherwaren",4572000,9624000,14196000
2010,3,WA47,"Halbstoffe aus Holz usw., Papierabfall",77001000,318420000,395421000
2010,3,WA48,"Papier, Pappe und Waren daraus",1541485000,951375000,2492860000
2010,3,WA49,"Bücher, Zeitungen, Bilddrucke usw.",374873000,165283000,540156000
2010,3,WA50,Seide,5776000,6236000,12012000
2010,3,WA51,"Wolle, feine und grobe Tierhaare",55823000,65118000,120941000
2010,3,WA52,Baumwolle,83096000,74436000,157532000
2010,3,WA53,"Andere pflanzliche Spinnstoffe, Papiergarn",3810000,4531000,8341000
2010,3,WA54,Synthetisches oder künstliches Filament,176712000,123486000,300198000
2010,3,WA55,Synthetische oder künstliche Spinnfaser,165480000,121821000,287301000
2010,3,WA56,"Watte, Filz, Vliesstoff usw., Tauwerk",169274000,100124000,269398000
2010,3,WA57,"Teppiche, Fußbodenbelag aus Spinnstoff",42597000,103409000,146006000
2010,3,WA58,"Spezialgewebe, Spitzen, Tapisserien",45783000,30040000,75823000
2010,3,WA59,"Getränkte, bestrichene usw. Gewebe",168438000,84146000,252584000
2010,3,WA60,Gewirke und Gestricke,72855000,36818000,109673000
2010,3,WA61,"Bekleidung usw. aus Gewirken, Gestricken",494331000,894098000,1388429000
2010,3,WA62,"Andere Bekleidung, Bekleidungszubehör",674353000,1042460000,1716813000
2010,3,WA63,"Andere Konfektion, Spinnstoffwaren usw.",159254000,256610000,415864000
2010,3,WA64,"Schuhe, Gamaschen, ähnliche Waren",299532000,527744000,827276000
2010,3,WA65,Kopfbedeckungen und Teile davon,21737000,33394000,55131000
2010,3,WA66,"Schirme, Gehstöcke usw., Peitschen",19791000,22518000,42309000
2010,3,WA67,"Zugerichtete Federn, Daunen, künstliche Blumen",7315000,9617000,16932000
2010,3,WA68,"Waren aus Steinen, Gips, Zement usw.",289570000,183606000,473176000
2010,3,WA69,Keramische Waren,247390000,186263000,433653000
2010,3,WA70,Glas und Glaswaren,449390000,336585000,785975000
2010,3,WA71,"Perlen, Edelsteine, Edelmetalle",900442000,1023677000,1924119000
2010,3,WA72,Eisen und Stahl,1958248000,1686997000,3645245000
2010,3,WA73,Waren aus Eisen oder Stahl,1971715000,1194961000,3166676000
2010,3,WA74,Kupfer und Waren daraus,1065359000,789742000,1855101000
2010,3,WA75,Nickel und Waren daraus,68935000,134104000,203039000
2010,3,WA76,Aluminium und Waren daraus,919540000,1016963000,1936503000
2010,3,WA78,Blei und Waren daraus,45260000,27012000,72272000
2010,3,WA79,Zink und Waren daraus,52377000,93146000,145523000
2010,3,WA80,Zinn und Waren daraus,8130000,26404000,34534000
2010,3,WA81,"Andere unedle Metalle, Cermets usw.",81106000,97746000,178852000
2010,3,WA82,"Werkzeuge, Schneidwaren, Essbestecke",539565000,301288000,840853000
2010,3,WA83,Verschiedene Waren aus unedlen Metallen,517839000,296220000,814059000
2010,3,WA84,"Maschinen, Apparate, mechanische Geräte",14860238000,8554583000,23414821000
2010,3,WA85,Elektrotechnische Erzeugnisse,8671033000,8178261000,16849294000
2010,3,WA86,Schienenfahrzeuge,436082000,151034000,587116000
2010,3,WA87,"Kraftfahrzeuge, Landfahrzeuge",14299088000,5236024000,19535112000
2010,3,WA88,"Luftfahrzeuge, Raumfahrzeuge",2046041000,1268213000,3314254000
2010,3,WA89,Wasserfahrzeuge,675305000,2038560000,2713865000
2010,3,WA90,"Optische, photografische usw. Erzeugnisse",3776046000,2062166000,5838212000
2010,3,WA91,Uhrmacherwaren,93881000,102312000,196193000
2010,3,WA92,Musikinstrumente,35233000,42202000,77435000
2010,3,WA93,Waffen und Munition,39797000,12842000,52639000
2010,3,WA94,"Möbel, Beleuchtungskörper usw.",1081531000,1189538000,2271069000
2010,3,WA95,"Spielzeug, Spiele usw., Sportgeräte",386291000,427095000,813386000
2010,3,WA96,Verschiedene Waren,168633000,108049000,276682000
2010,3,WA97,"Kunstgegenstände, Sammlungsstücke",59225000,35386000,94611000
2010,3,WA98,Vollständige Fabrikationsanlagen,428195000,1744000,429939000
2010,3,WA99,Zusammenstellungen verschiedener Waren,1295115000,1130445000,2425560000
2010,4,WA01,Lebende Tiere,85754000,127089000,212843000
2010,4,WA02,Fleisch,494026000,356950000,850976000
2010,4,WA03,"Fische, Krebs- und Weichtiere",82779000,207632000,290411000
2010,4,WA04,"Milch, Milcherzeugnisse, Eier, Honig",548091000,431359000,979450000
2010,4,WA05,Andere Waren tierischen Ursprungs,46506000,49423000,95929000
2010,4,WA06,"Pflanzen, Waren des Blumenhandels",93144000,314657000,407801000
2010,4,WA07,"Gemüse, Pflanzen für Ernährung",76440000,542605000,619045000
2010,4,WA08,Genießbare Früchte und Nüsse,99871000,449821000,549692000
2010,4,WA09,"Kaffee, Tee, Mate, Gewürze",135781000,229424000,365205000
2010,4,WA10,Getreide,155031000,102687000,257718000
2010,4,WA11,"Müllereierzeugnisse, Malz usw.",68074000,30993000,99067000
2010,4,WA12,"Ölsamen usw., Heilpflanzen usw.",64579000,202616000,267195000
2010,4,WA13,"Schellack, Gummen, Harz, Pflanzensaft",45852000,29181000,75033000
2010,4,WA14,Flechtstoffe usw. pflanzlichen Ursprungs,974000,1894000,2868000
2010,4,WA15,"Tierische und pflanzliche Fette, Öle, Wachs",132609000,222048000,354657000
2010,4,WA16,"Zubereitungen von Fleisch, Fisch usw.",169814000,155282000,325096000
2010,4,WA17,Zucker und Zuckerwaren,120965000,103438000,224403000
2010,4,WA18,Kakao und Zubereitungen aus Kakao,193689000,215021000,408710000
2010,4,WA19,"Zubereitungen aus Getreide usw., Backwaren",322891000,191876000,514767000
2010,4,WA20,"Zubereitungen von Gemüse, Früchten usw.",151934000,287742000,439676000
2010,4,WA21,Verschiedene Lebensmittelzubereitungen,311069000,224622000,535691000
2010,4,WA22,"Getränke, alkoholhaltige Flüssigkeiten, Essig",366784000,410042000,776826000
2010,4,WA23,"Rückstände der Lebensmittelindustrie, Futter",202992000,217011000,420003000
2010,4,WA24,Tabak,272573000,144358000,416931000
2010,4,WA25,"Salz, Schwefel, Steine, Erden usw.",155098000,144206000,299304000
2010,4,WA26,"Erze, Schlacken, Aschen",28012000,590788000,618800000
2010,4,WA27,Mineralische Brennstoffe usw.,1680328000,7555928000,9236256000
2010,4,WA28,Anorganische chemische Erzeugnisse,626189000,669455000,1295644000
2010,4,WA29,Organische chemische Erzeugnisse,2013372000,1742224000,3755596000
2010,4,WA30,Pharmazeutische Erzeugnisse,3707716000,2967479000,6675195000
2010,4,WA31,Düngemittel,168228000,75494000,243722000
2010,4,WA32,"Gerb- und Farbstoffe, Farben, Lacke usw.",713017000,321697000,1034714000
2010,4,WA33,"Etherische Öle, Riech-, Schönheitsmittel",592095000,319001000,911096000
2010,4,WA34,"Seifen, Waschmittel usw.",415789000,220268000,636057000
2010,4,WA35,"Eiweißstoffe, Klebstoffe, Enzyme",177888000,123691000,301579000
2010,4,WA36,"Sprengstoffe, pyrotechnische Artikel usw.",15829000,14990000,30819000
2010,4,WA37,Photochemische Erzeugnisse,94920000,65471000,160391000
2010,4,WA38,Verschiedene Erzeugnisse der Chemischen Industrie,1301400000,779579000,2080979000
2010,4,WA39,Kunststoffe und Waren daraus,3692800000,2196788000,5889588000
2010,4,WA40,Kautschuk und Waren daraus,923402000,883787000,1807189000
2010,4,WA41,"Häute, Felle, Leder",59488000,66640000,126128000
2010,4,WA42,"Lederwaren, Sattlerwaren",88804000,157504000,246308000
2010,4,WA43,"Pelzfelle, künstliches Pelzwerk",14468000,8260000,22728000
2010,4,WA44,"Holz, Holzwaren, Holzkohle",530777000,484731000,1015508000
2010,4,WA45,"Kork, Korkwaren",2131000,6871000,9002000
2010,4,WA46,"Flechtwaren, Korbmacherwaren",3177000,9419000,12596000
2010,4,WA47,"Halbstoffe aus Holz usw., Papierabfall",84986000,298977000,383963000
2010,4,WA48,"Papier, Pappe und Waren daraus",1402558000,917274000,2319832000
2010,4,WA49,"Bücher, Zeitungen, Bilddrucke usw.",328296000,161578000,489874000
2010,4,WA50,Seide,5705000,6071000,11776000
2010,4,WA51,"Wolle, feine und grobe Tierhaare",47944000,64214000,112158000
2010,4,WA52,Baumwolle,78780000,74774000,153554000
2010,4,WA53,"Andere pflanzliche Spinnstoffe, Papiergarn",2740000,4544000,7284000
2010,4,WA54,Synthetisches oder künstliches Filament,159430000,112873000,272303000
2010,4,WA55,Synthetische oder künstliche Spinnfaser,154697000,117115000,271812000
2010,4,WA56,"Watte, Filz, Vliesstoff usw., Tauwerk",155805000,87366000,243171000
2010,4,WA57,"Teppiche, Fußbodenbelag aus Spinnstoff",40426000,77279000,117705000
2010,4,WA58,"Spezialgewebe, Spitzen, Tapisserien",38813000,26194000,65007000
2010,4,WA59,"Getränkte, bestrichene usw. Gewebe",141869000,73030000,214899000
2010,4,WA60,Gewirke und Gestricke,67932000,36317000,104249000
2010,4,WA61,"Bekleidung usw. aus Gewirken, Gestricken",382147000,750812000,1132959000
2010,4,WA62,"Andere Bekleidung, Bekleidungszubehör",465112000,794383000,1259495000
2010,4,WA63,"Andere Konfektion, Spinnstoffwaren usw.",142778000,219311000,362089000
2010,4,WA64,"Schuhe, Gamaschen, ähnliche Waren",182916000,368960000,551876000
2010,4,WA65,Kopfbedeckungen und Teile davon,17843000,26451000,44294000
2010,4,WA66,"Schirme, Gehstöcke usw., Peitschen",18919000,17282000,36201000
2010,4,WA67,"Zugerichtete Federn, Daunen, künstliche Blumen",4389000,7498000,11887000
2010,4,WA68,"Waren aus Steinen, Gips, Zement usw.",262297000,174563000,436860000
2010,4,WA69,Keramische Waren,223598000,158838000,382436000
2010,4,WA70,Glas und Glaswaren,398504000,300502000,699006000
2010,4,WA71,"Perlen, Edelsteine, Edelmetalle",833325000,938435000,1771760000
2010,4,WA72,Eisen und Stahl,1958288000,1730001000,3688289000
2010,4,WA73,Waren aus Eisen oder Stahl,1748137000,1093857000,2841994000
2010,4,WA74,Kupfer und Waren daraus,837221000,736265000,1573486000
2010,4,WA75,Nickel und Waren daraus,61494000,148140000,209634000
2010,4,WA76,Aluminium und Waren daraus,815507000,922856000,1738363000
2010,4,WA78,Blei und Waren daraus,36752000,26544000,63296000
2010,4,WA79,Zink und Waren daraus,49322000,85640000,134962000
2010,4,WA80,Zinn und Waren daraus,6509000,21003000,27512000
2010,4,WA81,"Andere unedle Metalle, Cermets usw.",76772000,86655000,163427000
2010,4,WA82,"Werkzeuge, Schneidwaren, Essbestecke",437830000,255701000,693531000
2010,4,WA83,Verschiedene Waren aus unedlen Metallen,480481000,264622000,745103000
2010,4,WA84,"Maschinen, Apparate, mechanische Geräte",13104609000,7469324000,20573933000
2010,4,WA85,Elektrotechnische Erzeugnisse,7465630000,7257280000,14722910000
2010,4,WA86,Schienenfahrzeuge,403331000,148272000,551603000
2010,4,WA87,"Kraftfahrzeuge, Landfahrzeuge",12296528000,4899575000,17196103000
2010,4,WA88,"Luftfahrzeuge, Raumfahrzeuge",1770235000,1228475000,2998710000
2010,4,WA89,Wasserfahrzeuge,639227000,1031536000,1670763000
2010,4,WA90,"Optische, photografische usw. Erzeugnisse",3172032000,1782163000,4954195000
2010,4,WA91,Uhrmacherwaren,82515000,82723000,165238000
2010,4,WA92,Musikinstrumente,35178000,34558000,69736000
2010,4,WA93,Waffen und Munition,33723000,12205000,45928000
2010,4,WA94,"Möbel, Beleuchtungskörper usw.",874581000,987244000,1861825000
2010,4,WA95,"Spielzeug, Spiele usw., Sportgeräte",326626000,361376000,688002000
2010,4,WA96,Verschiedene Waren,153626000,97305000,250931000
2010,4,WA97,"Kunstgegenstände, Sammlungsstücke",63704000,30092000,93796000
2010,4,WA98,Vollständige Fabrikationsanlagen,402357000,1830000,404187000
2010,4,WA99,Zusammenstellungen verschiedener Waren,963354000,927229000,1890583000
2010,5,WA01,Lebende Tiere,88860000,134398000,223258000
2010,5,WA02,Fleisch,478781000,429788000,908569000
2010,5,WA03,"Fische, Krebs- und Weichtiere",81791000,211613000,293404000
2010,5,WA04,"Milch, Milcherzeugnisse, Eier, Honig",581597000,500433000,1082030000
2010,5,WA05,Andere Waren tierischen Ursprungs,50328000,56456000,106784000
2010,5,WA06,"Pflanzen, Waren des Blumenhandels",58058000,326860000,384918000
2010,5,WA07,"Gemüse, Pflanzen für Ernährung",83930000,503563000,587493000
2010,5,WA08,Genießbare Früchte und Nüsse,111097000,517009000,628106000
2010,5,WA09,"Kaffee, Tee, Mate, Gewürze",134271000,234786000,369057000
2010,5,WA10,Getreide,150170000,107010000,257180000
2010,5,WA11,"Müllereierzeugnisse, Malz usw.",73216000,32000000,105216000
2010,5,WA12,"Ölsamen usw., Heilpflanzen usw.",54248000,249183000,303431000
2010,5,WA13,"Schellack, Gummen, Harz, Pflanzensaft",37139000,34905000,72044000
2010,5,WA14,Flechtstoffe usw. pflanzlichen Ursprungs,762000,2889000,3651000
2010,5,WA15,"Tierische und pflanzliche Fette, Öle, Wachs",144936000,198704000,343640000
2010,5,WA16,"Zubereitungen von Fleisch, Fisch usw.",201021000,160077000,361098000
2010,5,WA17,Zucker und Zuckerwaren,115198000,94598000,209796000
2010,5,WA18,Kakao und Zubereitungen aus Kakao,195494000,209535000,405029000
2010,5,WA19,"Zubereitungen aus Getreide usw., Backwaren",327171000,199082000,526253000
2010,5,WA20,"Zubereitungen von Gemüse, Früchten usw.",161341000,274316000,435657000
2010,5,WA21,Verschiedene Lebensmittelzubereitungen,324228000,227876000,552104000
2010,5,WA22,"Getränke, alkoholhaltige Flüssigkeiten, Essig",389960000,441024000,830984000
2010,5,WA23,"Rückstände der Lebensmittelindustrie, Futter",208759000,233050000,441809000
2010,5,WA24,Tabak,317211000,122834000,440045000
2010,5,WA25,"Salz, Schwefel, Steine, Erden usw.",168895000,146282000,315177000
2010,5,WA26,"Erze, Schlacken, Aschen",25082000,646078000,671160000
2010,5,WA27,Mineralische Brennstoffe usw.,1659904000,7985792000,9645696000
2010,5,WA28,Anorganische chemische Erzeugnisse,637719000,447268000,1084987000
2010,5,WA29,Organische chemische Erzeugnisse,1744206000,1906774000,3650980000
2010,5,WA30,Pharmazeutische Erzeugnisse,4026217000,2667232000,6693449000
2010,5,WA31,Düngemittel,151915000,76768000,228683000
2010,5,WA32,"Gerb- und Farbstoffe, Farben, Lacke usw.",705893000,343917000,1049810000
2010,5,WA33,"Etherische Öle, Riech-, Schönheitsmittel",566870000,327431000,894301000
2010,5,WA34,"Seifen, Waschmittel usw.",418942000,222517000,641459000
2010,5,WA35,"Eiweißstoffe, Klebstoffe, Enzyme",189316000,128446000,317762000
2010,5,WA36,"Sprengstoffe, pyrotechnische Artikel usw.",17475000,14211000,31686000
2010,5,WA37,Photochemische Erzeugnisse,90464000,65583000,156047000
2010,5,WA38,Verschiedene Erzeugnisse der Chemischen Industrie,1254110000,871341000,2125451000
2010,5,WA39,Kunststoffe und Waren daraus,3827029000,2393535000,6220564000
2010,5,WA40,Kautschuk und Waren daraus,933578000,854132000,1787710000
2010,5,WA41,"Häute, Felle, Leder",81333000,81060000,162393000
2010,5,WA42,"Lederwaren, Sattlerwaren",90719000,192904000,283623000
2010,5,WA43,"Pelzfelle, künstliches Pelzwerk",12494000,9896000,22390000
2010,5,WA44,"Holz, Holzwaren, Holzkohle",567322000,509060000,1076382000
2010,5,WA45,"Kork, Korkwaren",2872000,10180000,13052000
2010,5,WA46,"Flechtwaren, Korbmacherwaren",3424000,9993000,13417000
2010,5,WA47,"Halbstoffe aus Holz usw., Papierabfall",88587000,317191000,405778000
2010,5,WA48,"Papier, Pappe und Waren daraus",1495390000,917409000,2412799000
2010,5,WA49,"Bücher, Zeitungen, Bilddrucke usw.",323047000,152919000,475966000
2010,5,WA50,Seide,6108000,6021000,12129000
2010,5,WA51,"Wolle, feine und grobe Tierhaare",73755000,68617000,142372000
2010,5,WA52,Baumwolle,87019000,78686000,165705000
2010,5,WA53,"Andere pflanzliche Spinnstoffe, Papiergarn",2724000,4645000,7369000
2010,5,WA54,Synthetisches oder künstliches Filament,165228000,126159000,291387000
2010,5,WA55,Synthetische oder künstliche Spinnfaser,159284000,115663000,274947000
2010,5,WA56,"Watte, Filz, Vliesstoff usw., Tauwerk",159127000,85025000,244152000
2010,5,WA57,"Teppiche, Fußbodenbelag aus Spinnstoff",36669000,80442000,117111000
2010,5,WA58,"Spezialgewebe, Spitzen, Tapisserien",39938000,26989000,66927000
2010,5,WA59,"Getränkte, bestrichene usw. Gewebe",152111000,88220000,240331000
2010,5,WA60,Gewirke und Gestricke,79070000,38335000,117405000
2010,5,WA61,"Bekleidung usw. aus Gewirken, Gestricken",348710000,773511000,1122221000
2010,5,WA62,"Andere Bekleidung, Bekleidungszubehör",365293000,789038000,1154331000
2010,5,WA63,"Andere Konfektion, Spinnstoffwaren usw.",141659000,232885000,374544000
2010,5,WA64,"Schuhe, Gamaschen, ähnliche Waren",182270000,361548000,543818000
2010,5,WA65,Kopfbedeckungen und Teile davon,17905000,26473000,44378000
2010,5,WA66,"Schirme, Gehstöcke usw., Peitschen",8093000,13971000,22064000
2010,5,WA67,"Zugerichtete Federn, Daunen, künstliche Blumen",4234000,9430000,13664000
2010,5,WA68,"Waren aus Steinen, Gips, Zement usw.",275599000,186544000,462143000
2010,5,WA69,Keramische Waren,224078000,172844000,396922000
2010,5,WA70,Glas und Glaswaren,408157000,333607000,741764000
2010,5,WA71,"Perlen, Edelsteine, Edelmetalle",902919000,1801249000,2704168000
2010,5,WA72,Eisen und Stahl,2011688000,1979814000,3991502000
2010,5,WA73,Waren aus Eisen oder Stahl,1849596000,1190993000,3040589000
2010,5,WA74,Kupfer und Waren daraus,851099000,826856000,1677955000
2010,5,WA75,Nickel und Waren daraus,61426000,140773000,202199000
2010,5,WA76,Aluminium und Waren daraus,819948000,1021306000,1841254000
2010,5,WA78,Blei und Waren daraus,36600000,41295000,77895000
2010,5,WA79,Zink und Waren daraus,51261000,99641000,150902000
2010,5,WA80,Zinn und Waren daraus,8001000,21936000,29937000
2010,5,WA81,"Andere unedle Metalle, Cermets usw.",80578000,91877000,172455000
2010,5,WA82,"Werkzeuge, Schneidwaren, Essbestecke",467410000,268341000,735751000
2010,5,WA83,Verschiedene Waren aus unedlen Metallen,479112000,297097000,776209000
2010,5,WA84,"Maschinen, Apparate, mechanische Geräte",13003278000,7657764000,20661042000
2010,5,WA85,Elektrotechnische Erzeugnisse,7638438000,7957432000,15595870000
2010,5,WA86,Schienenfahrzeuge,363481000,147604000,511085000
2010,5,WA87,"Kraftfahrzeuge, Landfahrzeuge",12753429000,4934139000,17687568000
2010,5,WA88,"Luftfahrzeuge, Raumfahrzeuge",2157343000,1308079000,3465422000
2010,5,WA89,Wasserfahrzeuge,72718000,1312919000,1385637000
2010,5,WA90,"Optische, photografische usw. Erzeugnisse",3304729000,1918779000,5223508000
2010,5,WA91,Uhrmacherwaren,95195000,97628000,192823000
2010,5,WA92,Musikinstrumente,30551000,31339000,61890000
2010,5,WA93,Waffen und Munition,35467000,13622000,49089000
2010,5,WA94,"Möbel, Beleuchtungskörper usw.",913643000,1034806000,1948449000
2010,5,WA95,"Spielzeug, Spiele usw., Sportgeräte",300820000,372934000,673754000
2010,5,WA96,Verschiedene Waren,157455000,104361000,261816000
2010,5,WA97,"Kunstgegenstände, Sammlungsstücke",45252000,33250000,78502000
2010,5,WA98,Vollständige Fabrikationsanlagen,325060000,2020000,327080000
2010,5,WA99,Zusammenstellungen verschiedener Waren,985402000,922378000,1907780000
2010,6,WA01,Lebende Tiere,100421000,123866000,224287000
2010,6,WA02,Fleisch,543915000,407936000,951851000
2010,6,WA03,"Fische, Krebs- und Weichtiere",87486000,214303000,301789000
2010,6,WA04,"Milch, Milcherzeugnisse, Eier, Honig",612314000,462755000,1075069000
2010,6,WA05,Andere Waren tierischen Ursprungs,53668000,62923000,116591000
2010,6,WA06,"Pflanzen, Waren des Blumenhandels",45679000,235465000,281144000
2010,6,WA07,"Gemüse, Pflanzen für Ernährung",72257000,399771000,472028000
2010,6,WA08,Genießbare Früchte und Nüsse,110664000,559937000,670601000
2010,6,WA09,"Kaffee, Tee, Mate, Gewürze",147157000,294703000,441860000
2010,6,WA10,Getreide,183277000,112725000,296002000
2010,6,WA11,"Müllereierzeugnisse, Malz usw.",72230000,31648000,103878000
2010,6,WA12,"Ölsamen usw., Heilpflanzen usw.",51129000,180103000,231232000
2010,6,WA13,"Schellack, Gummen, Harz, Pflanzensaft",47521000,32457000,79978000
2010,6,WA14,Flechtstoffe usw. pflanzlichen Ursprungs,762000,2705000,3467000
2010,6,WA15,"Tierische und pflanzliche Fette, Öle, Wachs",155979000,282562000,438541000
2010,6,WA16,"Zubereitungen von Fleisch, Fisch usw.",185130000,162616000,347746000
2010,6,WA17,Zucker und Zuckerwaren,136865000,101827000,238692000
2010,6,WA18,Kakao und Zubereitungen aus Kakao,206397000,216476000,422873000
2010,6,WA19,"Zubereitungen aus Getreide usw., Backwaren",341452000,201845000,543297000
2010,6,WA20,"Zubereitungen von Gemüse, Früchten usw.",168003000,293374000,461377000
2010,6,WA21,Verschiedene Lebensmittelzubereitungen,343460000,235126000,578586000
2010,6,WA22,"Getränke, alkoholhaltige Flüssigkeiten, Essig",403836000,466434000,870270000
2010,6,WA23,"Rückstände der Lebensmittelindustrie, Futter",211413000,222940000,434353000
2010,6,WA24,Tabak,321643000,136109000,457752000
2010,6,WA25,"Salz, Schwefel, Steine, Erden usw.",199704000,150983000,350687000
2010,6,WA26,"Erze, Schlacken, Aschen",29720000,745111000,774831000
2010,6,WA27,Mineralische Brennstoffe usw.,1597705000,8129127000,9726832000
2010,6,WA28,Anorganische chemische Erzeugnisse,649258000,506340000,1155598000
2010,6,WA29,Organische chemische Erzeugnisse,1877240000,1849811000,3727051000
2010,6,WA30,Pharmazeutische Erzeugnisse,4102135000,2825632000,6927767000
2010,6,WA31,Düngemittel,181068000,60971000,242039000
2010,6,WA32,"Gerb- und Farbstoffe, Farben, Lacke usw.",798506000,365736000,1164242000
2010,6,WA33,"Etherische Öle, Riech-, Schönheitsmittel",622213000,363531000,985744000
2010,6,WA34,"Seifen, Waschmittel usw.",450649000,229217000,679866000
2010,6,WA35,"Eiweißstoffe, Klebstoffe, Enzyme",206976000,137317000,344293000
2010,6,WA36,"Sprengstoffe, pyrotechnische Artikel usw.",16934000,18413000,35347000
2010,6,WA37,Photochemische Erzeugnisse,85932000,71874000,157806000
2010,6,WA38,Verschiedene Erzeugnisse der Chemischen Industrie,1432294000,929118000,2361412000
2010,6,WA39,Kunststoffe und Waren daraus,4195013000,2472518000,6667531000
2010,6,WA40,Kautschuk und Waren daraus,1055223000,972224000,2027447000
2010,6,WA41,"Häute, Felle, Leder",76909000,69144000,146053000
2010,6,WA42,"Lederwaren, Sattlerwaren",112478000,226855000,339333000
2010,6,WA43,"Pelzfelle, künstliches Pelzwerk",11062000,16219000,27281000
2010,6,WA44,"Holz, Holzwaren, Holzkohle",599608000,520721000,1120329000
2010,6,WA45,"Kork, Korkwaren",2879000,6848000,9727000
2010,6,WA46,"Flechtwaren, Korbmacherwaren",3565000,10415000,13980000
2010,6,WA47,"Halbstoffe aus Holz usw., Papierabfall",107920000,379925000,487845000
2010,6,WA48,"Papier, Pappe und Waren daraus",1596528000,981114000,2577642000
2010,6,WA49,"Bücher, Zeitungen, Bilddrucke usw.",319580000,165665000,485245000
2010,6,WA50,Seide,5654000,6403000,12057000
2010,6,WA51,"Wolle, feine und grobe Tierhaare",65494000,68330000,133824000
2010,6,WA52,Baumwolle,87723000,79816000,167539000
2010,6,WA53,"Andere pflanzliche Spinnstoffe, Papiergarn",2569000,4828000,7397000
2010,6,WA54,Synthetisches oder künstliches Filament,169819000,113445000,283264000
2010,6,WA55,Synthetische oder künstliche Spinnfaser,167514000,114633000,282147000
2010,6,WA56,"Watte, Filz, Vliesstoff usw., Tauwerk",172544000,93690000,266234000
2010,6,WA57,"Teppiche, Fußbodenbelag aus Spinnstoff",43806000,81472000,125278000
2010,6,WA58,"Spezialgewebe, Spitzen, Tapisserien",44944000,28502000,73446000
2010,6,WA59,"Getränkte, bestrichene usw. Gewebe",161695000,77645000,239340000
2010,6,WA60,Gewirke und Gestricke,75487000,41276000,116763000
2010,6,WA61,"Bekleidung usw. aus Gewirken, Gestricken",412712000,957988000,1370700000
2010,6,WA62,"Andere Bekleidung, Bekleidungszubehör",429444000,946491000,1375935000
2010,6,WA63,"Andere Konfektion, Spinnstoffwaren usw.",157736000,256756000,414492000
2010,6,WA64,"Schuhe, Gamaschen, ähnliche Waren",208806000,465400000,674206000
2010,6,WA65,Kopfbedeckungen und Teile davon,19639000,32367000,52006000
2010,6,WA66,"Schirme, Gehstöcke usw., Peitschen",7154000,13239000,20393000
2010,6,WA67,"Zugerichtete Federn, Daunen, künstliche Blumen",4281000,12978000,17259000
2010,6,WA68,"Waren aus Steinen, Gips, Zement usw.",310625000,210382000,521007000
2010,6,WA69,Keramische Waren,242219000,176759000,418978000
2010,6,WA70,Glas und Glaswaren,447051000,335647000,782698000
2010,6,WA71,"Perlen, Edelsteine, Edelmetalle",1044358000,1455576000,2499934000
2010,6,WA72,Eisen und Stahl,2167254000,2133440000,4300694000
2010,6,WA73,Waren aus Eisen oder Stahl,2057529000,1247167000,3304696000
2010,6,WA74,Kupfer und Waren daraus,934765000,794745000,1729510000
2010,6,WA75,Nickel und Waren daraus,75056000,164456000,239512000
2010,6,WA76,Aluminium und Waren daraus,998978000,1073787000,2072765000
2010,6,WA78,Blei und Waren daraus,34674000,23436000,58110000
2010,6,WA79,Zink und Waren daraus,54744000,90216000,144960000
2010,6,WA80,Zinn und Waren daraus,8036000,34851000,42887000
2010,6,WA81,"Andere unedle Metalle, Cermets usw.",91018000,105918000,196936000
2010,6,WA82,"Werkzeuge, Schneidwaren, Essbestecke",510394000,298851000,809245000
2010,6,WA83,Verschiedene Waren aus unedlen Metallen,551166000,318630000,869796000
2010,6,WA84,"Maschinen, Apparate, mechanische Geräte",15074294000,8989833000,24064127000
2010,6,WA85,Elektrotechnische Erzeugnisse,8795243000,8772371000,17567614000
2010,6,WA86,Schienenfahrzeuge,418389000,187086000,605475000
2010,6,WA87,"Kraftfahrzeuge, Landfahrzeuge",14214881000,5483846000,19698727000
2010,6,WA88,"Luftfahrzeuge, Raumfahrzeuge",2556320000,2116078000,4672398000
2010,6,WA89,Wasserfahrzeuge,102443000,1181454000,1283897000
2010,6,WA90,"Optische, photografische usw. Erzeugnisse",3758501000,2023797000,5782298000
2010,6,WA91,Uhrmacherwaren,94028000,126349000,220377000
2010,6,WA92,Musikinstrumente,45059000,37192000,82251000
2010,6,WA93,Waffen und Munition,41909000,13394000,55303000
2010,6,WA94,"Möbel, Beleuchtungskörper usw.",1032213000,1063728000,2095941000
2010,6,WA95,"Spielzeug, Spiele usw., Sportgeräte",289364000,376264000,665628000
2010,6,WA96,Verschiedene Waren,169507000,116771000,286278000
2010,6,WA97,"Kunstgegenstände, Sammlungsstücke",134984000,34006000,168990000
2010,6,WA98,Vollständige Fabrikationsanlagen,320491000,169569000,490060000
2010,6,WA99,Zusammenstellungen verschiedener Waren,1564136000,1003323000,2567459000
2010,7,WA01,Lebende Tiere,90789000,126149000,216938000
2010,7,WA02,Fleisch,510785000,367890000,878675000
2010,7,WA03,"Fische, Krebs- und Weichtiere",76311000,195747000,272058000
2010,7,WA04,"Milch, Milcherzeugnisse, Eier, Honig",598160000,465442000,1063602000
2010,7,WA05,Andere Waren tierischen Ursprungs,48649000,58373000,107022000
2010,7,WA06,"Pflanzen, Waren des Blumenhandels",38548000,168948000,207496000
2010,7,WA07,"Gemüse, Pflanzen für Ernährung",69998000,355900000,425898000
2010,7,WA08,Genießbare Früchte und Nüsse,115118000,581813000,696931000
2010,7,WA09,"Kaffee, Tee, Mate, Gewürze",147299000,280891000,428190000
2010,7,WA10,Getreide,139886000,116218000,256104000
2010,7,WA11,"Müllereierzeugnisse, Malz usw.",79243000,30649000,109892000
2010,7,WA12,"Ölsamen usw., Heilpflanzen usw.",72335000,251329000,323664000
2010,7,WA13,"Schellack, Gummen, Harz, Pflanzensaft",40837000,31895000,72732000
2010,7,WA14,Flechtstoffe usw. pflanzlichen Ursprungs,673000,2542000,3215000
2010,7,WA15,"Tierische und pflanzliche Fette, Öle, Wachs",139557000,208298000,347855000
2010,7,WA16,"Zubereitungen von Fleisch, Fisch usw.",194583000,159251000,353834000
2010,7,WA17,Zucker und Zuckerwaren,122764000,116345000,239109000
2010,7,WA18,Kakao und Zubereitungen aus Kakao,232394000,256041000,488435000
2010,7,WA19,"Zubereitungen aus Getreide usw., Backwaren",341204000,207035000,548239000
2010,7,WA20,"Zubereitungen von Gemüse, Früchten usw.",156764000,308008000,464772000
2010,7,WA21,Verschiedene Lebensmittelzubereitungen,340418000,247534000,587952000
2010,7,WA22,"Getränke, alkoholhaltige Flüssigkeiten, Essig",435673000,513930000,949603000
2010,7,WA23,"Rückstände der Lebensmittelindustrie, Futter",202244000,213922000,416166000
2010,7,WA24,Tabak,314497000,137899000,452396000
2010,7,WA25,"Salz, Schwefel, Steine, Erden usw.",177357000,174161000,351518000
2010,7,WA26,"Erze, Schlacken, Aschen",29775000,876020000,905795000
2010,7,WA27,Mineralische Brennstoffe usw.,1572395000,7562635000,9135030000
2010,7,WA28,Anorganische chemische Erzeugnisse,651524000,567760000,1219284000
2010,7,WA29,Organische chemische Erzeugnisse,1956532000,1731859000,3688391000
2010,7,WA30,Pharmazeutische Erzeugnisse,4093623000,2899870000,6993493000
2010,7,WA31,Düngemittel,169773000,85394000,255167000
2010,7,WA32,"Gerb- und Farbstoffe, Farben, Lacke usw.",760376000,388438000,1148814000
2010,7,WA33,"Etherische Öle, Riech-, Schönheitsmittel",604273000,367775000,972048000
2010,7,WA34,"Seifen, Waschmittel usw.",457094000,225858000,682952000
2010,7,WA35,"Eiweißstoffe, Klebstoffe, Enzyme",204693000,134423000,339116000
2010,7,WA36,"Sprengstoffe, pyrotechnische Artikel usw.",14584000,17512000,32096000
2010,7,WA37,Photochemische Erzeugnisse,84670000,60131000,144801000
2010,7,WA38,Verschiedene Erzeugnisse der Chemischen Industrie,1325674000,898528000,2224202000
2010,7,WA39,Kunststoffe und Waren daraus,4000279000,2475708000,6475987000
2010,7,WA40,Kautschuk und Waren daraus,975816000,958059000,1933875000
2010,7,WA41,"Häute, Felle, Leder",63462000,67152000,130614000
2010,7,WA42,"Lederwaren, Sattlerwaren",119109000,246169000,365278000
2010,7,WA43,"Pelzfelle, künstliches Pelzwerk",16395000,16135000,32530000
2010,7,WA44,"Holz, Holzwaren, Holzkohle",577977000,499886000,1077863000
2010,7,WA45,"Kork, Korkwaren",2668000,11597000,14265000
2010,7,WA46,"Flechtwaren, Korbmacherwaren",3595000,12576000,16171000
2010,7,WA47,"Halbstoffe aus Holz usw., Papierabfall",96585000,350602000,447187000
2010,7,WA48,"Papier, Pappe und Waren daraus",1551532000,977906000,2529438000
2010,7,WA49,"Bücher, Zeitungen, Bilddrucke usw.",346695000,165185000,511880000
2010,7,WA50,Seide,5694000,5622000,11316000
2010,7,WA51,"Wolle, feine und grobe Tierhaare",58494000,64772000,123266000
2010,7,WA52,Baumwolle,73296000,70275000,143571000
2010,7,WA53,"Andere pflanzliche Spinnstoffe, Papiergarn",2301000,4855000,7156000
2010,7,WA54,Synthetisches oder künstliches Filament,151529000,123031000,274560000
2010,7,WA55,Synthetische oder künstliche Spinnfaser,158490000,126460000,284950000
2010,7,WA56,"Watte, Filz, Vliesstoff usw., Tauwerk",170834000,103139000,273973000
2010,7,WA57,"Teppiche, Fußbodenbelag aus Spinnstoff",38638000,76162000,114800000
2010,7,WA58,"Spezialgewebe, Spitzen, Tapisserien",40108000,26927000,67035000
2010,7,WA59,"Getränkte, bestrichene usw. Gewebe",152055000,79596000,231651000
2010,7,WA60,Gewirke und Gestricke,69404000,34702000,104106000
2010,7,WA61,"Bekleidung usw. aus Gewirken, Gestricken",513817000,1147967000,1661784000
2010,7,WA62,"Andere Bekleidung, Bekleidungszubehör",551865000,1131134000,1682999000
2010,7,WA63,"Andere Konfektion, Spinnstoffwaren usw.",141433000,243853000,385286000
2010,7,WA64,"Schuhe, Gamaschen, ähnliche Waren",276860000,614602000,891462000
2010,7,WA65,Kopfbedeckungen und Teile davon,20002000,39283000,59285000
2010,7,WA66,"Schirme, Gehstöcke usw., Peitschen",5595000,9769000,15364000
2010,7,WA67,"Zugerichtete Federn, Daunen, künstliche Blumen",5507000,16291000,21798000
2010,7,WA68,"Waren aus Steinen, Gips, Zement usw.",292386000,204625000,497011000
2010,7,WA69,Keramische Waren,235373000,177533000,412906000
2010,7,WA70,Glas und Glaswaren,414965000,332749000,747714000
2010,7,WA71,"Perlen, Edelsteine, Edelmetalle",978751000,1015406000,1994157000
2010,7,WA72,Eisen und Stahl,1866094000,2087619000,3953713000
2010,7,WA73,Waren aus Eisen oder Stahl,1868381000,1286874000,3155255000
2010,7,WA74,Kupfer und Waren daraus,894059000,792427000,1686486000
2010,7,WA75,Nickel und Waren daraus,64527000,150055000,214582000
2010,7,WA76,Aluminium und Waren daraus,887979000,1048086000,1936065000
2010,7,WA78,Blei und Waren daraus,33784000,16906000,50690000
2010,7,WA79,Zink und Waren daraus,52207000,97289000,149496000
2010,7,WA80,Zinn und Waren daraus,9122000,27163000,36285000
2010,7,WA81,"Andere unedle Metalle, Cermets usw.",86421000,107403000,193824000
2010,7,WA82,"Werkzeuge, Schneidwaren, Essbestecke",469941000,307652000,777593000
2010,7,WA83,Verschiedene Waren aus unedlen Metallen,511749000,307596000,819345000
2010,7,WA84,"Maschinen, Apparate, mechanische Geräte",14841239000,8226002000,23067241000
2010,7,WA85,Elektrotechnische Erzeugnisse,8407300000,7870381000,16277681000
2010,7,WA86,Schienenfahrzeuge,306141000,152989000,459130000
2010,7,WA87,"Kraftfahrzeuge, Landfahrzeuge",12800205000,4981627000,17781832000
2010,7,WA88,"Luftfahrzeuge, Raumfahrzeuge",2152376000,2931604000,5083980000
2010,7,WA89,Wasserfahrzeuge,575071000,684115000,1259186000
2010,7,WA90,"Optische, photografische usw. Erzeugnisse",3606559000,1963241000,5569800000
2010,7,WA91,Uhrmacherwaren,142055000,142002000,284057000
2010,7,WA92,Musikinstrumente,36689000,47836000,84525000
2010,7,WA93,Waffen und Munition,32706000,14983000,47689000
2010,7,WA94,"Möbel, Beleuchtungskörper usw.",977026000,948784000,1925810000
2010,7,WA95,"Spielzeug, Spiele usw., Sportgeräte",321089000,362097000,683186000
2010,7,WA96,Verschiedene Waren,168481000,115028000,283509000
2010,7,WA97,"Kunstgegenstände, Sammlungsstücke",41969000,34342000,76311000
2010,7,WA98,Vollständige Fabrikationsanlagen,390179000,2185000,392364000
2010,7,WA99,Zusammenstellungen verschiedener Waren,1084376000,855222000,1939598000
2010,8,WA01,Lebende Tiere,87588000,130809000,218397000
2010,8,WA02,Fleisch,529665000,414411000,944076000
2010,8,WA03,"Fische, Krebs- und Weichtiere",73669000,223151000,296820000
2010,8,WA04,"Milch, Milcherzeugnisse, Eier, Honig",600648000,480723000,1081371000
2010,8,WA05,Andere Waren tierischen Ursprungs,44985000,53590000,98575000
2010,8,WA06,"Pflanzen, Waren des Blumenhandels",39479000,175283000,214762000
2010,8,WA07,"Gemüse, Pflanzen für Ernährung",74685000,325404000,400089000
2010,8,WA08,Genießbare Früchte und Nüsse,96378000,561992000,658370000
2010,8,WA09,"Kaffee, Tee, Mate, Gewürze",156985000,274517000,431502000
2010,8,WA10,Getreide,112613000,161390000,274003000
2010,8,WA11,"Müllereierzeugnisse, Malz usw.",63850000,33206000,97056000
2010,8,WA12,"Ölsamen usw., Heilpflanzen usw.",77083000,282264000,359347000
2010,8,WA13,"Schellack, Gummen, Harz, Pflanzensaft",31588000,32637000,64225000
2010,8,WA14,Flechtstoffe usw. pflanzlichen Ursprungs,790000,1893000,2683000
2010,8,WA15,"Tierische und pflanzliche Fette, Öle, Wachs",163730000,288921000,452651000
2010,8,WA16,"Zubereitungen von Fleisch, Fisch usw.",185143000,156137000,341280000
2010,8,WA17,Zucker und Zuckerwaren,115877000,103551000,219428000
2010,8,WA18,Kakao und Zubereitungen aus Kakao,295095000,257743000,552838000
2010,8,WA19,"Zubereitungen aus Getreide usw., Backwaren",363104000,189516000,552620000
2010,8,WA20,"Zubereitungen von Gemüse, Früchten usw.",168895000,305092000,473987000
2010,8,WA21,Verschiedene Lebensmittelzubereitungen,302411000,203348000,505759000
2010,8,WA22,"Getränke, alkoholhaltige Flüssigkeiten, Essig",421959000,450900000,872859000
2010,8,WA23,"Rückstände der Lebensmittelindustrie, Futter",215564000,200248000,415812000
2010,8,WA24,Tabak,303691000,131182000,434873000
2010,8,WA25,"Salz, Schwefel, Steine, Erden usw.",149478000,167065000,316543000
2010,8,WA26,"Erze, Schlacken, Aschen",24364000,677444000,701808000
2010,8,WA27,Mineralische Brennstoffe usw.,1514603000,8155029000,9669632000
2010,8,WA28,Anorganische chemische Erzeugnisse,685493000,532646000,1218139000
2010,8,WA29,Organische chemische Erzeugnisse,1705636000,1736972000,3442608000
2010,8,WA30,Pharmazeutische Erzeugnisse,4139236000,2770542000,6909778000
2010,8,WA31,Düngemittel,160227000,105371000,265598000
2010,8,WA32,"Gerb- und Farbstoffe, Farben, Lacke usw.",698618000,354970000,1053588000
2010,8,WA33,"Etherische Öle, Riech-, Schönheitsmittel",608321000,391216000,999537000
2010,8,WA34,"Seifen, Waschmittel usw.",427274000,227058000,654332000
2010,8,WA35,"Eiweißstoffe, Klebstoffe, Enzyme",179417000,135776000,315193000
2010,8,WA36,"Sprengstoffe, pyrotechnische Artikel usw.",13600000,20288000,33888000
2010,8,WA37,Photochemische Erzeugnisse,101354000,56094000,157448000
2010,8,WA38,Verschiedene Erzeugnisse der Chemischen Industrie,1301233000,808984000,2110217000
2010,8,WA39,Kunststoffe und Waren daraus,3699063000,2330354000,6029417000
2010,8,WA40,Kautschuk und Waren daraus,930904000,943116000,1874020000
2010,8,WA41,"Häute, Felle, Leder",69072000,55534000,124606000
2010,8,WA42,"Lederwaren, Sattlerwaren",129177000,246811000,375988000
2010,8,WA43,"Pelzfelle, künstliches Pelzwerk",14565000,14665000,29230000
2010,8,WA44,"Holz, Holzwaren, Holzkohle",522954000,462376000,985330000
2010,8,WA45,"Kork, Korkwaren",2402000,7160000,9562000
2010,8,WA46,"Flechtwaren, Korbmacherwaren",3298000,11063000,14361000
2010,8,WA47,"Halbstoffe aus Holz usw., Papierabfall",86794000,377932000,464726000
2010,8,WA48,"Papier, Pappe und Waren daraus",1551783000,935311000,2487094000
2010,8,WA49,"Bücher, Zeitungen, Bilddrucke usw.",401289000,152272000,553561000
2010,8,WA50,Seide,3016000,4015000,7031000
2010,8,WA51,"Wolle, feine und grobe Tierhaare",31701000,48819000,80520000
2010,8,WA52,Baumwolle,58011000,64312000,122323000
2010,8,WA53,"Andere pflanzliche Spinnstoffe, Papiergarn",2284000,5113000,7397000
2010,8,WA54,Synthetisches oder künstliches Filament,137832000,100268000,238100000
2010,8,WA55,Synthetische oder künstliche Spinnfaser,124522000,99073000,223595000
2010,8,WA56,"Watte, Filz, Vliesstoff usw., Tauwerk",148133000,76998000,225131000
2010,8,WA57,"Teppiche, Fußbodenbelag aus Spinnstoff",36178000,69285000,105463000
2010,8,WA58,"Spezialgewebe, Spitzen, Tapisserien",33469000,21122000,54591000
2010,8,WA59,"Getränkte, bestrichene usw. Gewebe",131736000,79330000,211066000
2010,8,WA60,Gewirke und Gestricke,51576000,27975000,79551000
2010,8,WA61,"Bekleidung usw. aus Gewirken, Gestricken",622693000,1303043000,1925736000
2010,8,WA62,"Andere Bekleidung, Bekleidungszubehör",725945000,1308077000,2034022000
2010,8,WA63,"Andere Konfektion, Spinnstoffwaren usw.",141144000,233152000,374296000
2010,8,WA64,"Schuhe, Gamaschen, ähnliche Waren",309349000,610075000,919424000
2010,8,WA65,Kopfbedeckungen und Teile davon,25757000,43892000,69649000
2010,8,WA66,"Schirme, Gehstöcke usw., Peitschen",5608000,11827000,17435000
2010,8,WA67,"Zugerichtete Federn, Daunen, künstliche Blumen",6547000,17149000,23696000
2010,8,WA68,"Waren aus Steinen, Gips, Zement usw.",262388000,177014000,439402000
2010,8,WA69,Keramische Waren,215785000,177871000,393656000
2010,8,WA70,Glas und Glaswaren,381579000,307121000,688700000
2010,8,WA71,"Perlen, Edelsteine, Edelmetalle",927738000,1029435000,1957173000
2010,8,WA72,Eisen und Stahl,1695133000,1730143000,3425276000
2010,8,WA73,Waren aus Eisen oder Stahl,1699451000,1166638000,2866089000
2010,8,WA74,Kupfer und Waren daraus,861121000,783188000,1644309000
2010,8,WA75,Nickel und Waren daraus,71959000,156419000,228378000
2010,8,WA76,Aluminium und Waren daraus,831366000,978070000,1809436000
2010,8,WA78,Blei und Waren daraus,35595000,21568000,57163000
2010,8,WA79,Zink und Waren daraus,46517000,101210000,147727000
2010,8,WA80,Zinn und Waren daraus,6736000,26207000,32943000
2010,8,WA81,"Andere unedle Metalle, Cermets usw.",85264000,93528000,178792000
2010,8,WA82,"Werkzeuge, Schneidwaren, Essbestecke",442515000,280070000,722585000
2010,8,WA83,Verschiedene Waren aus unedlen Metallen,481220000,288661000,769881000
2010,8,WA84,"Maschinen, Apparate, mechanische Geräte",13315151000,7853829000,21168980000
2010,8,WA85,Elektrotechnische Erzeugnisse,8255927000,7654853000,15910780000
2010,8,WA86,Schienenfahrzeuge,269486000,144825000,414311000
2010,8,WA87,"Kraftfahrzeuge, Landfahrzeuge",9885603000,4075247000,13960850000
2010,8,WA88,"Luftfahrzeuge, Raumfahrzeuge",1675000000,1345640000,3020640000
2010,8,WA89,Wasserfahrzeuge,407361000,1007726000,1415087000
2010,8,WA90,"Optische, photografische usw. Erzeugnisse",3449689000,1828999000,5278688000
2010,8,WA91,Uhrmacherwaren,77871000,119759000,197630000
2010,8,WA92,Musikinstrumente,33421000,43800000,77221000
2010,8,WA93,Waffen und Munition,27087000,12403000,39490000
2010,8,WA94,"Möbel, Beleuchtungskörper usw.",851589000,944242000,1795831000
2010,8,WA95,"Spielzeug, Spiele usw., Sportgeräte",326808000,386771000,713579000
2010,8,WA96,Verschiedene Waren,141828000,105940000,247768000
2010,8,WA97,"Kunstgegenstände, Sammlungsstücke",43716000,18724000,62440000
2010,8,WA98,Vollständige Fabrikationsanlagen,334487000,3369000,337856000
2010,8,WA99,Zusammenstellungen verschiedener Waren,1012990000,837157000,1850147000
2010,9,WA01,Lebende Tiere,95038000,107257000,202295000
2010,9,WA02,Fleisch,568861000,443429000,1012290000
2010,9,WA03,"Fische, Krebs- und Weichtiere",103992000,246820000,350812000
2010,9,WA04,"Milch, Milcherzeugnisse, Eier, Honig",626966000,485276000,1112242000
2010,9,WA05,Andere Waren tierischen Ursprungs,48840000,52696000,101536000
2010,9,WA06,"Pflanzen, Waren des Blumenhandels",62382000,185643000,248025000
2010,9,WA07,"Gemüse, Pflanzen für Ernährung",75170000,317322000,392492000
2010,9,WA08,Genießbare Früchte und Nüsse,102977000,534135000,637112000
2010,9,WA09,"Kaffee, Tee, Mate, Gewürze",175782000,313631000,489413000
2010,9,WA10,Getreide,237188000,180770000,417958000
2010,9,WA11,"Müllereierzeugnisse, Malz usw.",79403000,34397000,113800000
2010,9,WA12,"Ölsamen usw., Heilpflanzen usw.",50022000,280308000,330330000
2010,9,WA13,"Schellack, Gummen, Harz, Pflanzensaft",33822000,33392000,67214000
2010,9,WA14,Flechtstoffe usw. pflanzlichen Ursprungs,674000,1907000,2581000
2010,9,WA15,"Tierische und pflanzliche Fette, Öle, Wachs",172065000,257514000,429579000
2010,9,WA16,"Zubereitungen von Fleisch, Fisch usw.",178521000,158928000,337449000
2010,9,WA17,Zucker und Zuckerwaren,115939000,107272000,223211000
2010,9,WA18,Kakao und Zubereitungen aus Kakao,335644000,287672000,623316000
2010,9,WA19,"Zubereitungen aus Getreide usw., Backwaren",374949000,197445000,572394000
2010,9,WA20,"Zubereitungen von Gemüse, Früchten usw.",147701000,287302000,435003000
2010,9,WA21,Verschiedene Lebensmittelzubereitungen,303883000,166192000,470075000
2010,9,WA22,"Getränke, alkoholhaltige Flüssigkeiten, Essig",349967000,499908000,849875000
2010,9,WA23,"Rückstände der Lebensmittelindustrie, Futter",236396000,250772000,487168000
2010,9,WA24,Tabak,288367000,138198000,426565000
2010,9,WA25,"Salz, Schwefel, Steine, Erden usw.",184082000,164989000,349071000
2010,9,WA26,"Erze, Schlacken, Aschen",28283000,548384000,576667000
2010,9,WA27,Mineralische Brennstoffe usw.,1589227000,7208318000,8797545000
2010,9,WA28,Anorganische chemische Erzeugnisse,640977000,514050000,1155027000
2010,9,WA29,Organische chemische Erzeugnisse,1813294000,1830859000,3644153000
2010,9,WA30,Pharmazeutische Erzeugnisse,4122509000,2281836000,6404345000
2010,9,WA31,Düngemittel,178800000,129502000,308302000
2010,9,WA32,"Gerb- und Farbstoffe, Farben, Lacke usw.",770771000,389727000,1160498000
2010,9,WA33,"Etherische Öle, Riech-, Schönheitsmittel",667510000,417848000,1085358000
2010,9,WA34,"Seifen, Waschmittel usw.",466859000,247814000,714673000
2010,9,WA35,"Eiweißstoffe, Klebstoffe, Enzyme",200607000,133451000,334058000
2010,9,WA36,"Sprengstoffe, pyrotechnische Artikel usw.",15011000,22249000,37260000
2010,9,WA37,Photochemische Erzeugnisse,97242000,65186000,162428000
2010,9,WA38,Verschiedene Erzeugnisse der Chemischen Industrie,1318927000,891869000,2210796000
2010,9,WA39,Kunststoffe und Waren daraus,4071708000,2436481000,6508189000
2010,9,WA40,Kautschuk und Waren daraus,1072495000,1003089000,2075584000
2010,9,WA41,"Häute, Felle, Leder",77733000,59677000,137410000
2010,9,WA42,"Lederwaren, Sattlerwaren",129039000,243236000,372275000
2010,9,WA43,"Pelzfelle, künstliches Pelzwerk",17201000,14711000,31912000
2010,9,WA44,"Holz, Holzwaren, Holzkohle",604400000,484127000,1088527000
2010,9,WA45,"Kork, Korkwaren",2281000,7473000,9754000
2010,9,WA46,"Flechtwaren, Korbmacherwaren",3354000,10558000,13912000
2010,9,WA47,"Halbstoffe aus Holz usw., Papierabfall",99926000,337807000,437733000
2010,9,WA48,"Papier, Pappe und Waren daraus",1604665000,1022088000,2626753000
2010,9,WA49,"Bücher, Zeitungen, Bilddrucke usw.",448472000,195479000,643951000
2010,9,WA50,Seide,4820000,5090000,9910000
2010,9,WA51,"Wolle, feine und grobe Tierhaare",53511000,58505000,112016000
2010,9,WA52,Baumwolle,87605000,83656000,171261000
2010,9,WA53,"Andere pflanzliche Spinnstoffe, Papiergarn",3109000,4847000,7956000
2010,9,WA54,Synthetisches oder künstliches Filament,160601000,114326000,274927000
2010,9,WA55,Synthetische oder künstliche Spinnfaser,163911000,123700000,287611000
2010,9,WA56,"Watte, Filz, Vliesstoff usw., Tauwerk",174979000,89093000,264072000
2010,9,WA57,"Teppiche, Fußbodenbelag aus Spinnstoff",45953000,83647000,129600000
2010,9,WA58,"Spezialgewebe, Spitzen, Tapisserien",39004000,27066000,66070000
2010,9,WA59,"Getränkte, bestrichene usw. Gewebe",161089000,82861000,243950000
2010,9,WA60,Gewirke und Gestricke,63659000,34561000,98220000
2010,9,WA61,"Bekleidung usw. aus Gewirken, Gestricken",642222000,1244710000,1886932000
2010,9,WA62,"Andere Bekleidung, Bekleidungszubehör",738606000,1242200000,1980806000
2010,9,WA63,"Andere Konfektion, Spinnstoffwaren usw.",167443000,250694000,418137000
2010,9,WA64,"Schuhe, Gamaschen, ähnliche Waren",313717000,615832000,929549000
2010,9,WA65,Kopfbedeckungen und Teile davon,30082000,46274000,76356000
2010,9,WA66,"Schirme, Gehstöcke usw., Peitschen",6278000,8891000,15169000
2010,9,WA67,"Zugerichtete Federn, Daunen, künstliche Blumen",7551000,14956000,22507000
2010,9,WA68,"Waren aus Steinen, Gips, Zement usw.",301492000,205134000,506626000
2010,9,WA69,Keramische Waren,243305000,187253000,430558000
2010,9,WA70,Glas und Glaswaren,431846000,339845000,771691000
2010,9,WA71,"Perlen, Edelsteine, Edelmetalle",1046413000,1070091000,2116504000
2010,9,WA72,Eisen und Stahl,1998231000,2057164000,4055395000
2010,9,WA73,Waren aus Eisen oder Stahl,1963963000,1292342000,3256305000
2010,9,WA74,Kupfer und Waren daraus,916465000,826596000,1743061000
2010,9,WA75,Nickel und Waren daraus,71961000,123119000,195080000
2010,9,WA76,Aluminium und Waren daraus,928163000,1051885000,1980048000
2010,9,WA78,Blei und Waren daraus,43011000,27602000,70613000
2010,9,WA79,Zink und Waren daraus,55295000,95596000,150891000
2010,9,WA80,Zinn und Waren daraus,9314000,36931000,46245000
2010,9,WA81,"Andere unedle Metalle, Cermets usw.",88477000,93416000,181893000
2010,9,WA82,"Werkzeuge, Schneidwaren, Essbestecke",501893000,300187000,802080000
2010,9,WA83,Verschiedene Waren aus unedlen Metallen,543108000,319675000,862783000
2010,9,WA84,"Maschinen, Apparate, mechanische Geräte",15132086000,9374880000,24506966000
2010,9,WA85,Elektrotechnische Erzeugnisse,9207560000,8949588000,18157148000
2010,9,WA86,Schienenfahrzeuge,315785000,133299000,449084000
2010,9,WA87,"Kraftfahrzeuge, Landfahrzeuge",14745437000,5557878000,20303315000
2010,9,WA88,"Luftfahrzeuge, Raumfahrzeuge",1899914000,1570253000,3470167000
2010,9,WA89,Wasserfahrzeuge,593965000,473175000,1067140000
2010,9,WA90,"Optische, photografische usw. Erzeugnisse",3839151000,2085124000,5924275000
2010,9,WA91,Uhrmacherwaren,126010000,138896000,264906000
2010,9,WA92,Musikinstrumente,46313000,47813000,94126000
2010,9,WA93,Waffen und Munition,33898000,13666000,47564000
2010,9,WA94,"Möbel, Beleuchtungskörper usw.",1036914000,1108704000,2145618000
2010,9,WA95,"Spielzeug, Spiele usw., Sportgeräte",409204000,608270000,1017474000
2010,9,WA96,Verschiedene Waren,161125000,113979000,275104000
2010,9,WA97,"Kunstgegenstände, Sammlungsstücke",46075000,22663000,68738000
2010,9,WA98,Vollständige Fabrikationsanlagen,329312000,1922000,331234000
2010,9,WA99,Zusammenstellungen verschiedener Waren,1051941000,912007000,1963948000
2010,10,WA01,Lebende Tiere,94754000,132209000,226963000
2010,10,WA02,Fleisch,648167000,446317000,1094484000
2010,10,WA03,"Fische, Krebs- und Weichtiere",102884000,276021000,378905000
2010,10,WA04,"Milch, Milcherzeugnisse, Eier, Honig",615986000,515001000,1130987000
2010,10,WA05,Andere Waren tierischen Ursprungs,54453000,60535000,114988000
2010,10,WA06,"Pflanzen, Waren des Blumenhandels",60533000,194074000,254607000
2010,10,WA07,"Gemüse, Pflanzen für Ernährung",77163000,291162000,368325000
2010,10,WA08,Genießbare Früchte und Nüsse,100705000,509151000,609856000
2010,10,WA09,"Kaffee, Tee, Mate, Gewürze",170989000,304464000,475453000
2010,10,WA10,Getreide,238021000,215880000,453901000
2010,10,WA11,"Müllereierzeugnisse, Malz usw.",82597000,37524000,120121000
2010,10,WA12,"Ölsamen usw., Heilpflanzen usw.",50071000,305844000,355915000
2010,10,WA13,"Schellack, Gummen, Harz, Pflanzensaft",37257000,30896000,68153000
2010,10,WA14,Flechtstoffe usw. pflanzlichen Ursprungs,862000,2654000,3516000
2010,10,WA15,"Tierische und pflanzliche Fette, Öle, Wachs",183525000,296433000,479958000
2010,10,WA16,"Zubereitungen von Fleisch, Fisch usw.",198546000,176982000,375528000
2010,10,WA17,Zucker und Zuckerwaren,124822000,109543000,234365000
2010,10,WA18,Kakao und Zubereitungen aus Kakao,356364000,301760000,658124000
2010,10,WA19,"Zubereitungen aus Getreide usw., Backwaren",393028000,217942000,610970000
2010,10,WA20,"Zubereitungen von Gemüse, Früchten usw.",163631000,330405000,494036000
2010,10,WA21,Verschiedene Lebensmittelzubereitungen,304718000,166010000,470728000
2010,10,WA22,"Getränke, alkoholhaltige Flüssigkeiten, Essig",391958000,502714000,894672000
2010,10,WA23,"Rückstände der Lebensmittelindustrie, Futter",252688000,253021000,505709000
2010,10,WA24,Tabak,291051000,127868000,418919000
2010,10,WA25,"Salz, Schwefel, Steine, Erden usw.",186683000,159189000,345872000
2010,10,WA26,"Erze, Schlacken, Aschen",35480000,664823000,700303000
2010,10,WA27,Mineralische Brennstoffe usw.,1809678000,8272996000,10082674000
2010,10,WA28,Anorganische chemische Erzeugnisse,647630000,721010000,1368640000
2010,10,WA29,Organische chemische Erzeugnisse,1777410000,1845529000,3622939000
2010,10,WA30,Pharmazeutische Erzeugnisse,4047763000,2856564000,6904327000
2010,10,WA31,Düngemittel,172666000,117392000,290058000
2010,10,WA32,"Gerb- und Farbstoffe, Farben, Lacke usw.",750975000,416713000,1167688000
2010,10,WA33,"Etherische Öle, Riech-, Schönheitsmittel",650789000,379740000,1030529000
2010,10,WA34,"Seifen, Waschmittel usw.",447272000,245368000,692640000
2010,10,WA35,"Eiweißstoffe, Klebstoffe, Enzyme",197296000,137450000,334746000
2010,10,WA36,"Sprengstoffe, pyrotechnische Artikel usw.",16426000,25629000,42055000
2010,10,WA37,Photochemische Erzeugnisse,88319000,62361000,150680000
2010,10,WA38,Verschiedene Erzeugnisse der Chemischen Industrie,1308824000,796926000,2105750000
2010,10,WA39,Kunststoffe und Waren daraus,4057113000,2464793000,6521906000
2010,10,WA40,Kautschuk und Waren daraus,1111280000,1030970000,2142250000
2010,10,WA41,"Häute, Felle, Leder",84229000,79499000,163728000
2010,10,WA42,"Lederwaren, Sattlerwaren",123411000,213526000,336937000
2010,10,WA43,"Pelzfelle, künstliches Pelzwerk",13697000,12897000,26594000
2010,10,WA44,"Holz, Holzwaren, Holzkohle",601313000,522478000,1123791000
2010,10,WA45,"Kork, Korkwaren",2920000,8897000,11817000
2010,10,WA46,"Flechtwaren, Korbmacherwaren",3382000,10260000,13642000
2010,10,WA47,"Halbstoffe aus Holz usw., Papierabfall",98453000,320648000,419101000
2010,10,WA48,"Papier, Pappe und Waren daraus",1604458000,1006921000,2611379000
2010,10,WA49,"Bücher, Zeitungen, Bilddrucke usw.",398819000,196137000,594956000
2010,10,WA50,Seide,6308000,6040000,12348000
2010,10,WA51,"Wolle, feine und grobe Tierhaare",55105000,66707000,121812000
2010,10,WA52,Baumwolle,98496000,93129000,191625000
2010,10,WA53,"Andere pflanzliche Spinnstoffe, Papiergarn",4709000,7963000,12672000
2010,10,WA54,Synthetisches oder künstliches Filament,172351000,126494000,298845000
2010,10,WA55,Synthetische oder künstliche Spinnfaser,164179000,126254000,290433000
2010,10,WA56,"Watte, Filz, Vliesstoff usw., Tauwerk",167523000,85997000,253520000
2010,10,WA57,"Teppiche, Fußbodenbelag aus Spinnstoff",43586000,98650000,142236000
2010,10,WA58,"Spezialgewebe, Spitzen, Tapisserien",46061000,31594000,77655000
2010,10,WA59,"Getränkte, bestrichene usw. Gewebe",156377000,89369000,245746000
2010,10,WA60,Gewirke und Gestricke,72125000,38349000,110474000
2010,10,WA61,"Bekleidung usw. aus Gewirken, Gestricken",553092000,1137019000,1690111000
2010,10,WA62,"Andere Bekleidung, Bekleidungszubehör",589899000,1043974000,1633873000
2010,10,WA63,"Andere Konfektion, Spinnstoffwaren usw.",160021000,255865000,415886000
2010,10,WA64,"Schuhe, Gamaschen, ähnliche Waren",251016000,470712000,721728000
2010,10,WA65,Kopfbedeckungen und Teile davon,28649000,43647000,72296000
2010,10,WA66,"Schirme, Gehstöcke usw., Peitschen",6606000,10526000,17132000
2010,10,WA67,"Zugerichtete Federn, Daunen, künstliche Blumen",8302000,13964000,22266000
2010,10,WA68,"Waren aus Steinen, Gips, Zement usw.",302342000,212648000,514990000
2010,10,WA69,Keramische Waren,234795000,191541000,426336000
2010,10,WA70,Glas und Glaswaren,444022000,352517000,796539000
2010,10,WA71,"Perlen, Edelsteine, Edelmetalle",1074529000,934248000,2008777000
2010,10,WA72,Eisen und Stahl,1976190000,2179616000,4155806000
2010,10,WA73,Waren aus Eisen oder Stahl,1946058000,1355365000,3301423000
2010,10,WA74,Kupfer und Waren daraus,930547000,890933000,1821480000
2010,10,WA75,Nickel und Waren daraus,68689000,225903000,294592000
2010,10,WA76,Aluminium und Waren daraus,945856000,1097020000,2042876000
2010,10,WA78,Blei und Waren daraus,48310000,25738000,74048000
2010,10,WA79,Zink und Waren daraus,52890000,90274000,143164000
2010,10,WA80,Zinn und Waren daraus,10674000,30461000,41135000
2010,10,WA81,"Andere unedle Metalle, Cermets usw.",88552000,118997000,207549000
2010,10,WA82,"Werkzeuge, Schneidwaren, Essbestecke",539944000,312049000,851993000
2010,10,WA83,Verschiedene Waren aus unedlen Metallen,521089000,303309000,824398000
2010,10,WA84,"Maschinen, Apparate, mechanische Geräte",15126048000,9448586000,24574634000
2010,10,WA85,Elektrotechnische Erzeugnisse,9633403000,8898658000,18532061000
2010,10,WA86,Schienenfahrzeuge,354533000,177887000,532420000
2010,10,WA87,"Kraftfahrzeuge, Landfahrzeuge",14353631000,5778534000,20132165000
2010,10,WA88,"Luftfahrzeuge, Raumfahrzeuge",1635741000,1215505000,2851246000
2010,10,WA89,Wasserfahrzeuge,579174000,386646000,965820000
2010,10,WA90,"Optische, photografische usw. Erzeugnisse",3756418000,2038918000,5795336000
2010,10,WA91,Uhrmacherwaren,123901000,140792000,264693000
2010,10,WA92,Musikinstrumente,44839000,42096000,86935000
2010,10,WA93,Waffen und Munition,38856000,12674000,51530000
2010,10,WA94,"Möbel, Beleuchtungskörper usw.",1088620000,1152169000,2240789000
2010,10,WA95,"Spielzeug, Spiele usw., Sportgeräte",666669000,646564000,1313233000
2010,10,WA96,Verschiedene Waren,170795000,114742000,285537000
2010,10,WA97,"Kunstgegenstände, Sammlungsstücke",49129000,48325000,97454000
2010,10,WA98,Vollständige Fabrikationsanlagen,274917000,2689000,277606000
2010,10,WA99,Zusammenstellungen verschiedener Waren,1104774000,938824000,2043598000
2010,11,WA01,Lebende Tiere,87504000,118029000,205533000
2010,11,WA02,Fleisch,586013000,464874000,1050887000
2010,11,WA03,"Fische, Krebs- und Weichtiere",100531000,281978000,382509000
2010,11,WA04,"Milch, Milcherzeugnisse, Eier, Honig",597824000,512633000,1110457000
2010,11,WA05,Andere Waren tierischen Ursprungs,50516000,55626000,106142000
2010,11,WA06,"Pflanzen, Waren des Blumenhandels",44998000,178519000,223517000
2010,11,WA07,"Gemüse, Pflanzen für Ernährung",67136000,361541000,428677000
2010,11,WA08,Genießbare Früchte und Nüsse,115263000,566696000,681959000
2010,11,WA09,"Kaffee, Tee, Mate, Gewürze",186574000,308630000,495204000
2010,11,WA10,Getreide,254526000,190903000,445429000
2010,11,WA11,"Müllereierzeugnisse, Malz usw.",83710000,37272000,120982000
2010,11,WA12,"Ölsamen usw., Heilpflanzen usw.",79974000,292006000,371980000
2010,11,WA13,"Schellack, Gummen, Harz, Pflanzensaft",34182000,28892000,63074000
2010,11,WA14,Flechtstoffe usw. pflanzlichen Ursprungs,594000,2523000,3117000
2010,11,WA15,"Tierische und pflanzliche Fette, Öle, Wachs",180272000,310491000,490763000
2010,11,WA16,"Zubereitungen von Fleisch, Fisch usw.",189188000,174668000,363856000
2010,11,WA17,Zucker und Zuckerwaren,133519000,107311000,240830000
2010,11,WA18,Kakao und Zubereitungen aus Kakao,353383000,304163000,657546000
2010,11,WA19,"Zubereitungen aus Getreide usw., Backwaren",355156000,193628000,548784000
2010,11,WA20,"Zubereitungen von Gemüse, Früchten usw.",169261000,337196000,506457000
2010,11,WA21,Verschiedene Lebensmittelzubereitungen,320552000,159024000,479576000
2010,11,WA22,"Getränke, alkoholhaltige Flüssigkeiten, Essig",358906000,526460000,885366000
2010,11,WA23,"Rückstände der Lebensmittelindustrie, Futter",224020000,269017000,493037000
2010,11,WA24,Tabak,306169000,130297000,436466000
2010,11,WA25,"Salz, Schwefel, Steine, Erden usw.",170785000,163045000,333830000
2010,11,WA26,"Erze, Schlacken, Aschen",35324000,727112000,762436000
2010,11,WA27,Mineralische Brennstoffe usw.,1887575000,8871517000,10759092000
2010,11,WA28,Anorganische chemische Erzeugnisse,664701000,528312000,1193013000
2010,11,WA29,Organische chemische Erzeugnisse,1872999000,2001314000,3874313000
2010,11,WA30,Pharmazeutische Erzeugnisse,3718375000,2814362000,6532737000
2010,11,WA31,Düngemittel,184639000,112690000,297329000
2010,11,WA32,"Gerb- und Farbstoffe, Farben, Lacke usw.",752332000,395600000,1147932000
2010,11,WA33,"Etherische Öle, Riech-, Schönheitsmittel",585643000,378356000,963999000
2010,11,WA34,"Seifen, Waschmittel usw.",461548000,254361000,715909000
2010,11,WA35,"Eiweißstoffe, Klebstoffe, Enzyme",211515000,131162000,342677000
2010,11,WA36,"Sprengstoffe, pyrotechnische Artikel usw.",22934000,30299000,53233000
2010,11,WA37,Photochemische Erzeugnisse,91191000,65222000,156413000
2010,11,WA38,Verschiedene Erzeugnisse der Chemischen Industrie,1372342000,884988000,2257330000
2010,11,WA39,Kunststoffe und Waren daraus,3901617000,2306612000,6208229000
2010,11,WA40,Kautschuk und Waren daraus,1112969000,1067433000,2180402000
2010,11,WA41,"Häute, Felle, Leder",78763000,73565000,152328000
2010,11,WA42,"Lederwaren, Sattlerwaren",113446000,232185000,345631000
2010,11,WA43,"Pelzfelle, künstliches Pelzwerk",11495000,11571000,23066000
2010,11,WA44,"Holz, Holzwaren, Holzkohle",566435000,492674000,1059109000
2010,11,WA45,"Kork, Korkwaren",2651000,7236000,9887000
2010,11,WA46,"Flechtwaren, Korbmacherwaren",3266000,9260000,12526000
2010,11,WA47,"Halbstoffe aus Holz usw., Papierabfall",89019000,316898000,405917000
2010,11,WA48,"Papier, Pappe und Waren daraus",1532966000,991691000,2524657000
2010,11,WA49,"Bücher, Zeitungen, Bilddrucke usw.",383137000,142232000,525369000
2010,11,WA50,Seide,6359000,6944000,13303000
2010,11,WA51,"Wolle, feine und grobe Tierhaare",54709000,72737000,127446000
2010,11,WA52,Baumwolle,100989000,98325000,199314000
2010,11,WA53,"Andere pflanzliche Spinnstoffe, Papiergarn",6026000,9530000,15556000
2010,11,WA54,Synthetisches oder künstliches Filament,164675000,123383000,288058000
2010,11,WA55,Synthetische oder künstliche Spinnfaser,171660000,131396000,303056000
2010,11,WA56,"Watte, Filz, Vliesstoff usw., Tauwerk",160906000,84584000,245490000
2010,11,WA57,"Teppiche, Fußbodenbelag aus Spinnstoff",43891000,90478000,134369000
2010,11,WA58,"Spezialgewebe, Spitzen, Tapisserien",40917000,30008000,70925000
2010,11,WA59,"Getränkte, bestrichene usw. Gewebe",159005000,84742000,243747000
2010,11,WA60,Gewirke und Gestricke,72640000,34579000,107219000
2010,11,WA61,"Bekleidung usw. aus Gewirken, Gestricken",484449000,1024724000,1509173000
2010,11,WA62,"Andere Bekleidung, Bekleidungszubehör",477539000,945681000,1423220000
2010,11,WA63,"Andere Konfektion, Spinnstoffwaren usw.",166015000,241342000,407357000
2010,11,WA64,"Schuhe, Gamaschen, ähnliche Waren",201170000,436248000,637418000
2010,11,WA65,Kopfbedeckungen und Teile davon,22912000,32736000,55648000
2010,11,WA66,"Schirme, Gehstöcke usw., Peitschen",5912000,9766000,15678000
2010,11,WA67,"Zugerichtete Federn, Daunen, künstliche Blumen",5348000,12573000,17921000
2010,11,WA68,"Waren aus Steinen, Gips, Zement usw.",298645000,191513000,490158000
2010,11,WA69,Keramische Waren,245958000,181398000,427356000
2010,11,WA70,Glas und Glaswaren,420035000,319743000,739778000
2010,11,WA71,"Perlen, Edelsteine, Edelmetalle",1243294000,1279369000,2522663000
2010,11,WA72,Eisen und Stahl,2075913000,1967583000,4043496000
2010,11,WA73,Waren aus Eisen oder Stahl,1864769000,1303773000,3168542000
2010,11,WA74,Kupfer und Waren daraus,916452000,859369000,1775821000
2010,11,WA75,Nickel und Waren daraus,81392000,167785000,249177000
2010,11,WA76,Aluminium und Waren daraus,908371000,1048740000,1957111000
2010,11,WA78,Blei und Waren daraus,70118000,30381000,100499000
2010,11,WA79,Zink und Waren daraus,57261000,96053000,153314000
2010,11,WA80,Zinn und Waren daraus,12897000,39343000,52240000
2010,11,WA81,"Andere unedle Metalle, Cermets usw.",90025000,111200000,201225000
2010,11,WA82,"Werkzeuge, Schneidwaren, Essbestecke",517991000,324195000,842186000
2010,11,WA83,Verschiedene Waren aus unedlen Metallen,515528000,316875000,832403000
2010,11,WA84,"Maschinen, Apparate, mechanische Geräte",15474070000,9333640000,24807710000
2010,11,WA85,Elektrotechnische Erzeugnisse,9734904000,9383109000,19118013000
2010,11,WA86,Schienenfahrzeuge,364044000,149299000,513343000
2010,11,WA87,"Kraftfahrzeuge, Landfahrzeuge",14575087000,5655305000,20230392000
2010,11,WA88,"Luftfahrzeuge, Raumfahrzeuge",2141838000,1965895000,4107733000
2010,11,WA89,Wasserfahrzeuge,843714000,1367598000,2211312000
2010,11,WA90,"Optische, photografische usw. Erzeugnisse",4030223000,2140102000,6170325000
2010,11,WA91,Uhrmacherwaren,109229000,148509000,257738000
2010,11,WA92,Musikinstrumente,53364000,49774000,103138000
2010,11,WA93,Waffen und Munition,29129000,12871000,42000000
2010,11,WA94,"Möbel, Beleuchtungskörper usw.",1085786000,1115260000,2201046000
2010,11,WA95,"Spielzeug, Spiele usw., Sportgeräte",730407000,594868000,1325275000
2010,11,WA96,Verschiedene Waren,162330000,121684000,284014000
2010,11,WA97,"Kunstgegenstände, Sammlungsstücke",102197000,32238000,134435000
2010,11,WA98,Vollständige Fabrikationsanlagen,289332000,1012000,290344000
2010,11,WA99,Zusammenstellungen verschiedener Waren,1527539000,1039919000,2567458000
2010,12,WA01,Lebende Tiere,113116000,134066000,247182000
2010,12,WA02,Fleisch,612810000,489338000,1102148000
2010,12,WA03,"Fische, Krebs- und Weichtiere",116491000,277079000,393570000
2010,12,WA04,"Milch, Milcherzeugnisse, Eier, Honig",604714000,530006000,1134720000
2010,12,WA05,Andere Waren tierischen Ursprungs,48257000,61283000,109540000
2010,12,WA06,"Pflanzen, Waren des Blumenhandels",42185000,180510000,222695000
2010,12,WA07,"Gemüse, Pflanzen für Ernährung",76976000,386267000,463243000
2010,12,WA08,Genießbare Früchte und Nüsse,115837000,505263000,621100000
2010,12,WA09,"Kaffee, Tee, Mate, Gewürze",165674000,307190000,472864000
2010,12,WA10,Getreide,225275000,192260000,417535000
2010,12,WA11,"Müllereierzeugnisse, Malz usw.",84102000,34972000,119074000
2010,12,WA12,"Ölsamen usw., Heilpflanzen usw.",80128000,240533000,320661000
2010,12,WA13,"Schellack, Gummen, Harz, Pflanzensaft",36083000,27663000,63746000
2010,12,WA14,Flechtstoffe usw. pflanzlichen Ursprungs,663000,1406000,2069000
2010,12,WA15,"Tierische und pflanzliche Fette, Öle, Wachs",154003000,304095000,458098000
2010,12,WA16,"Zubereitungen von Fleisch, Fisch usw.",188503000,191740000,380243000
2010,12,WA17,Zucker und Zuckerwaren,121217000,91845000,213062000
2010,12,WA18,Kakao und Zubereitungen aus Kakao,275097000,255534000,530631000
2010,12,WA19,"Zubereitungen aus Getreide usw., Backwaren",353269000,206464000,559733000
2010,12,WA20,"Zubereitungen von Gemüse, Früchten usw.",176292000,369107000,545399000
2010,12,WA21,Verschiedene Lebensmittelzubereitungen,288213000,166852000,455065000
2010,12,WA22,"Getränke, alkoholhaltige Flüssigkeiten, Essig",357588000,507577000,865165000
2010,12,WA23,"Rückstände der Lebensmittelindustrie, Futter",236524000,260039000,496563000
2010,12,WA24,Tabak,253682000,97835000,351517000
2010,12,WA25,"Salz, Schwefel, Steine, Erden usw.",129751000,160538000,290289000
2010,12,WA26,"Erze, Schlacken, Aschen",21698000,714935000,736633000
2010,12,WA27,Mineralische Brennstoffe usw.,2129585000,8875903000,11005488000
2010,12,WA28,Anorganische chemische Erzeugnisse,647434000,599775000,1247209000
2010,12,WA29,Organische chemische Erzeugnisse,1719057000,1813520000,3532577000
2010,12,WA30,Pharmazeutische Erzeugnisse,4200870000,2569849000,6770719000
2010,12,WA31,Düngemittel,174592000,92000000,266592000
2010,12,WA32,"Gerb- und Farbstoffe, Farben, Lacke usw.",593909000,345560000,939469000
2010,12,WA33,"Etherische Öle, Riech-, Schönheitsmittel",646580000,361499000,1008079000
2010,12,WA34,"Seifen, Waschmittel usw.",407072000,231793000,638865000
2010,12,WA35,"Eiweißstoffe, Klebstoffe, Enzyme",162399000,118843000,281242000
2010,12,WA36,"Sprengstoffe, pyrotechnische Artikel usw.",25049000,22862000,47911000
2010,12,WA37,Photochemische Erzeugnisse,84818000,72530000,157348000
2010,12,WA38,Verschiedene Erzeugnisse der Chemischen Industrie,1296691000,831445000,2128136000
2010,12,WA39,Kunststoffe und Waren daraus,3292223000,2169225000,5461448000
2010,12,WA40,Kautschuk und Waren daraus,925447000,854246000,1779693000
2010,12,WA41,"Häute, Felle, Leder",70355000,68414000,138769000
2010,12,WA42,"Lederwaren, Sattlerwaren",112739000,225563000,338302000
2010,12,WA43,"Pelzfelle, künstliches Pelzwerk",9445000,15613000,25058000
2010,12,WA44,"Holz, Holzwaren, Holzkohle",450334000,419610000,869944000
2010,12,WA45,"Kork, Korkwaren",2092000,8279000,10371000
2010,12,WA46,"Flechtwaren, Korbmacherwaren",2536000,9061000,11597000
2010,12,WA47,"Halbstoffe aus Holz usw., Papierabfall",99385000,317849000,417234000
2010,12,WA48,"Papier, Pappe und Waren daraus",1491454000,959717000,2451171000
2010,12,WA49,"Bücher, Zeitungen, Bilddrucke usw.",422802000,187728000,610530000
2010,12,WA50,Seide,5077000,5913000,10990000
2010,12,WA51,"Wolle, feine und grobe Tierhaare",51837000,59450000,111287000
2010,12,WA52,Baumwolle,94889000,89668000,184557000
2010,12,WA53,"Andere pflanzliche Spinnstoffe, Papiergarn",6304000,7684000,13988000
2010,12,WA54,Synthetisches oder künstliches Filament,151437000,103560000,254997000
2010,12,WA55,Synthetische oder künstliche Spinnfaser,159723000,115305000,275028000
2010,12,WA56,"Watte, Filz, Vliesstoff usw., Tauwerk",141391000,75613000,217004000
2010,12,WA57,"Teppiche, Fußbodenbelag aus Spinnstoff",41439000,92638000,134077000
2010,12,WA58,"Spezialgewebe, Spitzen, Tapisserien",34112000,25482000,59594000
2010,12,WA59,"Getränkte, bestrichene usw. Gewebe",137832000,81899000,219731000
2010,12,WA60,Gewirke und Gestricke,62841000,32498000,95339000
2010,12,WA61,"Bekleidung usw. aus Gewirken, Gestricken",468566000,999877000,1468443000
2010,12,WA62,"Andere Bekleidung, Bekleidungszubehör",445091000,983601000,1428692000
2010,12,WA63,"Andere Konfektion, Spinnstoffwaren usw.",145157000,242251000,387408000
2010,12,WA64,"Schuhe, Gamaschen, ähnliche Waren",180804000,448030000,628834000
2010,12,WA65,Kopfbedeckungen und Teile davon,16288000,31655000,47943000
2010,12,WA66,"Schirme, Gehstöcke usw., Peitschen",4953000,13050000,18003000
2010,12,WA67,"Zugerichtete Federn, Daunen, künstliche Blumen",5186000,13793000,18979000
2010,12,WA68,"Waren aus Steinen, Gips, Zement usw.",229941000,160802000,390743000
2010,12,WA69,Keramische Waren,215658000,169164000,384822000
2010,12,WA70,Glas und Glaswaren,373844000,292752000,666596000
2010,12,WA71,"Perlen, Edelsteine, Edelmetalle",1238123000,1118943000,2357066000
2010,12,WA72,Eisen und Stahl,1616669000,1775291000,3391960000
2010,12,WA73,Waren aus Eisen oder Stahl,1651309000,1152141000,2803450000
2010,12,WA74,Kupfer und Waren daraus,809518000,967068000,1776586000
2010,12,WA75,Nickel und Waren daraus,71944000,121429000,193373000
2010,12,WA76,Aluminium und Waren daraus,787158000,976816000,1763974000
2010,12,WA78,Blei und Waren daraus,32515000,37039000,69554000
2010,12,WA79,Zink und Waren daraus,42407000,72567000,114974000
2010,12,WA80,Zinn und Waren daraus,10833000,29804000,40637000
2010,12,WA81,"Andere unedle Metalle, Cermets usw.",86286000,103772000,190058000
2010,12,WA82,"Werkzeuge, Schneidwaren, Essbestecke",485136000,290568000,775704000
2010,12,WA83,Verschiedene Waren aus unedlen Metallen,402042000,256332000,658374000
2010,12,WA84,"Maschinen, Apparate, mechanische Geräte",15155934000,8579448000,23735382000
2010,12,WA85,Elektrotechnische Erzeugnisse,9405962000,8487689000,17893651000
2010,12,WA86,Schienenfahrzeuge,326024000,142914000,468938000
2010,12,WA87,"Kraftfahrzeuge, Landfahrzeuge",12372599000,4971605000,17344204000
2010,12,WA88,"Luftfahrzeuge, Raumfahrzeuge",1910025000,1918480000,3828505000
2010,12,WA89,Wasserfahrzeuge,65496000,646186000,711682000
2010,12,WA90,"Optische, photografische usw. Erzeugnisse",3897516000,2023179000,5920695000
2010,12,WA91,Uhrmacherwaren,148800000,130386000,279186000
2010,12,WA92,Musikinstrumente,42403000,45261000,87664000
2010,12,WA93,Waffen und Munition,32729000,12816000,45545000
2010,12,WA94,"Möbel, Beleuchtungskörper usw.",966524000,1080440000,2046964000
2010,12,WA95,"Spielzeug, Spiele usw., Sportgeräte",576989000,463367000,1040356000
2010,12,WA96,Verschiedene Waren,156308000,98834000,255142000
2010,12,WA97,"Kunstgegenstände, Sammlungsstücke",45509000,32116000,77625000
2010,12,WA98,Vollständige Fabrikationsanlagen,247958000,23681000,271639000
2010,12,WA99,Zusammenstellungen verschiedener Waren,1606871000,960463000,2567334000
2011,1,WA01,Lebende Tiere,104934000,108806000,213740000
2011,1,WA02,Fleisch,496271000,404780000,901051000
2011,1,WA03,"Fische, Krebs- und Weichtiere",99454000,279948000,379402000
2011,1,WA04,"Milch, Milcherzeugnisse, Eier, Honig",607462000,460783000,1068245000
2011,1,WA05,Andere Waren tierischen Ursprungs,54527000,54285000,108812000
2011,1,WA06,"Pflanzen, Waren des Blumenhandels",39601000,182531000,222132000
2011,1,WA07,"Gemüse, Pflanzen für Ernährung",84995000,476245000,561240000
2011,1,WA08,Genießbare Früchte und Nüsse,103766000,554930000,658696000
2011,1,WA09,"Kaffee, Tee, Mate, Gewürze",173445000,370573000,544018000
2011,1,WA10,Getreide,242528000,218156000,460684000
2011,1,WA11,"Müllereierzeugnisse, Malz usw.",79871000,40279000,120150000
2011,1,WA12,"Ölsamen usw., Heilpflanzen usw.",111740000,271278000,383018000
2011,1,WA13,"Schellack, Gummen, Harz, Pflanzensaft",40033000,36541000,76574000
2011,1,WA14,Flechtstoffe usw. pflanzlichen Ursprungs,697000,1990000,2687000
2011,1,WA15,"Tierische und pflanzliche Fette, Öle, Wachs",190487000,308954000,499441000
2011,1,WA16,"Zubereitungen von Fleisch, Fisch usw.",186571000,176175000,362746000
2011,1,WA17,Zucker und Zuckerwaren,107366000,96742000,204108000
2011,1,WA18,Kakao und Zubereitungen aus Kakao,259831000,250982000,510813000
2011,1,WA19,"Zubereitungen aus Getreide usw., Backwaren",321179000,182767000,503946000
2011,1,WA20,"Zubereitungen von Gemüse, Früchten usw.",155598000,321348000,476946000
2011,1,WA21,Verschiedene Lebensmittelzubereitungen,301084000,158128000,459212000
2011,1,WA22,"Getränke, alkoholhaltige Flüssigkeiten, Essig",318104000,445199000,763303000
2011,1,WA23,"Rückstände der Lebensmittelindustrie, Futter",221764000,241364000,463128000
2011,1,WA24,Tabak,269823000,148256000,418079000
2011,1,WA25,"Salz, Schwefel, Steine, Erden usw.",141592000,144964000,286556000
2011,1,WA26,"Erze, Schlacken, Aschen",24891000,835924000,860815000
2011,1,WA27,Mineralische Brennstoffe usw.,2298696000,9524494000,11823190000
2011,1,WA28,Anorganische chemische Erzeugnisse,863642000,475718000,1339360000
2011,1,WA29,Organische chemische Erzeugnisse,2081196000,1930522000,4011718000
2011,1,WA30,Pharmazeutische Erzeugnisse,3703655000,2615088000,6318743000
2011,1,WA31,Düngemittel,204965000,114839000,319804000
2011,1,WA32,"Gerb- und Farbstoffe, Farben, Lacke usw.",703268000,391658000,1094926000
2011,1,WA33,"Etherische Öle, Riech-, Schönheitsmittel",609979000,356155000,966134000
2011,1,WA34,"Seifen, Waschmittel usw.",464318000,235251000,699569000
2011,1,WA35,"Eiweißstoffe, Klebstoffe, Enzyme",187848000,142607000,330455000
2011,1,WA36,"Sprengstoffe, pyrotechnische Artikel usw.",15756000,17595000,33351000
2011,1,WA37,Photochemische Erzeugnisse,83286000,55687000,138973000
2011,1,WA38,Verschiedene Erzeugnisse der Chemischen Industrie,1424595000,961560000,2386155000
2011,1,WA39,Kunststoffe und Waren daraus,3929146000,2391864000,6321010000
2011,1,WA40,Kautschuk und Waren daraus,1053628000,1063193000,2116821000
2011,1,WA41,"Häute, Felle, Leder",67328000,63831000,131159000
2011,1,WA42,"Lederwaren, Sattlerwaren",123474000,256417000,379891000
2011,1,WA43,"Pelzfelle, künstliches Pelzwerk",7097000,9479000,16576000
2011,1,WA44,"Holz, Holzwaren, Holzkohle",476065000,469311000,945376000
2011,1,WA45,"Kork, Korkwaren",2644000,9553000,12197000
2011,1,WA46,"Flechtwaren, Korbmacherwaren",2961000,11537000,14498000
2011,1,WA47,"Halbstoffe aus Holz usw., Papierabfall",97695000,324808000,422503000
2011,1,WA48,"Papier, Pappe und Waren daraus",1485475000,968494000,2453969000
2011,1,WA49,"Bücher, Zeitungen, Bilddrucke usw.",367695000,149326000,517021000
2011,1,WA50,Seide,5604000,6636000,12240000
2011,1,WA51,"Wolle, feine und grobe Tierhaare",62050000,70665000,132715000
2011,1,WA52,Baumwolle,97388000,104889000,202277000
2011,1,WA53,"Andere pflanzliche Spinnstoffe, Papiergarn",5772000,7533000,13305000
2011,1,WA54,Synthetisches oder künstliches Filament,164739000,121346000,286085000
2011,1,WA55,Synthetische oder künstliche Spinnfaser,171798000,127279000,299077000
2011,1,WA56,"Watte, Filz, Vliesstoff usw., Tauwerk",164262000,88905000,253167000
2011,1,WA57,"Teppiche, Fußbodenbelag aus Spinnstoff",39635000,93275000,132910000
2011,1,WA58,"Spezialgewebe, Spitzen, Tapisserien",35866000,26584000,62450000
2011,1,WA59,"Getränkte, bestrichene usw. Gewebe",151544000,85832000,237376000
2011,1,WA60,Gewirke und Gestricke,69533000,31346000,100879000
2011,1,WA61,"Bekleidung usw. aus Gewirken, Gestricken",537584000,1089363000,1626947000
2011,1,WA62,"Andere Bekleidung, Bekleidungszubehör",654329000,1225609000,1879938000
2011,1,WA63,"Andere Konfektion, Spinnstoffwaren usw.",139649000,276232000,415881000
2011,1,WA64,"Schuhe, Gamaschen, ähnliche Waren",310280000,657023000,967303000
2011,1,WA65,Kopfbedeckungen und Teile davon,18810000,29790000,48600000
2011,1,WA66,"Schirme, Gehstöcke usw., Peitschen",6048000,19008000,25056000
2011,1,WA67,"Zugerichtete Federn, Daunen, künstliche Blumen",7602000,16285000,23887000
2011,1,WA68,"Waren aus Steinen, Gips, Zement usw.",250913000,167332000,418245000
2011,1,WA69,Keramische Waren,211992000,188969000,400961000
2011,1,WA70,Glas und Glaswaren,403861000,314318000,718179000
2011,1,WA71,"Perlen, Edelsteine, Edelmetalle",988041000,1196428000,2184469000
2011,1,WA72,Eisen und Stahl,2022752000,2056775000,4079527000
2011,1,WA73,Waren aus Eisen oder Stahl,1749533000,1251442000,3000975000
2011,1,WA74,Kupfer und Waren daraus,976012000,930368000,1906380000
2011,1,WA75,Nickel und Waren daraus,71477000,160646000,232123000
2011,1,WA76,Aluminium und Waren daraus,1005447000,1035815000,2041262000
2011,1,WA78,Blei und Waren daraus,49217000,27988000,77205000
2011,1,WA79,Zink und Waren daraus,49777000,85954000,135731000
2011,1,WA80,Zinn und Waren daraus,10831000,39934000,50765000
2011,1,WA81,"Andere unedle Metalle, Cermets usw.",90834000,129370000,220204000
2011,1,WA82,"Werkzeuge, Schneidwaren, Essbestecke",499139000,320595000,819734000
2011,1,WA83,Verschiedene Waren aus unedlen Metallen,503147000,296477000,799624000
2011,1,WA84,"Maschinen, Apparate, mechanische Geräte",13454531000,8581594000,22036125000
2011,1,WA85,Elektrotechnische Erzeugnisse,8153317000,7749974000,15903291000
2011,1,WA86,Schienenfahrzeuge,236978000,143217000,380195000
2011,1,WA87,"Kraftfahrzeuge, Landfahrzeuge",12554425000,4967119000,17521544000
2011,1,WA88,"Luftfahrzeuge, Raumfahrzeuge",1878916000,830350000,2709266000
2011,1,WA89,Wasserfahrzeuge,177049000,806450000,983499000
2011,1,WA90,"Optische, photografische usw. Erzeugnisse",3481529000,2073738000,5555267000
2011,1,WA91,Uhrmacherwaren,96244000,117135000,213379000
2011,1,WA92,Musikinstrumente,39083000,39618000,78701000
2011,1,WA93,Waffen und Munition,19169000,9432000,28601000
2011,1,WA94,"Möbel, Beleuchtungskörper usw.",913969000,1090576000,2004545000
2011,1,WA95,"Spielzeug, Spiele usw., Sportgeräte",251817000,405573000,657390000
2011,1,WA96,Verschiedene Waren,143947000,117694000,261641000
2011,1,WA97,"Kunstgegenstände, Sammlungsstücke",89899000,19858000,109757000
2011,1,WA98,Vollständige Fabrikationsanlagen,241774000,853000,242627000
2011,1,WA99,Zusammenstellungen verschiedener Waren,1064704000,844692000,1909396000
2011,2,WA01,Lebende Tiere,87161000,121448000,208609000
2011,2,WA02,Fleisch,497795000,408896000,906691000
2011,2,WA03,"Fische, Krebs- und Weichtiere",94631000,274112000,368743000
2011,2,WA04,"Milch, Milcherzeugnisse, Eier, Honig",630239000,465266000,1095505000
2011,2,WA05,Andere Waren tierischen Ursprungs,49804000,58591000,108395000
2011,2,WA06,"Pflanzen, Waren des Blumenhandels",55792000,231981000,287773000
2011,2,WA07,"Gemüse, Pflanzen für Ernährung",87460000,468874000,556334000
2011,2,WA08,Genießbare Früchte und Nüsse,105353000,488788000,594141000
2011,2,WA09,"Kaffee, Tee, Mate, Gewürze",181805000,354508000,536313000
2011,2,WA10,Getreide,242813000,218491000,461304000
2011,2,WA11,"Müllereierzeugnisse, Malz usw.",80084000,38393000,118477000
2011,2,WA12,"Ölsamen usw., Heilpflanzen usw.",134753000,319913000,454666000
2011,2,WA13,"Schellack, Gummen, Harz, Pflanzensaft",37409000,30164000,67573000
2011,2,WA14,Flechtstoffe usw. pflanzlichen Ursprungs,944000,2125000,3069000
2011,2,WA15,"Tierische und pflanzliche Fette, Öle, Wachs",213297000,321600000,534897000
2011,2,WA16,"Zubereitungen von Fleisch, Fisch usw.",181223000,143443000,324666000
2011,2,WA17,Zucker und Zuckerwaren,112362000,103673000,216035000
2011,2,WA18,Kakao und Zubereitungen aus Kakao,282273000,295780000,578053000
2011,2,WA19,"Zubereitungen aus Getreide usw., Backwaren",333136000,192039000,525175000
2011,2,WA20,"Zubereitungen von Gemüse, Früchten usw.",160843000,307851000,468694000
2011,2,WA21,Verschiedene Lebensmittelzubereitungen,302621000,167676000,470297000
2011,2,WA22,"Getränke, alkoholhaltige Flüssigkeiten, Essig",311656000,410560000,722216000
2011,2,WA23,"Rückstände der Lebensmittelindustrie, Futter",244868000,240598000,485466000
2011,2,WA24,Tabak,287963000,137512000,425475000
2011,2,WA25,"Salz, Schwefel, Steine, Erden usw.",155695000,154222000,309917000
2011,2,WA26,"Erze, Schlacken, Aschen",37818000,800110000,837928000
2011,2,WA27,Mineralische Brennstoffe usw.,2168093000,10088258000,12256351000
2011,2,WA28,Anorganische chemische Erzeugnisse,662253000,628210000,1290463000
2011,2,WA29,Organische chemische Erzeugnisse,2143337000,1869253000,4012590000
2011,2,WA30,Pharmazeutische Erzeugnisse,3932930000,2805666000,6738596000
2011,2,WA31,Düngemittel,240321000,133293000,373614000
2011,2,WA32,"Gerb- und Farbstoffe, Farben, Lacke usw.",755975000,420943000,1176918000
2011,2,WA33,"Etherische Öle, Riech-, Schönheitsmittel",622005000,359586000,981591000
2011,2,WA34,"Seifen, Waschmittel usw.",470251000,224453000,694704000
2011,2,WA35,"Eiweißstoffe, Klebstoffe, Enzyme",196490000,137315000,333805000
2011,2,WA36,"Sprengstoffe, pyrotechnische Artikel usw.",19630000,13628000,33258000
2011,2,WA37,Photochemische Erzeugnisse,86943000,61385000,148328000
2011,2,WA38,Verschiedene Erzeugnisse der Chemischen Industrie,1551028000,906211000,2457239000
2011,2,WA39,Kunststoffe und Waren daraus,4068256000,2480394000,6548650000
2011,2,WA40,Kautschuk und Waren daraus,1091752000,1089988000,2181740000
2011,2,WA41,"Häute, Felle, Leder",87719000,74651000,162370000
2011,2,WA42,"Lederwaren, Sattlerwaren",127595000,237564000,365159000
2011,2,WA43,"Pelzfelle, künstliches Pelzwerk",6147000,10911000,17058000
2011,2,WA44,"Holz, Holzwaren, Holzkohle",541871000,499791000,1041662000
2011,2,WA45,"Kork, Korkwaren",2528000,7161000,9689000
2011,2,WA46,"Flechtwaren, Korbmacherwaren",2944000,12241000,15185000
2011,2,WA47,"Halbstoffe aus Holz usw., Papierabfall",103098000,330811000,433909000
2011,2,WA48,"Papier, Pappe und Waren daraus",1532700000,965898000,2498598000
2011,2,WA49,"Bücher, Zeitungen, Bilddrucke usw.",340213000,151925000,492138000
2011,2,WA50,Seide,6406000,6791000,13197000
2011,2,WA51,"Wolle, feine und grobe Tierhaare",56955000,60951000,117906000
2011,2,WA52,Baumwolle,92273000,99821000,192094000
2011,2,WA53,"Andere pflanzliche Spinnstoffe, Papiergarn",5306000,6851000,12157000
2011,2,WA54,Synthetisches oder künstliches Filament,174629000,123245000,297874000
2011,2,WA55,Synthetische oder künstliche Spinnfaser,168542000,147197000,315739000
2011,2,WA56,"Watte, Filz, Vliesstoff usw., Tauwerk",164429000,101635000,266064000
2011,2,WA57,"Teppiche, Fußbodenbelag aus Spinnstoff",45010000,101347000,146357000
2011,2,WA58,"Spezialgewebe, Spitzen, Tapisserien",39723000,27008000,66731000
2011,2,WA59,"Getränkte, bestrichene usw. Gewebe",156824000,94311000,251135000
2011,2,WA60,Gewirke und Gestricke,70625000,33282000,103907000
2011,2,WA61,"Bekleidung usw. aus Gewirken, Gestricken",554438000,1037396000,1591834000
2011,2,WA62,"Andere Bekleidung, Bekleidungszubehör",749880000,1257074000,2006954000
2011,2,WA63,"Andere Konfektion, Spinnstoffwaren usw.",152040000,268174000,420214000
2011,2,WA64,"Schuhe, Gamaschen, ähnliche Waren",362502000,656091000,1018593000
2011,2,WA65,Kopfbedeckungen und Teile davon,29562000,38058000,67620000
2011,2,WA66,"Schirme, Gehstöcke usw., Peitschen",6505000,18680000,25185000
2011,2,WA67,"Zugerichtete Federn, Daunen, künstliche Blumen",7679000,12787000,20466000
2011,2,WA68,"Waren aus Steinen, Gips, Zement usw.",279855000,184052000,463907000
2011,2,WA69,Keramische Waren,228491000,191764000,420255000
2011,2,WA70,Glas und Glaswaren,405402000,319919000,725321000
2011,2,WA71,"Perlen, Edelsteine, Edelmetalle",853811000,1134262000,1988073000
2011,2,WA72,Eisen und Stahl,2274567000,2314442000,4589009000
2011,2,WA73,Waren aus Eisen oder Stahl,1967052000,1358392000,3325444000
2011,2,WA74,Kupfer und Waren daraus,1140574000,1074771000,2215345000
2011,2,WA75,Nickel und Waren daraus,81734000,191899000,273633000
2011,2,WA76,Aluminium und Waren daraus,1063399000,1147368000,2210767000
2011,2,WA78,Blei und Waren daraus,45176000,33490000,78666000
2011,2,WA79,Zink und Waren daraus,56058000,94787000,150845000
2011,2,WA80,Zinn und Waren daraus,12225000,40453000,52678000
2011,2,WA81,"Andere unedle Metalle, Cermets usw.",95146000,121929000,217075000
2011,2,WA82,"Werkzeuge, Schneidwaren, Essbestecke",532334000,329190000,861524000
2011,2,WA83,Verschiedene Waren aus unedlen Metallen,522469000,310923000,833392000
2011,2,WA84,"Maschinen, Apparate, mechanische Geräte",14479105000,8462372000,22941477000
2011,2,WA85,Elektrotechnische Erzeugnisse,8372744000,7533454000,15906198000
2011,2,WA86,Schienenfahrzeuge,231010000,138012000,369022000
2011,2,WA87,"Kraftfahrzeuge, Landfahrzeuge",14679082000,5497682000,20176764000
2011,2,WA88,"Luftfahrzeuge, Raumfahrzeuge",1689924000,1727715000,3417639000
2011,2,WA89,Wasserfahrzeuge,108203000,1015665000,1123868000
2011,2,WA90,"Optische, photografische usw. Erzeugnisse",3699198000,2008426000,5707624000
2011,2,WA91,Uhrmacherwaren,102418000,116060000,218478000
2011,2,WA92,Musikinstrumente,36219000,35637000,71856000
2011,2,WA93,Waffen und Munition,27480000,11526000,39006000
2011,2,WA94,"Möbel, Beleuchtungskörper usw.",1070385000,1191208000,2261593000
2011,2,WA95,"Spielzeug, Spiele usw., Sportgeräte",331516000,436211000,767727000
2011,2,WA96,Verschiedene Waren,156170000,113460000,269630000
2011,2,WA97,"Kunstgegenstände, Sammlungsstücke",123644000,18507000,142151000
2011,2,WA98,Vollständige Fabrikationsanlagen,227458000,477000,227935000
2011,2,WA99,Zusammenstellungen verschiedener Waren,1136783000,935891000,2072674000
2011,3,WA01,Lebende Tiere,92063000,129330000,221393000
2011,3,WA02,Fleisch,570513000,493574000,1064087000
2011,3,WA03,"Fische, Krebs- und Weichtiere",107434000,266471000,373905000
2011,3,WA04,"Milch, Milcherzeugnisse, Eier, Honig",706863000,544354000,1251217000
2011,3,WA05,Andere Waren tierischen Ursprungs,62287000,66416000,128703000
2011,3,WA06,"Pflanzen, Waren des Blumenhandels",87631000,317332000,404963000
2011,3,WA07,"Gemüse, Pflanzen für Ernährung",105400000,480174000,585574000
2011,3,WA08,Genießbare Früchte und Nüsse,107925000,522419000,630344000
2011,3,WA09,"Kaffee, Tee, Mate, Gewürze",214461000,407434000,621895000
2011,3,WA10,Getreide,295711000,252779000,548490000
2011,3,WA11,"Müllereierzeugnisse, Malz usw.",90299000,46340000,136639000
2011,3,WA12,"Ölsamen usw., Heilpflanzen usw.",128426000,324971000,453397000
2011,3,WA13,"Schellack, Gummen, Harz, Pflanzensaft",43391000,41537000,84928000
2011,3,WA14,Flechtstoffe usw. pflanzlichen Ursprungs,1030000,2723000,3753000
2011,3,WA15,"Tierische und pflanzliche Fette, Öle, Wachs",231603000,336676000,568279000
2011,3,WA16,"Zubereitungen von Fleisch, Fisch usw.",209241000,190183000,399424000
2011,3,WA17,Zucker und Zuckerwaren,135296000,125788000,261084000
2011,3,WA18,Kakao und Zubereitungen aus Kakao,309758000,279548000,589306000
2011,3,WA19,"Zubereitungen aus Getreide usw., Backwaren",380431000,239358000,619789000
2011,3,WA20,"Zubereitungen von Gemüse, Früchten usw.",177521000,347798000,525319000
2011,3,WA21,Verschiedene Lebensmittelzubereitungen,373110000,182979000,556089000
2011,3,WA22,"Getränke, alkoholhaltige Flüssigkeiten, Essig",400098000,513458000,913556000
2011,3,WA23,"Rückstände der Lebensmittelindustrie, Futter",223219000,263025000,486244000
2011,3,WA24,Tabak,328366000,167954000,496320000
2011,3,WA25,"Salz, Schwefel, Steine, Erden usw.",199350000,151869000,351219000
2011,3,WA26,"Erze, Schlacken, Aschen",24711000,789744000,814455000
2011,3,WA27,Mineralische Brennstoffe usw.,2438974000,10085380000,12524354000
2011,3,WA28,Anorganische chemische Erzeugnisse,850504000,613015000,1463519000
2011,3,WA29,Organische chemische Erzeugnisse,2152226000,2093282000,4245508000
2011,3,WA30,Pharmazeutische Erzeugnisse,4451887000,3118443000,7570330000
2011,3,WA31,Düngemittel,246323000,172802000,419125000
2011,3,WA32,"Gerb- und Farbstoffe, Farben, Lacke usw.",863691000,471183000,1334874000
2011,3,WA33,"Etherische Öle, Riech-, Schönheitsmittel",677700000,380589000,1058289000
2011,3,WA34,"Seifen, Waschmittel usw.",517683000,259010000,776693000
2011,3,WA35,"Eiweißstoffe, Klebstoffe, Enzyme",226909000,151680000,378589000
2011,3,WA36,"Sprengstoffe, pyrotechnische Artikel usw.",18432000,13395000,31827000
2011,3,WA37,Photochemische Erzeugnisse,102273000,73740000,176013000
2011,3,WA38,Verschiedene Erzeugnisse der Chemischen Industrie,1753090000,1131793000,2884883000
2011,3,WA39,Kunststoffe und Waren daraus,4620941000,2890141000,7511082000
2011,3,WA40,Kautschuk und Waren daraus,1281819000,1312142000,2593961000
2011,3,WA41,"Häute, Felle, Leder",94408000,88415000,182823000
2011,3,WA42,"Lederwaren, Sattlerwaren",134490000,249404000,383894000
2011,3,WA43,"Pelzfelle, künstliches Pelzwerk",12561000,13380000,25941000
2011,3,WA44,"Holz, Holzwaren, Holzkohle",611717000,588946000,1200663000
2011,3,WA45,"Kork, Korkwaren",3001000,9484000,12485000
2011,3,WA46,"Flechtwaren, Korbmacherwaren",3577000,11399000,14976000
2011,3,WA47,"Halbstoffe aus Holz usw., Papierabfall",115459000,370935000,486394000
2011,3,WA48,"Papier, Pappe und Waren daraus",1663319000,1049923000,2713242000
2011,3,WA49,"Bücher, Zeitungen, Bilddrucke usw.",382306000,183400000,565706000
2011,3,WA50,Seide,6691000,7268000,13959000
2011,3,WA51,"Wolle, feine und grobe Tierhaare",72605000,92414000,165019000
2011,3,WA52,Baumwolle,108379000,115980000,224359000
2011,3,WA53,"Andere pflanzliche Spinnstoffe, Papiergarn",4447000,7463000,11910000
2011,3,WA54,Synthetisches oder künstliches Filament,203286000,134023000,337309000
2011,3,WA55,Synthetische oder künstliche Spinnfaser,199363000,157589000,356952000
2011,3,WA56,"Watte, Filz, Vliesstoff usw., Tauwerk",201795000,103283000,305078000
2011,3,WA57,"Teppiche, Fußbodenbelag aus Spinnstoff",44015000,95241000,139256000
2011,3,WA58,"Spezialgewebe, Spitzen, Tapisserien",44622000,29776000,74398000
2011,3,WA59,"Getränkte, bestrichene usw. Gewebe",190111000,104339000,294450000
2011,3,WA60,Gewirke und Gestricke,82408000,43098000,125506000
2011,3,WA61,"Bekleidung usw. aus Gewirken, Gestricken",605291000,1079061000,1684352000
2011,3,WA62,"Andere Bekleidung, Bekleidungszubehör",776932000,1269736000,2046668000
2011,3,WA63,"Andere Konfektion, Spinnstoffwaren usw.",183981000,290523000,474504000
2011,3,WA64,"Schuhe, Gamaschen, ähnliche Waren",392464000,604265000,996729000
2011,3,WA65,Kopfbedeckungen und Teile davon,23249000,35139000,58388000
2011,3,WA66,"Schirme, Gehstöcke usw., Peitschen",8215000,22225000,30440000
2011,3,WA67,"Zugerichtete Federn, Daunen, künstliche Blumen",7174000,9201000,16375000
2011,3,WA68,"Waren aus Steinen, Gips, Zement usw.",325989000,214835000,540824000
2011,3,WA69,Keramische Waren,256445000,195951000,452396000
2011,3,WA70,Glas und Glaswaren,484301000,348967000,833268000
2011,3,WA71,"Perlen, Edelsteine, Edelmetalle",1295159000,1233387000,2528546000
2011,3,WA72,Eisen und Stahl,2419814000,2681712000,5101526000
2011,3,WA73,Waren aus Eisen oder Stahl,2208936000,1520409000,3729345000
2011,3,WA74,Kupfer und Waren daraus,1286819000,1059149000,2345968000
2011,3,WA75,Nickel und Waren daraus,98082000,191849000,289931000
2011,3,WA76,Aluminium und Waren daraus,1224375000,1284012000,2508387000
2011,3,WA78,Blei und Waren daraus,46603000,41115000,87718000
2011,3,WA79,Zink und Waren daraus,62669000,101649000,164318000
2011,3,WA80,Zinn und Waren daraus,15519000,45206000,60725000
2011,3,WA81,"Andere unedle Metalle, Cermets usw.",123641000,139046000,262687000
2011,3,WA82,"Werkzeuge, Schneidwaren, Essbestecke",589924000,371444000,961368000
2011,3,WA83,Verschiedene Waren aus unedlen Metallen,581106000,336553000,917659000
2011,3,WA84,"Maschinen, Apparate, mechanische Geräte",17435763000,9874665000,27310428000
2011,3,WA85,Elektrotechnische Erzeugnisse,9779856000,8741119000,18520975000
2011,3,WA86,Schienenfahrzeuge,369131000,176217000,545348000
2011,3,WA87,"Kraftfahrzeuge, Landfahrzeuge",16940923000,6808410000,23749333000
2011,3,WA88,"Luftfahrzeuge, Raumfahrzeuge",2410216000,1477838000,3888054000
2011,3,WA89,Wasserfahrzeuge,492660000,479004000,971664000
2011,3,WA90,"Optische, photografische usw. Erzeugnisse",4328429000,2308418000,6636847000
2011,3,WA91,Uhrmacherwaren,110196000,115810000,226006000
2011,3,WA92,Musikinstrumente,41800000,39620000,81420000
2011,3,WA93,Waffen und Munition,37272000,20501000,57773000
2011,3,WA94,"Möbel, Beleuchtungskörper usw.",1196667000,1206061000,2402728000
2011,3,WA95,"Spielzeug, Spiele usw., Sportgeräte",513009000,540055000,1053064000
2011,3,WA96,Verschiedene Waren,180439000,120820000,301259000
2011,3,WA97,"Kunstgegenstände, Sammlungsstücke",53147000,24735000,77882000
2011,3,WA98,Vollständige Fabrikationsanlagen,239621000,2175000,241796000
2011,3,WA99,Zusammenstellungen verschiedener Waren,1538314000,1067983000,2606297000
2011,4,WA01,Lebende Tiere,110964000,136670000,247634000
2011,4,WA02,Fleisch,576588000,463590000,1040178000
2011,4,WA03,"Fische, Krebs- und Weichtiere",98895000,254180000,353075000
2011,4,WA04,"Milch, Milcherzeugnisse, Eier, Honig",652072000,521770000,1173842000
2011,4,WA05,Andere Waren tierischen Ursprungs,54307000,55195000,109502000
2011,4,WA06,"Pflanzen, Waren des Blumenhandels",112962000,354223000,467185000
2011,4,WA07,"Gemüse, Pflanzen für Ernährung",101361000,533451000,634812000
2011,4,WA08,Genießbare Früchte und Nüsse,109992000,521598000,631590000
2011,4,WA09,"Kaffee, Tee, Mate, Gewürze",193667000,373462000,567129000
2011,4,WA10,Getreide,267420000,170764000,438184000
2011,4,WA11,"Müllereierzeugnisse, Malz usw.",80417000,41419000,121836000
2011,4,WA12,"Ölsamen usw., Heilpflanzen usw.",70110000,291883000,361993000
2011,4,WA13,"Schellack, Gummen, Harz, Pflanzensaft",36833000,28940000,65773000
2011,4,WA14,Flechtstoffe usw. pflanzlichen Ursprungs,1077000,2504000,3581000
2011,4,WA15,"Tierische und pflanzliche Fette, Öle, Wachs",208615000,313946000,522561000
2011,4,WA16,"Zubereitungen von Fleisch, Fisch usw.",200209000,165929000,366138000
2011,4,WA17,Zucker und Zuckerwaren,108641000,103559000,212200000
2011,4,WA18,Kakao und Zubereitungen aus Kakao,239895000,265846000,505741000
2011,4,WA19,"Zubereitungen aus Getreide usw., Backwaren",362348000,216847000,579195000
2011,4,WA20,"Zubereitungen von Gemüse, Früchten usw.",170016000,347529000,517545000
2011,4,WA21,Verschiedene Lebensmittelzubereitungen,349186000,174891000,524077000
2011,4,WA22,"Getränke, alkoholhaltige Flüssigkeiten, Essig",386105000,467726000,853831000
2011,4,WA23,"Rückstände der Lebensmittelindustrie, Futter",210783000,231640000,442423000
2011,4,WA24,Tabak,302131000,148060000,450191000
2011,4,WA25,"Salz, Schwefel, Steine, Erden usw.",183954000,162886000,346840000
2011,4,WA26,"Erze, Schlacken, Aschen",24610000,808019000,832629000
2011,4,WA27,Mineralische Brennstoffe usw.,1941929000,10944340000,12886269000
2011,4,WA28,Anorganische chemische Erzeugnisse,723688000,656188000,1379876000
2011,4,WA29,Organische chemische Erzeugnisse,1795791000,1868667000,3664458000
2011,4,WA30,Pharmazeutische Erzeugnisse,4029641000,2699853000,6729494000
2011,4,WA31,Düngemittel,210719000,103015000,313734000
2011,4,WA32,"Gerb- und Farbstoffe, Farben, Lacke usw.",788206000,431967000,1220173000
2011,4,WA33,"Etherische Öle, Riech-, Schönheitsmittel",583166000,321832000,904998000
2011,4,WA34,"Seifen, Waschmittel usw.",463928000,227707000,691635000
2011,4,WA35,"Eiweißstoffe, Klebstoffe, Enzyme",205213000,140878000,346091000
2011,4,WA36,"Sprengstoffe, pyrotechnische Artikel usw.",17914000,16174000,34088000
2011,4,WA37,Photochemische Erzeugnisse,83056000,63955000,147011000
2011,4,WA38,Verschiedene Erzeugnisse der Chemischen Industrie,1565647000,1004897000,2570544000
2011,4,WA39,Kunststoffe und Waren daraus,4161271000,2675800000,6837071000
2011,4,WA40,Kautschuk und Waren daraus,1127335000,1135293000,2262628000
2011,4,WA41,"Häute, Felle, Leder",94083000,79859000,173942000
2011,4,WA42,"Lederwaren, Sattlerwaren",100636000,190797000,291433000
2011,4,WA43,"Pelzfelle, künstliches Pelzwerk",12551000,12849000,25400000
2011,4,WA44,"Holz, Holzwaren, Holzkohle",575990000,571364000,1147354000
2011,4,WA45,"Kork, Korkwaren",2737000,11240000,13977000
2011,4,WA46,"Flechtwaren, Korbmacherwaren",3138000,9722000,12860000
2011,4,WA47,"Halbstoffe aus Holz usw., Papierabfall",105724000,335775000,441499000
2011,4,WA48,"Papier, Pappe und Waren daraus",1532995000,988366000,2521361000
2011,4,WA49,"Bücher, Zeitungen, Bilddrucke usw.",333384000,162479000,495863000
2011,4,WA50,Seide,6177000,7302000,13479000
2011,4,WA51,"Wolle, feine und grobe Tierhaare",64710000,75365000,140075000
2011,4,WA52,Baumwolle,100943000,114694000,215637000
2011,4,WA53,"Andere pflanzliche Spinnstoffe, Papiergarn",3401000,6295000,9696000
2011,4,WA54,Synthetisches oder künstliches Filament,177734000,127023000,304757000
2011,4,WA55,Synthetische oder künstliche Spinnfaser,167802000,143571000,311373000
2011,4,WA56,"Watte, Filz, Vliesstoff usw., Tauwerk",180462000,107058000,287520000
2011,4,WA57,"Teppiche, Fußbodenbelag aus Spinnstoff",40934000,94792000,135726000
2011,4,WA58,"Spezialgewebe, Spitzen, Tapisserien",44414000,29217000,73631000
2011,4,WA59,"Getränkte, bestrichene usw. Gewebe",160603000,99512000,260115000
2011,4,WA60,Gewirke und Gestricke,86851000,44381000,131232000
2011,4,WA61,"Bekleidung usw. aus Gewirken, Gestricken",429466000,854652000,1284118000
2011,4,WA62,"Andere Bekleidung, Bekleidungszubehör",528057000,965458000,1493515000
2011,4,WA63,"Andere Konfektion, Spinnstoffwaren usw.",155313000,276488000,431801000
2011,4,WA64,"Schuhe, Gamaschen, ähnliche Waren",233109000,425552000,658661000
2011,4,WA65,Kopfbedeckungen und Teile davon,19784000,25727000,45511000
2011,4,WA66,"Schirme, Gehstöcke usw., Peitschen",8255000,17885000,26140000
2011,4,WA67,"Zugerichtete Federn, Daunen, künstliche Blumen",5476000,8679000,14155000
2011,4,WA68,"Waren aus Steinen, Gips, Zement usw.",309266000,202196000,511462000
2011,4,WA69,Keramische Waren,231622000,181980000,413602000
2011,4,WA70,Glas und Glaswaren,425792000,334561000,760353000
2011,4,WA71,"Perlen, Edelsteine, Edelmetalle",942973000,1016275000,1959248000
2011,4,WA72,Eisen und Stahl,2175305000,2443780000,4619085000
2011,4,WA73,Waren aus Eisen oder Stahl,2107544000,1494857000,3602401000
2011,4,WA74,Kupfer und Waren daraus,1057888000,1044968000,2102856000
2011,4,WA75,Nickel und Waren daraus,75002000,209649000,284651000
2011,4,WA76,Aluminium und Waren daraus,1036829000,1195420000,2232249000
2011,4,WA78,Blei und Waren daraus,39755000,30496000,70251000
2011,4,WA79,Zink und Waren daraus,58398000,105139000,163537000
2011,4,WA80,Zinn und Waren daraus,12863000,52379000,65242000
2011,4,WA81,"Andere unedle Metalle, Cermets usw.",103810000,134823000,238633000
2011,4,WA82,"Werkzeuge, Schneidwaren, Essbestecke",525729000,324789000,850518000
2011,4,WA83,Verschiedene Waren aus unedlen Metallen,533311000,304572000,837883000
2011,4,WA84,"Maschinen, Apparate, mechanische Geräte",15180247000,8927131000,24107378000
2011,4,WA85,Elektrotechnische Erzeugnisse,8406062000,7948508000,16354570000
2011,4,WA86,Schienenfahrzeuge,289470000,133165000,422635000
2011,4,WA87,"Kraftfahrzeuge, Landfahrzeuge",14101582000,5883350000,19984932000
2011,4,WA88,"Luftfahrzeuge, Raumfahrzeuge",1708082000,944342000,2652424000
2011,4,WA89,Wasserfahrzeuge,284868000,735549000,1020417000
2011,4,WA90,"Optische, photografische usw. Erzeugnisse",3643061000,2030250000,5673311000
2011,4,WA91,Uhrmacherwaren,112247000,124198000,236445000
2011,4,WA92,Musikinstrumente,34635000,34735000,69370000
2011,4,WA93,Waffen und Munition,32893000,12505000,45398000
2011,4,WA94,"Möbel, Beleuchtungskörper usw.",1047051000,1113156000,2160207000
2011,4,WA95,"Spielzeug, Spiele usw., Sportgeräte",294596000,422427000,717023000
2011,4,WA96,Verschiedene Waren,162091000,113797000,275888000
2011,4,WA97,"Kunstgegenstände, Sammlungsstücke",60046000,37210000,97256000
2011,4,WA98,Vollständige Fabrikationsanlagen,234071000,432000,234503000
2011,4,WA99,Zusammenstellungen verschiedener Waren,1197392000,904814000,2102206000
2011,5,WA01,Lebende Tiere,102712000,136530000,239242000
2011,5,WA02,Fleisch,616594000,493778000,1110372000
2011,5,WA03,"Fische, Krebs- und Weichtiere",95488000,249331000,344819000
2011,5,WA04,"Milch, Milcherzeugnisse, Eier, Honig",637460000,487597000,1125057000
2011,5,WA05,Andere Waren tierischen Ursprungs,55096000,67433000,122529000
2011,5,WA06,"Pflanzen, Waren des Blumenhandels",83453000,326619000,410072000
2011,5,WA07,"Gemüse, Pflanzen für Ernährung",89508000,439188000,528696000
2011,5,WA08,Genießbare Früchte und Nüsse,108245000,535315000,643560000
2011,5,WA09,"Kaffee, Tee, Mate, Gewürze",172798000,395157000,567955000
2011,5,WA10,Getreide,201331000,180715000,382046000
2011,5,WA11,"Müllereierzeugnisse, Malz usw.",85708000,45181000,130889000
2011,5,WA12,"Ölsamen usw., Heilpflanzen usw.",67816000,341320000,409136000
2011,5,WA13,"Schellack, Gummen, Harz, Pflanzensaft",40828000,38565000,79393000
2011,5,WA14,Flechtstoffe usw. pflanzlichen Ursprungs,1020000,2617000,3637000
2011,5,WA15,"Tierische und pflanzliche Fette, Öle, Wachs",199673000,420989000,620662000
2011,5,WA16,"Zubereitungen von Fleisch, Fisch usw.",203953000,172119000,376072000
2011,5,WA17,Zucker und Zuckerwaren,142127000,118921000,261048000
2011,5,WA18,Kakao und Zubereitungen aus Kakao,199968000,216375000,416343000
2011,5,WA19,"Zubereitungen aus Getreide usw., Backwaren",354514000,214441000,568955000
2011,5,WA20,"Zubereitungen von Gemüse, Früchten usw.",170374000,349501000,519875000
2011,5,WA21,Verschiedene Lebensmittelzubereitungen,349062000,201982000,551044000
2011,5,WA22,"Getränke, alkoholhaltige Flüssigkeiten, Essig",440029000,531510000,971539000
2011,5,WA23,"Rückstände der Lebensmittelindustrie, Futter",227997000,278882000,506879000
2011,5,WA24,Tabak,369923000,150562000,520485000
2011,5,WA25,"Salz, Schwefel, Steine, Erden usw.",188565000,162891000,351456000
2011,5,WA26,"Erze, Schlacken, Aschen",30832000,822122000,852954000
2011,5,WA27,Mineralische Brennstoffe usw.,2096030000,9688930000,11784960000
2011,5,WA28,Anorganische chemische Erzeugnisse,733213000,560352000,1293565000
2011,5,WA29,Organische chemische Erzeugnisse,1998092000,2048385000,4046477000
2011,5,WA30,Pharmazeutische Erzeugnisse,4287119000,3198557000,7485676000
2011,5,WA31,Düngemittel,175943000,144225000,320168000
2011,5,WA32,"Gerb- und Farbstoffe, Farben, Lacke usw.",838993000,432957000,1271950000
2011,5,WA33,"Etherische Öle, Riech-, Schönheitsmittel",647234000,369533000,1016767000
2011,5,WA34,"Seifen, Waschmittel usw.",505149000,266077000,771226000
2011,5,WA35,"Eiweißstoffe, Klebstoffe, Enzyme",224556000,156760000,381316000
2011,5,WA36,"Sprengstoffe, pyrotechnische Artikel usw.",18840000,15890000,34730000
2011,5,WA37,Photochemische Erzeugnisse,87914000,65246000,153160000
2011,5,WA38,Verschiedene Erzeugnisse der Chemischen Industrie,1556395000,1115379000,2671774000
2011,5,WA39,Kunststoffe und Waren daraus,4525498000,2821209000,7346707000
2011,5,WA40,Kautschuk und Waren daraus,1192380000,1232062000,2424442000
2011,5,WA41,"Häute, Felle, Leder",88221000,91700000,179921000
2011,5,WA42,"Lederwaren, Sattlerwaren",117436000,234031000,351467000
2011,5,WA43,"Pelzfelle, künstliches Pelzwerk",11377000,16804000,28181000
2011,5,WA44,"Holz, Holzwaren, Holzkohle",609392000,577352000,1186744000
2011,5,WA45,"Kork, Korkwaren",3714000,8953000,12667000
2011,5,WA46,"Flechtwaren, Korbmacherwaren",3172000,10906000,14078000
2011,5,WA47,"Halbstoffe aus Holz usw., Papierabfall",116637000,339200000,455837000
2011,5,WA48,"Papier, Pappe und Waren daraus",1638645000,1018753000,2657398000
2011,5,WA49,"Bücher, Zeitungen, Bilddrucke usw.",331609000,174148000,505757000
2011,5,WA50,Seide,7206000,7971000,15177000
2011,5,WA51,"Wolle, feine und grobe Tierhaare",77677000,95639000,173316000
2011,5,WA52,Baumwolle,111565000,121938000,233503000
2011,5,WA53,"Andere pflanzliche Spinnstoffe, Papiergarn",3419000,6627000,10046000
2011,5,WA54,Synthetisches oder künstliches Filament,190682000,136350000,327032000
2011,5,WA55,Synthetische oder künstliche Spinnfaser,188819000,149642000,338461000
2011,5,WA56,"Watte, Filz, Vliesstoff usw., Tauwerk",191267000,110214000,301481000
2011,5,WA57,"Teppiche, Fußbodenbelag aus Spinnstoff",43774000,76670000,120444000
2011,5,WA58,"Spezialgewebe, Spitzen, Tapisserien",47471000,30388000,77859000
2011,5,WA59,"Getränkte, bestrichene usw. Gewebe",174799000,94636000,269435000
2011,5,WA60,Gewirke und Gestricke,88873000,44830000,133703000
2011,5,WA61,"Bekleidung usw. aus Gewirken, Gestricken",438073000,957984000,1396057000
2011,5,WA62,"Andere Bekleidung, Bekleidungszubehör",478951000,999568000,1478519000
2011,5,WA63,"Andere Konfektion, Spinnstoffwaren usw.",182965000,306513000,489478000
2011,5,WA64,"Schuhe, Gamaschen, ähnliche Waren",242127000,492828000,734955000
2011,5,WA65,Kopfbedeckungen und Teile davon,19240000,32295000,51535000
2011,5,WA66,"Schirme, Gehstöcke usw., Peitschen",7868000,20096000,27964000
2011,5,WA67,"Zugerichtete Federn, Daunen, künstliche Blumen",5048000,10385000,15433000
2011,5,WA68,"Waren aus Steinen, Gips, Zement usw.",339464000,227716000,567180000
2011,5,WA69,Keramische Waren,257913000,190815000,448728000
2011,5,WA70,Glas und Glaswaren,465072000,357516000,822588000
2011,5,WA71,"Perlen, Edelsteine, Edelmetalle",1314583000,1279692000,2594275000
2011,5,WA72,Eisen und Stahl,2292124000,2490579000,4782703000
2011,5,WA73,Waren aus Eisen oder Stahl,2234227000,1537527000,3771754000
2011,5,WA74,Kupfer und Waren daraus,1058475000,1041390000,2099865000
2011,5,WA75,Nickel und Waren daraus,81086000,228863000,309949000
2011,5,WA76,Aluminium und Waren daraus,1197055000,1272173000,2469228000
2011,5,WA78,Blei und Waren daraus,44056000,38694000,82750000
2011,5,WA79,Zink und Waren daraus,58606000,100429000,159035000
2011,5,WA80,Zinn und Waren daraus,14255000,38576000,52831000
2011,5,WA81,"Andere unedle Metalle, Cermets usw.",121754000,143838000,265592000
2011,5,WA82,"Werkzeuge, Schneidwaren, Essbestecke",532134000,345185000,877319000
2011,5,WA83,Verschiedene Waren aus unedlen Metallen,568278000,353101000,921379000
2011,5,WA84,"Maschinen, Apparate, mechanische Geräte",16300796000,9295756000,25596552000
2011,5,WA85,Elektrotechnische Erzeugnisse,9130811000,8461204000,17592015000
2011,5,WA86,Schienenfahrzeuge,317731000,149486000,467217000
2011,5,WA87,"Kraftfahrzeuge, Landfahrzeuge",16292782000,6344300000,22637082000
2011,5,WA88,"Luftfahrzeuge, Raumfahrzeuge",2254552000,1758389000,4012941000
2011,5,WA89,Wasserfahrzeuge,270813000,779392000,1050205000
2011,5,WA90,"Optische, photografische usw. Erzeugnisse",4016570000,2216183000,6232753000
2011,5,WA91,Uhrmacherwaren,128153000,147404000,275557000
2011,5,WA92,Musikinstrumente,43523000,40381000,83904000
2011,5,WA93,Waffen und Munition,36922000,17209000,54131000
2011,5,WA94,"Möbel, Beleuchtungskörper usw.",1140768000,1187048000,2327816000
2011,5,WA95,"Spielzeug, Spiele usw., Sportgeräte",351924000,428518000,780442000
2011,5,WA96,Verschiedene Waren,178760000,122961000,301721000
2011,5,WA97,"Kunstgegenstände, Sammlungsstücke",53399000,31171000,84570000
2011,5,WA98,Vollständige Fabrikationsanlagen,233996000,17285000,251281000
2011,5,WA99,Zusammenstellungen verschiedener Waren,1478913000,1214172000,2693085000
2011,6,WA01,Lebende Tiere,106145000,136847000,242992000
2011,6,WA02,Fleisch,611133000,478849000,1089982000
2011,6,WA03,"Fische, Krebs- und Weichtiere",104288000,239757000,344045000
2011,6,WA04,"Milch, Milcherzeugnisse, Eier, Honig",699251000,547444000,1246695000
2011,6,WA05,Andere Waren tierischen Ursprungs,65648000,72135000,137783000
2011,6,WA06,"Pflanzen, Waren des Blumenhandels",55632000,235594000,291226000
2011,6,WA07,"Gemüse, Pflanzen für Ernährung",70218000,353100000,423318000
2011,6,WA08,Genießbare Früchte und Nüsse,112334000,596172000,708506000
2011,6,WA09,"Kaffee, Tee, Mate, Gewürze",229059000,402816000,631875000
2011,6,WA10,Getreide,189239000,160660000,349899000
2011,6,WA11,"Müllereierzeugnisse, Malz usw.",83952000,45855000,129807000
2011,6,WA12,"Ölsamen usw., Heilpflanzen usw.",70900000,259999000,330899000
2011,6,WA13,"Schellack, Gummen, Harz, Pflanzensaft",36391000,33265000,69656000
2011,6,WA14,Flechtstoffe usw. pflanzlichen Ursprungs,1377000,3204000,4581000
2011,6,WA15,"Tierische und pflanzliche Fette, Öle, Wachs",215481000,372888000,588369000
2011,6,WA16,"Zubereitungen von Fleisch, Fisch usw.",210370000,177090000,387460000
2011,6,WA17,Zucker und Zuckerwaren,124454000,112322000,236776000
2011,6,WA18,Kakao und Zubereitungen aus Kakao,255607000,248413000,504020000
2011,6,WA19,"Zubereitungen aus Getreide usw., Backwaren",361863000,224033000,585896000
2011,6,WA20,"Zubereitungen von Gemüse, Früchten usw.",182027000,341884000,523911000
2011,6,WA21,Verschiedene Lebensmittelzubereitungen,380313000,194108000,574421000
2011,6,WA22,"Getränke, alkoholhaltige Flüssigkeiten, Essig",437042000,519843000,956885000
2011,6,WA23,"Rückstände der Lebensmittelindustrie, Futter",220457000,239116000,459573000
2011,6,WA24,Tabak,316097000,147884000,463981000
2011,6,WA25,"Salz, Schwefel, Steine, Erden usw.",194617000,186622000,381239000
2011,6,WA26,"Erze, Schlacken, Aschen",25892000,1000614000,1026506000
2011,6,WA27,Mineralische Brennstoffe usw.,2125339000,8743164000,10868503000
2011,6,WA28,Anorganische chemische Erzeugnisse,663452000,569747000,1233199000
2011,6,WA29,Organische chemische Erzeugnisse,1940393000,2177764000,4118157000
2011,6,WA30,Pharmazeutische Erzeugnisse,4151873000,2770873000,6922746000
2011,6,WA31,Düngemittel,204667000,142217000,346884000
2011,6,WA32,"Gerb- und Farbstoffe, Farben, Lacke usw.",803591000,420842000,1224433000
2011,6,WA33,"Etherische Öle, Riech-, Schönheitsmittel",591556000,358966000,950522000
2011,6,WA34,"Seifen, Waschmittel usw.",485379000,253438000,738817000
2011,6,WA35,"Eiweißstoffe, Klebstoffe, Enzyme",222151000,162303000,384454000
2011,6,WA36,"Sprengstoffe, pyrotechnische Artikel usw.",12234000,15254000,27488000
2011,6,WA37,Photochemische Erzeugnisse,82610000,61966000,144576000
2011,6,WA38,Verschiedene Erzeugnisse der Chemischen Industrie,1579658000,1036943000,2616601000
2011,6,WA39,Kunststoffe und Waren daraus,4378587000,2769200000,7147787000
2011,6,WA40,Kautschuk und Waren daraus,1144886000,1224108000,2368994000
2011,6,WA41,"Häute, Felle, Leder",93674000,87780000,181454000
2011,6,WA42,"Lederwaren, Sattlerwaren",114765000,262724000,377489000
2011,6,WA43,"Pelzfelle, künstliches Pelzwerk",17271000,19083000,36354000
2011,6,WA44,"Holz, Holzwaren, Holzkohle",588578000,589533000,1178111000
2011,6,WA45,"Kork, Korkwaren",2462000,5860000,8322000
2011,6,WA46,"Flechtwaren, Korbmacherwaren",3537000,10764000,14301000
2011,6,WA47,"Halbstoffe aus Holz usw., Papierabfall",108674000,361239000,469913000
2011,6,WA48,"Papier, Pappe und Waren daraus",1571763000,1012393000,2584156000
2011,6,WA49,"Bücher, Zeitungen, Bilddrucke usw.",327622000,152721000,480343000
2011,6,WA50,Seide,5058000,6274000,11332000
2011,6,WA51,"Wolle, feine und grobe Tierhaare",72002000,77022000,149024000
2011,6,WA52,Baumwolle,94608000,109996000,204604000
2011,6,WA53,"Andere pflanzliche Spinnstoffe, Papiergarn",3055000,5997000,9052000
2011,6,WA54,Synthetisches oder künstliches Filament,169752000,129408000,299160000
2011,6,WA55,Synthetische oder künstliche Spinnfaser,165269000,148520000,313789000
2011,6,WA56,"Watte, Filz, Vliesstoff usw., Tauwerk",184518000,95557000,280075000
2011,6,WA57,"Teppiche, Fußbodenbelag aus Spinnstoff",41726000,84082000,125808000
2011,6,WA58,"Spezialgewebe, Spitzen, Tapisserien",41593000,29428000,71021000
2011,6,WA59,"Getränkte, bestrichene usw. Gewebe",164090000,94815000,258905000
2011,6,WA60,Gewirke und Gestricke,79759000,45085000,124844000
2011,6,WA61,"Bekleidung usw. aus Gewirken, Gestricken",456197000,1087603000,1543800000
2011,6,WA62,"Andere Bekleidung, Bekleidungszubehör",458573000,1084031000,1542604000
2011,6,WA63,"Andere Konfektion, Spinnstoffwaren usw.",171375000,298037000,469412000
2011,6,WA64,"Schuhe, Gamaschen, ähnliche Waren",259916000,515986000,775902000
2011,6,WA65,Kopfbedeckungen und Teile davon,15895000,30930000,46825000
2011,6,WA66,"Schirme, Gehstöcke usw., Peitschen",6545000,13013000,19558000
2011,6,WA67,"Zugerichtete Federn, Daunen, künstliche Blumen",6208000,13275000,19483000
2011,6,WA68,"Waren aus Steinen, Gips, Zement usw.",318346000,233319000,551665000
2011,6,WA69,Keramische Waren,249512000,193434000,442946000
2011,6,WA70,Glas und Glaswaren,440409000,350169000,790578000
2011,6,WA71,"Perlen, Edelsteine, Edelmetalle",1058866000,1377883000,2436749000
2011,6,WA72,Eisen und Stahl,2330614000,2618625000,4949239000
2011,6,WA73,Waren aus Eisen oder Stahl,2078366000,1521332000,3599698000
2011,6,WA74,Kupfer und Waren daraus,975406000,932939000,1908345000
2011,6,WA75,Nickel und Waren daraus,89365000,148217000,237582000
2011,6,WA76,Aluminium und Waren daraus,1139008000,1249577000,2388585000
2011,6,WA78,Blei und Waren daraus,39902000,26962000,66864000
2011,6,WA79,Zink und Waren daraus,57401000,98409000,155810000
2011,6,WA80,Zinn und Waren daraus,12824000,38276000,51100000
2011,6,WA81,"Andere unedle Metalle, Cermets usw.",107301000,123891000,231192000
2011,6,WA82,"Werkzeuge, Schneidwaren, Essbestecke",542430000,360586000,903016000
2011,6,WA83,Verschiedene Waren aus unedlen Metallen,546016000,330318000,876334000
2011,6,WA84,"Maschinen, Apparate, mechanische Geräte",15553332000,8921489000,24474821000
2011,6,WA85,Elektrotechnische Erzeugnisse,8801522000,8198203000,16999725000
2011,6,WA86,Schienenfahrzeuge,314233000,115256000,429489000
2011,6,WA87,"Kraftfahrzeuge, Landfahrzeuge",14093632000,6258726000,20352358000
2011,6,WA88,"Luftfahrzeuge, Raumfahrzeuge",2317803000,2451640000,4769443000
2011,6,WA89,Wasserfahrzeuge,760768000,396382000,1157150000
2011,6,WA90,"Optische, photografische usw. Erzeugnisse",3801884000,2113715000,5915599000
2011,6,WA91,Uhrmacherwaren,126590000,143175000,269765000
2011,6,WA92,Musikinstrumente,37598000,43849000,81447000
2011,6,WA93,Waffen und Munition,32791000,15765000,48556000
2011,6,WA94,"Möbel, Beleuchtungskörper usw.",1071855000,1083906000,2155761000
2011,6,WA95,"Spielzeug, Spiele usw., Sportgeräte",308244000,379999000,688243000
2011,6,WA96,Verschiedene Waren,168700000,121400000,290100000
2011,6,WA97,"Kunstgegenstände, Sammlungsstücke",154817000,33669000,188486000
2011,6,WA98,Vollständige Fabrikationsanlagen,254113000,1747000,255860000
2011,6,WA99,Zusammenstellungen verschiedener Waren,1329887000,899500000,2229387000
2011,7,WA01,Lebende Tiere,95110000,129067000,224177000
2011,7,WA02,Fleisch,607422000,437733000,1045155000
2011,7,WA03,"Fische, Krebs- und Weichtiere",95636000,216041000,311677000
2011,7,WA04,"Milch, Milcherzeugnisse, Eier, Honig",598430000,468542000,1066972000
2011,7,WA05,Andere Waren tierischen Ursprungs,57825000,69448000,127273000
2011,7,WA06,"Pflanzen, Waren des Blumenhandels",37447000,182022000,219469000
2011,7,WA07,"Gemüse, Pflanzen für Ernährung",66382000,278654000,345036000
2011,7,WA08,Genießbare Früchte und Nüsse,106435000,567665000,674100000
2011,7,WA09,"Kaffee, Tee, Mate, Gewürze",173064000,359839000,532903000
2011,7,WA10,Getreide,134107000,150924000,285031000
2011,7,WA11,"Müllereierzeugnisse, Malz usw.",71057000,43665000,114722000
2011,7,WA12,"Ölsamen usw., Heilpflanzen usw.",69121000,262534000,331655000
2011,7,WA13,"Schellack, Gummen, Harz, Pflanzensaft",39529000,35283000,74812000
2011,7,WA14,Flechtstoffe usw. pflanzlichen Ursprungs,862000,2140000,3002000
2011,7,WA15,"Tierische und pflanzliche Fette, Öle, Wachs",198427000,340124000,538551000
2011,7,WA16,"Zubereitungen von Fleisch, Fisch usw.",197437000,157772000,355209000
2011,7,WA17,Zucker und Zuckerwaren,117245000,122578000,239823000
2011,7,WA18,Kakao und Zubereitungen aus Kakao,210112000,235359000,445471000
2011,7,WA19,"Zubereitungen aus Getreide usw., Backwaren",344663000,222764000,567427000
2011,7,WA20,"Zubereitungen von Gemüse, Früchten usw.",160044000,328140000,488184000
2011,7,WA21,Verschiedene Lebensmittelzubereitungen,336728000,166777000,503505000
2011,7,WA22,"Getränke, alkoholhaltige Flüssigkeiten, Essig",397629000,547511000,945140000
2011,7,WA23,"Rückstände der Lebensmittelindustrie, Futter",235244000,271376000,506620000
2011,7,WA24,Tabak,335230000,158748000,493978000
2011,7,WA25,"Salz, Schwefel, Steine, Erden usw.",187674000,172543000,360217000
2011,7,WA26,"Erze, Schlacken, Aschen",29139000,812228000,841367000
2011,7,WA27,Mineralische Brennstoffe usw.,2207994000,11149155000,13357149000
2011,7,WA28,Anorganische chemische Erzeugnisse,655781000,627912000,1283693000
2011,7,WA29,Organische chemische Erzeugnisse,1848592000,2194304000,4042896000
2011,7,WA30,Pharmazeutische Erzeugnisse,3881046000,2860937000,6741983000
2011,7,WA31,Düngemittel,213500000,122834000,336334000
2011,7,WA32,"Gerb- und Farbstoffe, Farben, Lacke usw.",803806000,412898000,1216704000
2011,7,WA33,"Etherische Öle, Riech-, Schönheitsmittel",653970000,378331000,1032301000
2011,7,WA34,"Seifen, Waschmittel usw.",475611000,233524000,709135000
2011,7,WA35,"Eiweißstoffe, Klebstoffe, Enzyme",208574000,151510000,360084000
2011,7,WA36,"Sprengstoffe, pyrotechnische Artikel usw.",14599000,14705000,29304000
2011,7,WA37,Photochemische Erzeugnisse,89256000,64385000,153641000
2011,7,WA38,Verschiedene Erzeugnisse der Chemischen Industrie,1452001000,982666000,2434667000
2011,7,WA39,Kunststoffe und Waren daraus,4092792000,2618867000,6711659000
2011,7,WA40,Kautschuk und Waren daraus,1132823000,1208696000,2341519000
2011,7,WA41,"Häute, Felle, Leder",74012000,71859000,145871000
2011,7,WA42,"Lederwaren, Sattlerwaren",139122000,258189000,397311000
2011,7,WA43,"Pelzfelle, künstliches Pelzwerk",21321000,21933000,43254000
2011,7,WA44,"Holz, Holzwaren, Holzkohle",559566000,512758000,1072324000
2011,7,WA45,"Kork, Korkwaren",3145000,10915000,14060000
2011,7,WA46,"Flechtwaren, Korbmacherwaren",3496000,10130000,13626000
2011,7,WA47,"Halbstoffe aus Holz usw., Papierabfall",103431000,318521000,421952000
2011,7,WA48,"Papier, Pappe und Waren daraus",1542313000,968978000,2511291000
2011,7,WA49,"Bücher, Zeitungen, Bilddrucke usw.",325949000,152743000,478692000
2011,7,WA50,Seide,5045000,5763000,10808000
2011,7,WA51,"Wolle, feine und grobe Tierhaare",62330000,73714000,136044000
2011,7,WA52,Baumwolle,82455000,91935000,174390000
2011,7,WA53,"Andere pflanzliche Spinnstoffe, Papiergarn",2773000,5735000,8508000
2011,7,WA54,Synthetisches oder künstliches Filament,156357000,117013000,273370000
2011,7,WA55,Synthetische oder künstliche Spinnfaser,149440000,133737000,283177000
2011,7,WA56,"Watte, Filz, Vliesstoff usw., Tauwerk",178684000,108315000,286999000
2011,7,WA57,"Teppiche, Fußbodenbelag aus Spinnstoff",41508000,78749000,120257000
2011,7,WA58,"Spezialgewebe, Spitzen, Tapisserien",40875000,27971000,68846000
2011,7,WA59,"Getränkte, bestrichene usw. Gewebe",162790000,96183000,258973000
2011,7,WA60,Gewirke und Gestricke,71494000,37696000,109190000
2011,7,WA61,"Bekleidung usw. aus Gewirken, Gestricken",552512000,1262124000,1814636000
2011,7,WA62,"Andere Bekleidung, Bekleidungszubehör",610448000,1267663000,1878111000
2011,7,WA63,"Andere Konfektion, Spinnstoffwaren usw.",168653000,298518000,467171000
2011,7,WA64,"Schuhe, Gamaschen, ähnliche Waren",330908000,666395000,997303000
2011,7,WA65,Kopfbedeckungen und Teile davon,24640000,38794000,63434000
2011,7,WA66,"Schirme, Gehstöcke usw., Peitschen",5860000,10521000,16381000
2011,7,WA67,"Zugerichtete Federn, Daunen, künstliche Blumen",6742000,14494000,21236000
2011,7,WA68,"Waren aus Steinen, Gips, Zement usw.",314605000,225195000,539800000
2011,7,WA69,Keramische Waren,245531000,182653000,428184000
2011,7,WA70,Glas und Glaswaren,428457000,333682000,762139000
2011,7,WA71,"Perlen, Edelsteine, Edelmetalle",1168043000,1518500000,2686543000
2011,7,WA72,Eisen und Stahl,2059009000,2426105000,4485114000
2011,7,WA73,Waren aus Eisen oder Stahl,2046874000,1474307000,3521181000
2011,7,WA74,Kupfer und Waren daraus,1001873000,1065111000,2066984000
2011,7,WA75,Nickel und Waren daraus,86290000,194853000,281143000
2011,7,WA76,Aluminium und Waren daraus,1091783000,1219174000,2310957000
2011,7,WA78,Blei und Waren daraus,39026000,32927000,71953000
2011,7,WA79,Zink und Waren daraus,57467000,107525000,164992000
2011,7,WA80,Zinn und Waren daraus,11340000,48933000,60273000
2011,7,WA81,"Andere unedle Metalle, Cermets usw.",101846000,124608000,226454000
2011,7,WA82,"Werkzeuge, Schneidwaren, Essbestecke",530287000,339165000,869452000
2011,7,WA83,Verschiedene Waren aus unedlen Metallen,526888000,311022000,837910000
2011,7,WA84,"Maschinen, Apparate, mechanische Geräte",15762433000,8988233000,24750666000
2011,7,WA85,Elektrotechnische Erzeugnisse,8634178000,7795701000,16429879000
2011,7,WA86,Schienenfahrzeuge,250321000,136957000,387278000
2011,7,WA87,"Kraftfahrzeuge, Landfahrzeuge",14460270000,5736280000,20196550000
2011,7,WA88,"Luftfahrzeuge, Raumfahrzeuge",1464080000,890218000,2354298000
2011,7,WA89,Wasserfahrzeuge,280843000,775748000,1056591000
2011,7,WA90,"Optische, photografische usw. Erzeugnisse",3778184000,2091604000,5869788000
2011,7,WA91,Uhrmacherwaren,137187000,149629000,286816000
2011,7,WA92,Musikinstrumente,37483000,32484000,69967000
2011,7,WA93,Waffen und Munition,39060000,18538000,57598000
2011,7,WA94,"Möbel, Beleuchtungskörper usw.",1072011000,990292000,2062303000
2011,7,WA95,"Spielzeug, Spiele usw., Sportgeräte",294986000,331911000,626897000
2011,7,WA96,Verschiedene Waren,160453000,119809000,280262000
2011,7,WA97,"Kunstgegenstände, Sammlungsstücke",47205000,29953000,77158000
2011,7,WA98,Vollständige Fabrikationsanlagen,208054000,1221000,209275000
2011,7,WA99,Zusammenstellungen verschiedener Waren,1177419000,902995000,2080414000
2011,8,WA01,Lebende Tiere,106852000,121538000,228390000
2011,8,WA02,Fleisch,620777000,467981000,1088758000
2011,8,WA03,"Fische, Krebs- und Weichtiere",91755000,222262000,314017000
2011,8,WA04,"Milch, Milcherzeugnisse, Eier, Honig",698200000,530040000,1228240000
2011,8,WA05,Andere Waren tierischen Ursprungs,60133000,72782000,132915000
2011,8,WA06,"Pflanzen, Waren des Blumenhandels",49161000,191773000,240934000
2011,8,WA07,"Gemüse, Pflanzen für Ernährung",62467000,280329000,342796000
2011,8,WA08,Genießbare Früchte und Nüsse,99282000,529722000,629004000
2011,8,WA09,"Kaffee, Tee, Mate, Gewürze",195052000,391992000,587044000
2011,8,WA10,Getreide,112073000,187951000,300024000
2011,8,WA11,"Müllereierzeugnisse, Malz usw.",73116000,42998000,116114000
2011,8,WA12,"Ölsamen usw., Heilpflanzen usw.",85959000,417041000,503000000
2011,8,WA13,"Schellack, Gummen, Harz, Pflanzensaft",34998000,30983000,65981000
2011,8,WA14,Flechtstoffe usw. pflanzlichen Ursprungs,769000,2003000,2772000
2011,8,WA15,"Tierische und pflanzliche Fette, Öle, Wachs",199922000,416500000,616422000
2011,8,WA16,"Zubereitungen von Fleisch, Fisch usw.",205316000,178269000,383585000
2011,8,WA17,Zucker und Zuckerwaren,116154000,137917000,254071000
2011,8,WA18,Kakao und Zubereitungen aus Kakao,307653000,293369000,601022000
2011,8,WA19,"Zubereitungen aus Getreide usw., Backwaren",402732000,211971000,614703000
2011,8,WA20,"Zubereitungen von Gemüse, Früchten usw.",168839000,339012000,507851000
2011,8,WA21,Verschiedene Lebensmittelzubereitungen,344578000,196278000,540856000
2011,8,WA22,"Getränke, alkoholhaltige Flüssigkeiten, Essig",402179000,498373000,900552000
2011,8,WA23,"Rückstände der Lebensmittelindustrie, Futter",239721000,234101000,473822000
2011,8,WA24,Tabak,360645000,160339000,520984000
2011,8,WA25,"Salz, Schwefel, Steine, Erden usw.",179725000,168941000,348666000
2011,8,WA26,"Erze, Schlacken, Aschen",25768000,772315000,798083000
2011,8,WA27,Mineralische Brennstoffe usw.,1903606000,9879529000,11783135000
2011,8,WA28,Anorganische chemische Erzeugnisse,782216000,614052000,1396268000
2011,8,WA29,Organische chemische Erzeugnisse,1905460000,2239909000,4145369000
2011,8,WA30,Pharmazeutische Erzeugnisse,4189711000,3004955000,7194666000
2011,8,WA31,Düngemittel,183630000,137675000,321305000
2011,8,WA32,"Gerb- und Farbstoffe, Farben, Lacke usw.",762777000,393092000,1155869000
2011,8,WA33,"Etherische Öle, Riech-, Schönheitsmittel",669648000,439501000,1109149000
2011,8,WA34,"Seifen, Waschmittel usw.",485689000,274712000,760401000
2011,8,WA35,"Eiweißstoffe, Klebstoffe, Enzyme",210393000,159127000,369520000
2011,8,WA36,"Sprengstoffe, pyrotechnische Artikel usw.",15094000,22880000,37974000
2011,8,WA37,Photochemische Erzeugnisse,75532000,54522000,130054000
2011,8,WA38,Verschiedene Erzeugnisse der Chemischen Industrie,1404234000,987500000,2391734000
2011,8,WA39,Kunststoffe und Waren daraus,3963935000,2589975000,6553910000
2011,8,WA40,Kautschuk und Waren daraus,1178360000,1231212000,2409572000
2011,8,WA41,"Häute, Felle, Leder",72122000,65747000,137869000
2011,8,WA42,"Lederwaren, Sattlerwaren",147736000,285989000,433725000
2011,8,WA43,"Pelzfelle, künstliches Pelzwerk",21799000,21483000,43282000
2011,8,WA44,"Holz, Holzwaren, Holzkohle",534948000,518609000,1053557000
2011,8,WA45,"Kork, Korkwaren",2814000,5106000,7920000
2011,8,WA46,"Flechtwaren, Korbmacherwaren",3823000,12414000,16237000
2011,8,WA47,"Halbstoffe aus Holz usw., Papierabfall",104799000,339583000,444382000
2011,8,WA48,"Papier, Pappe und Waren daraus",1575852000,1001105000,2576957000
2011,8,WA49,"Bücher, Zeitungen, Bilddrucke usw.",352086000,173607000,525693000
2011,8,WA50,Seide,3389000,3874000,7263000
2011,8,WA51,"Wolle, feine und grobe Tierhaare",43319000,59672000,102991000
2011,8,WA52,Baumwolle,72801000,75070000,147871000
2011,8,WA53,"Andere pflanzliche Spinnstoffe, Papiergarn",2752000,6469000,9221000
2011,8,WA54,Synthetisches oder künstliches Filament,150316000,111027000,261343000
2011,8,WA55,Synthetische oder künstliche Spinnfaser,143163000,114830000,257993000
2011,8,WA56,"Watte, Filz, Vliesstoff usw., Tauwerk",174323000,99322000,273645000
2011,8,WA57,"Teppiche, Fußbodenbelag aus Spinnstoff",41037000,77425000,118462000
2011,8,WA58,"Spezialgewebe, Spitzen, Tapisserien",36787000,22229000,59016000
2011,8,WA59,"Getränkte, bestrichene usw. Gewebe",152042000,84820000,236862000
2011,8,WA60,Gewirke und Gestricke,55703000,31373000,87076000
2011,8,WA61,"Bekleidung usw. aus Gewirken, Gestricken",708798000,1478796000,2187594000
2011,8,WA62,"Andere Bekleidung, Bekleidungszubehör",805201000,1524701000,2329902000
2011,8,WA63,"Andere Konfektion, Spinnstoffwaren usw.",175217000,279549000,454766000
2011,8,WA64,"Schuhe, Gamaschen, ähnliche Waren",437334000,774337000,1211671000
2011,8,WA65,Kopfbedeckungen und Teile davon,27433000,46689000,74122000
2011,8,WA66,"Schirme, Gehstöcke usw., Peitschen",7546000,13973000,21519000
2011,8,WA67,"Zugerichtete Federn, Daunen, künstliche Blumen",9084000,18448000,27532000
2011,8,WA68,"Waren aus Steinen, Gips, Zement usw.",280447000,216336000,496783000
2011,8,WA69,Keramische Waren,230203000,185044000,415247000
2011,8,WA70,Glas und Glaswaren,413926000,318602000,732528000
2011,8,WA71,"Perlen, Edelsteine, Edelmetalle",1558625000,1853534000,3412159000
2011,8,WA72,Eisen und Stahl,1972951000,2082017000,4054968000
2011,8,WA73,Waren aus Eisen oder Stahl,2332654000,1415589000,3748243000
2011,8,WA74,Kupfer und Waren daraus,989333000,1005909000,1995242000
2011,8,WA75,Nickel und Waren daraus,89714000,147480000,237194000
2011,8,WA76,Aluminium und Waren daraus,1043060000,1199283000,2242343000
2011,8,WA78,Blei und Waren daraus,44914000,22362000,67276000
2011,8,WA79,Zink und Waren daraus,47084000,111131000,158215000
2011,8,WA80,Zinn und Waren daraus,9468000,39690000,49158000
2011,8,WA81,"Andere unedle Metalle, Cermets usw.",104869000,127052000,231921000
2011,8,WA82,"Werkzeuge, Schneidwaren, Essbestecke",498605000,339014000,837619000
2011,8,WA83,Verschiedene Waren aus unedlen Metallen,525456000,301673000,827129000
2011,8,WA84,"Maschinen, Apparate, mechanische Geräte",15251303000,8718004000,23969307000
2011,8,WA85,Elektrotechnische Erzeugnisse,8610106000,8022430000,16632536000
2011,8,WA86,Schienenfahrzeuge,202800000,120269000,323069000
2011,8,WA87,"Kraftfahrzeuge, Landfahrzeuge",13032512000,4643091000,17675603000
2011,8,WA88,"Luftfahrzeuge, Raumfahrzeuge",1958908000,1185017000,3143925000
2011,8,WA89,Wasserfahrzeuge,78699000,326014000,404713000
2011,8,WA90,"Optische, photografische usw. Erzeugnisse",3905329000,2080441000,5985770000
2011,8,WA91,Uhrmacherwaren,113544000,149444000,262988000
2011,8,WA92,Musikinstrumente,38342000,41827000,80169000
2011,8,WA93,Waffen und Munition,27827000,15322000,43149000
2011,8,WA94,"Möbel, Beleuchtungskörper usw.",1005672000,1063751000,2069423000
2011,8,WA95,"Spielzeug, Spiele usw., Sportgeräte",316128000,400314000,716442000
2011,8,WA96,Verschiedene Waren,156450000,115154000,271604000
2011,8,WA97,"Kunstgegenstände, Sammlungsstücke",41331000,19745000,61076000
2011,8,WA98,Vollständige Fabrikationsanlagen,390903000,1664000,392567000
2011,8,WA99,Zusammenstellungen verschiedener Waren,1147917000,876690000,2024607000
2011,9,WA01,Lebende Tiere,114344000,135014000,249358000
2011,9,WA02,Fleisch,707820000,515626000,1223446000
2011,9,WA03,"Fische, Krebs- und Weichtiere",105051000,247733000,352784000
2011,9,WA04,"Milch, Milcherzeugnisse, Eier, Honig",697997000,494840000,1192837000
2011,9,WA05,Andere Waren tierischen Ursprungs,52644000,66872000,119516000
2011,9,WA06,"Pflanzen, Waren des Blumenhandels",72614000,212646000,285260000
2011,9,WA07,"Gemüse, Pflanzen für Ernährung",64952000,282729000,347681000
2011,9,WA08,Genießbare Früchte und Nüsse,98621000,507125000,605746000
2011,9,WA09,"Kaffee, Tee, Mate, Gewürze",210240000,412078000,622318000
2011,9,WA10,Getreide,235528000,255935000,491463000
2011,9,WA11,"Müllereierzeugnisse, Malz usw.",100858000,45638000,146496000
2011,9,WA12,"Ölsamen usw., Heilpflanzen usw.",60909000,307118000,368027000
2011,9,WA13,"Schellack, Gummen, Harz, Pflanzensaft",36401000,33068000,69469000
2011,9,WA14,Flechtstoffe usw. pflanzlichen Ursprungs,1182000,2761000,3943000
2011,9,WA15,"Tierische und pflanzliche Fette, Öle, Wachs",209571000,331233000,540804000
2011,9,WA16,"Zubereitungen von Fleisch, Fisch usw.",206146000,187527000,393673000
2011,9,WA17,Zucker und Zuckerwaren,135784000,127797000,263581000
2011,9,WA18,Kakao und Zubereitungen aus Kakao,422726000,321475000,744201000
2011,9,WA19,"Zubereitungen aus Getreide usw., Backwaren",399545000,223754000,623299000
2011,9,WA20,"Zubereitungen von Gemüse, Früchten usw.",170895000,328812000,499707000
2011,9,WA21,Verschiedene Lebensmittelzubereitungen,346963000,173713000,520676000
2011,9,WA22,"Getränke, alkoholhaltige Flüssigkeiten, Essig",381367000,532644000,914011000
2011,9,WA23,"Rückstände der Lebensmittelindustrie, Futter",253380000,239195000,492575000
2011,9,WA24,Tabak,359772000,162131000,521903000
2011,9,WA25,"Salz, Schwefel, Steine, Erden usw.",192166000,173259000,365425000
2011,9,WA26,"Erze, Schlacken, Aschen",36167000,967970000,1004137000
2011,9,WA27,Mineralische Brennstoffe usw.,2254543000,9816480000,12071023000
2011,9,WA28,Anorganische chemische Erzeugnisse,774432000,567425000,1341857000
2011,9,WA29,Organische chemische Erzeugnisse,2066640000,2251975000,4318615000
2011,9,WA30,Pharmazeutische Erzeugnisse,4150869000,2865394000,7016263000
2011,9,WA31,Düngemittel,208114000,113313000,321427000
2011,9,WA32,"Gerb- und Farbstoffe, Farben, Lacke usw.",839467000,379879000,1219346000
2011,9,WA33,"Etherische Öle, Riech-, Schönheitsmittel",722325000,411169000,1133494000
2011,9,WA34,"Seifen, Waschmittel usw.",513373000,275291000,788664000
2011,9,WA35,"Eiweißstoffe, Klebstoffe, Enzyme",236881000,145875000,382756000
2011,9,WA36,"Sprengstoffe, pyrotechnische Artikel usw.",20444000,25183000,45627000
2011,9,WA37,Photochemische Erzeugnisse,87743000,67513000,155256000
2011,9,WA38,Verschiedene Erzeugnisse der Chemischen Industrie,1509039000,952157000,2461196000
2011,9,WA39,Kunststoffe und Waren daraus,4386002000,2628326000,7014328000
2011,9,WA40,Kautschuk und Waren daraus,1261799000,1275396000,2537195000
2011,9,WA41,"Häute, Felle, Leder",94485000,74913000,169398000
2011,9,WA42,"Lederwaren, Sattlerwaren",143313000,247606000,390919000
2011,9,WA43,"Pelzfelle, künstliches Pelzwerk",20853000,16917000,37770000
2011,9,WA44,"Holz, Holzwaren, Holzkohle",585526000,538325000,1123851000
2011,9,WA45,"Kork, Korkwaren",2521000,7474000,9995000
2011,9,WA46,"Flechtwaren, Korbmacherwaren",3369000,9003000,12372000
2011,9,WA47,"Halbstoffe aus Holz usw., Papierabfall",112661000,295240000,407901000
2011,9,WA48,"Papier, Pappe und Waren daraus",1572475000,1023729000,2596204000
2011,9,WA49,"Bücher, Zeitungen, Bilddrucke usw.",414082000,173062000,587144000
2011,9,WA50,Seide,7176000,5960000,13136000
2011,9,WA51,"Wolle, feine und grobe Tierhaare",59574000,70180000,129754000
2011,9,WA52,Baumwolle,96718000,87101000,183819000
2011,9,WA53,"Andere pflanzliche Spinnstoffe, Papiergarn",3766000,7332000,11098000
2011,9,WA54,Synthetisches oder künstliches Filament,175268000,124788000,300056000
2011,9,WA55,Synthetische oder künstliche Spinnfaser,165154000,125844000,290998000
2011,9,WA56,"Watte, Filz, Vliesstoff usw., Tauwerk",194193000,88231000,282424000
2011,9,WA57,"Teppiche, Fußbodenbelag aus Spinnstoff",43718000,86630000,130348000
2011,9,WA58,"Spezialgewebe, Spitzen, Tapisserien",44488000,28940000,73428000
2011,9,WA59,"Getränkte, bestrichene usw. Gewebe",174469000,90669000,265138000
2011,9,WA60,Gewirke und Gestricke,73778000,40499000,114277000
2011,9,WA61,"Bekleidung usw. aus Gewirken, Gestricken",666519000,1283578000,1950097000
2011,9,WA62,"Andere Bekleidung, Bekleidungszubehör",764183000,1337823000,2102006000
2011,9,WA63,"Andere Konfektion, Spinnstoffwaren usw.",180778000,288485000,469263000
2011,9,WA64,"Schuhe, Gamaschen, ähnliche Waren",406006000,678817000,1084823000
2011,9,WA65,Kopfbedeckungen und Teile davon,34208000,54716000,88924000
2011,9,WA66,"Schirme, Gehstöcke usw., Peitschen",7300000,12641000,19941000
2011,9,WA67,"Zugerichtete Federn, Daunen, künstliche Blumen",9405000,14225000,23630000
2011,9,WA68,"Waren aus Steinen, Gips, Zement usw.",371767000,228566000,600333000
2011,9,WA69,Keramische Waren,253645000,198221000,451866000
2011,9,WA70,Glas und Glaswaren,449706000,360405000,810111000
2011,9,WA71,"Perlen, Edelsteine, Edelmetalle",1903468000,1709174000,3612642000
2011,9,WA72,Eisen und Stahl,2247114000,2230969000,4478083000
2011,9,WA73,Waren aus Eisen oder Stahl,2151270000,1551887000,3703157000
2011,9,WA74,Kupfer und Waren daraus,1074611000,899172000,1973783000
2011,9,WA75,Nickel und Waren daraus,90441000,161808000,252249000
2011,9,WA76,Aluminium und Waren daraus,1098625000,1170334000,2268959000
2011,9,WA78,Blei und Waren daraus,45265000,35493000,80758000
2011,9,WA79,Zink und Waren daraus,55955000,92592000,148547000
2011,9,WA80,Zinn und Waren daraus,11491000,28581000,40072000
2011,9,WA81,"Andere unedle Metalle, Cermets usw.",110159000,136116000,246275000
2011,9,WA82,"Werkzeuge, Schneidwaren, Essbestecke",558383000,350951000,909334000
2011,9,WA83,Verschiedene Waren aus unedlen Metallen,577440000,330609000,908049000
2011,9,WA84,"Maschinen, Apparate, mechanische Geräte",16653780000,9431035000,26084815000
2011,9,WA85,Elektrotechnische Erzeugnisse,9317552000,8550371000,17867923000
2011,9,WA86,Schienenfahrzeuge,283381000,138936000,422317000
2011,9,WA87,"Kraftfahrzeuge, Landfahrzeuge",16305871000,6396376000,22702247000
2011,9,WA88,"Luftfahrzeuge, Raumfahrzeuge",2663691000,2019761000,4683452000
2011,9,WA89,Wasserfahrzeuge,151356000,308036000,459392000
2011,9,WA90,"Optische, photografische usw. Erzeugnisse",4098832000,2288223000,6387055000
2011,9,WA91,Uhrmacherwaren,141291000,164361000,305652000
2011,9,WA92,Musikinstrumente,53061000,51062000,104123000
2011,9,WA93,Waffen und Munition,34819000,15736000,50555000
2011,9,WA94,"Möbel, Beleuchtungskörper usw.",1205200000,1205956000,2411156000
2011,9,WA95,"Spielzeug, Spiele usw., Sportgeräte",465607000,578104000,1043711000
2011,9,WA96,Verschiedene Waren,167158000,118167000,285325000
2011,9,WA97,"Kunstgegenstände, Sammlungsstücke",46969000,33724000,80693000
2011,9,WA98,Vollständige Fabrikationsanlagen,275815000,1579000,277394000
2011,9,WA99,Zusammenstellungen verschiedener Waren,1338988000,987008000,2325996000
2011,10,WA01,Lebende Tiere,103651000,120646000,224297000
2011,10,WA02,Fleisch,676177000,548560000,1224737000
2011,10,WA03,"Fische, Krebs- und Weichtiere",108073000,261553000,369626000
2011,10,WA04,"Milch, Milcherzeugnisse, Eier, Honig",636589000,535118000,1171707000
2011,10,WA05,Andere Waren tierischen Ursprungs,60771000,66230000,127001000
2011,10,WA06,"Pflanzen, Waren des Blumenhandels",67694000,181843000,249537000
2011,10,WA07,"Gemüse, Pflanzen für Ernährung",55673000,279763000,335436000
2011,10,WA08,Genießbare Früchte und Nüsse,100111000,536061000,636172000
2011,10,WA09,"Kaffee, Tee, Mate, Gewürze",196896000,386854000,583750000
2011,10,WA10,Getreide,161857000,210263000,372120000
2011,10,WA11,"Müllereierzeugnisse, Malz usw.",89541000,42424000,131965000
2011,10,WA12,"Ölsamen usw., Heilpflanzen usw.",45614000,386719000,432333000
2011,10,WA13,"Schellack, Gummen, Harz, Pflanzensaft",31680000,32652000,64332000
2011,10,WA14,Flechtstoffe usw. pflanzlichen Ursprungs,1047000,2739000,3786000
2011,10,WA15,"Tierische und pflanzliche Fette, Öle, Wachs",222151000,334388000,556539000
2011,10,WA16,"Zubereitungen von Fleisch, Fisch usw.",202744000,192197000,394941000
2011,10,WA17,Zucker und Zuckerwaren,192142000,116161000,308303000
2011,10,WA18,Kakao und Zubereitungen aus Kakao,377861000,322296000,700157000
2011,10,WA19,"Zubereitungen aus Getreide usw., Backwaren",398206000,227237000,625443000
2011,10,WA20,"Zubereitungen von Gemüse, Früchten usw.",174739000,354270000,529009000
2011,10,WA21,Verschiedene Lebensmittelzubereitungen,325015000,179495000,504510000
2011,10,WA22,"Getränke, alkoholhaltige Flüssigkeiten, Essig",404816000,544070000,948886000
2011,10,WA23,"Rückstände der Lebensmittelindustrie, Futter",239391000,281708000,521099000
2011,10,WA24,Tabak,338629000,142176000,480805000
2011,10,WA25,"Salz, Schwefel, Steine, Erden usw.",198240000,183659000,381899000
2011,10,WA26,"Erze, Schlacken, Aschen",25593000,651286000,676879000
2011,10,WA27,Mineralische Brennstoffe usw.,2360536000,10619193000,12979729000
2011,10,WA28,Anorganische chemische Erzeugnisse,660636000,532869000,1193505000
2011,10,WA29,Organische chemische Erzeugnisse,1890293000,2296864000,4187157000
2011,10,WA30,Pharmazeutische Erzeugnisse,4033911000,2909693000,6943604000
2011,10,WA31,Düngemittel,214298000,119845000,334143000
2011,10,WA32,"Gerb- und Farbstoffe, Farben, Lacke usw.",787796000,429070000,1216866000
2011,10,WA33,"Etherische Öle, Riech-, Schönheitsmittel",655470000,377696000,1033166000
2011,10,WA34,"Seifen, Waschmittel usw.",478801000,255501000,734302000
2011,10,WA35,"Eiweißstoffe, Klebstoffe, Enzyme",202977000,159757000,362734000
2011,10,WA36,"Sprengstoffe, pyrotechnische Artikel usw.",20195000,27392000,47587000
2011,10,WA37,Photochemische Erzeugnisse,79283000,62755000,142038000
2011,10,WA38,Verschiedene Erzeugnisse der Chemischen Industrie,1422941000,905033000,2327974000
2011,10,WA39,Kunststoffe und Waren daraus,3943155000,2493653000,6436808000
2011,10,WA40,Kautschuk und Waren daraus,1234595000,1318486000,2553081000
2011,10,WA41,"Häute, Felle, Leder",89626000,82351000,171977000
2011,10,WA42,"Lederwaren, Sattlerwaren",129378000,230414000,359792000
2011,10,WA43,"Pelzfelle, künstliches Pelzwerk",18413000,16551000,34964000
2011,10,WA44,"Holz, Holzwaren, Holzkohle",553044000,531895000,1084939000
2011,10,WA45,"Kork, Korkwaren",2823000,11135000,13958000
2011,10,WA46,"Flechtwaren, Korbmacherwaren",3357000,9556000,12913000
2011,10,WA47,"Halbstoffe aus Holz usw., Papierabfall",102508000,307855000,410363000
2011,10,WA48,"Papier, Pappe und Waren daraus",1610368000,1009268000,2619636000
2011,10,WA49,"Bücher, Zeitungen, Bilddrucke usw.",370479000,189597000,560076000
2011,10,WA50,Seide,5770000,6040000,11810000
2011,10,WA51,"Wolle, feine und grobe Tierhaare",58898000,71066000,129964000
2011,10,WA52,Baumwolle,101649000,100026000,201675000
2011,10,WA53,"Andere pflanzliche Spinnstoffe, Papiergarn",4805000,8551000,13356000
2011,10,WA54,Synthetisches oder künstliches Filament,164028000,125779000,289807000
2011,10,WA55,Synthetische oder künstliche Spinnfaser,161559000,137094000,298653000
2011,10,WA56,"Watte, Filz, Vliesstoff usw., Tauwerk",175131000,105857000,280988000
2011,10,WA57,"Teppiche, Fußbodenbelag aus Spinnstoff",46336000,101761000,148097000
2011,10,WA58,"Spezialgewebe, Spitzen, Tapisserien",43148000,28558000,71706000
2011,10,WA59,"Getränkte, bestrichene usw. Gewebe",165103000,95138000,260241000
2011,10,WA60,Gewirke und Gestricke,69677000,39686000,109363000
2011,10,WA61,"Bekleidung usw. aus Gewirken, Gestricken",529157000,1074144000,1603301000
2011,10,WA62,"Andere Bekleidung, Bekleidungszubehör",577439000,1014440000,1591879000
2011,10,WA63,"Andere Konfektion, Spinnstoffwaren usw.",169724000,271896000,441620000
2011,10,WA64,"Schuhe, Gamaschen, ähnliche Waren",282729000,506664000,789393000
2011,10,WA65,Kopfbedeckungen und Teile davon,32769000,46974000,79743000
2011,10,WA66,"Schirme, Gehstöcke usw., Peitschen",6106000,11105000,17211000
2011,10,WA67,"Zugerichtete Federn, Daunen, künstliche Blumen",8058000,13399000,21457000
2011,10,WA68,"Waren aus Steinen, Gips, Zement usw.",293591000,238174000,531765000
2011,10,WA69,Keramische Waren,233143000,184867000,418010000
2011,10,WA70,Glas und Glaswaren,422951000,338523000,761474000
2011,10,WA71,"Perlen, Edelsteine, Edelmetalle",1399342000,1675194000,3074536000
2011,10,WA72,Eisen und Stahl,2098085000,2215781000,4313866000
2011,10,WA73,Waren aus Eisen oder Stahl,2051433000,1487981000,3539414000
2011,10,WA74,Kupfer und Waren daraus,923422000,902448000,1825870000
2011,10,WA75,Nickel und Waren daraus,79873000,131887000,211760000
2011,10,WA76,Aluminium und Waren daraus,1007487000,1114691000,2122178000
2011,10,WA78,Blei und Waren daraus,53399000,26757000,80156000
2011,10,WA79,Zink und Waren daraus,48168000,91693000,139861000
2011,10,WA80,Zinn und Waren daraus,9892000,32665000,42557000
2011,10,WA81,"Andere unedle Metalle, Cermets usw.",105687000,140044000,245731000
2011,10,WA82,"Werkzeuge, Schneidwaren, Essbestecke",556421000,344053000,900474000
2011,10,WA83,Verschiedene Waren aus unedlen Metallen,517468000,317445000,834913000
2011,10,WA84,"Maschinen, Apparate, mechanische Geräte",15534278000,9687370000,25221648000
2011,10,WA85,Elektrotechnische Erzeugnisse,8859024000,8887581000,17746605000
2011,10,WA86,Schienenfahrzeuge,260949000,115661000,376610000
2011,10,WA87,"Kraftfahrzeuge, Landfahrzeuge",15441705000,6127495000,21569200000
2011,10,WA88,"Luftfahrzeuge, Raumfahrzeuge",2432313000,2001416000,4433729000
2011,10,WA89,Wasserfahrzeuge,99787000,655034000,754821000
2011,10,WA90,"Optische, photografische usw. Erzeugnisse",3884563000,2249610000,6134173000
2011,10,WA91,Uhrmacherwaren,128325000,176363000,304688000
2011,10,WA92,Musikinstrumente,48061000,47309000,95370000
2011,10,WA93,Waffen und Munition,28455000,14937000,43392000
2011,10,WA94,"Möbel, Beleuchtungskörper usw.",1173660000,1167854000,2341514000
2011,10,WA95,"Spielzeug, Spiele usw., Sportgeräte",572102000,650703000,1222805000
2011,10,WA96,Verschiedene Waren,159590000,126437000,286027000
2011,10,WA97,"Kunstgegenstände, Sammlungsstücke",76992000,32730000,109722000
2011,10,WA98,Vollständige Fabrikationsanlagen,314979000,87013000,401992000
2011,10,WA99,Zusammenstellungen verschiedener Waren,1337868000,1010083000,2347951000
2011,11,WA01,Lebende Tiere,119390000,125220000,244610000
2011,11,WA02,Fleisch,660612000,545456000,1206068000
2011,11,WA03,"Fische, Krebs- und Weichtiere",106660000,280488000,387148000
2011,11,WA04,"Milch, Milcherzeugnisse, Eier, Honig",658300000,550355000,1208655000
2011,11,WA05,Andere Waren tierischen Ursprungs,67991000,66386000,134377000
2011,11,WA06,"Pflanzen, Waren des Blumenhandels",59895000,204878000,264773000
2011,11,WA07,"Gemüse, Pflanzen für Ernährung",48234000,303320000,351554000
2011,11,WA08,Genießbare Früchte und Nüsse,103607000,523559000,627166000
2011,11,WA09,"Kaffee, Tee, Mate, Gewürze",223116000,388809000,611925000
2011,11,WA10,Getreide,134875000,178643000,313518000
2011,11,WA11,"Müllereierzeugnisse, Malz usw.",92886000,41689000,134575000
2011,11,WA12,"Ölsamen usw., Heilpflanzen usw.",85073000,371513000,456586000
2011,11,WA13,"Schellack, Gummen, Harz, Pflanzensaft",39450000,27929000,67379000
2011,11,WA14,Flechtstoffe usw. pflanzlichen Ursprungs,755000,1806000,2561000
2011,11,WA15,"Tierische und pflanzliche Fette, Öle, Wachs",228492000,328560000,557052000
2011,11,WA16,"Zubereitungen von Fleisch, Fisch usw.",202725000,183233000,385958000
2011,11,WA17,Zucker und Zuckerwaren,196830000,122704000,319534000
2011,11,WA18,Kakao und Zubereitungen aus Kakao,360423000,286892000,647315000
2011,11,WA19,"Zubereitungen aus Getreide usw., Backwaren",392050000,203818000,595868000
2011,11,WA20,"Zubereitungen von Gemüse, Früchten usw.",177943000,346737000,524680000
2011,11,WA21,Verschiedene Lebensmittelzubereitungen,332914000,174291000,507205000
2011,11,WA22,"Getränke, alkoholhaltige Flüssigkeiten, Essig",397314000,583415000,980729000
2011,11,WA23,"Rückstände der Lebensmittelindustrie, Futter",264023000,246184000,510207000
2011,11,WA24,Tabak,354255000,198078000,552333000
2011,11,WA25,"Salz, Schwefel, Steine, Erden usw.",188990000,163861000,352851000
2011,11,WA26,"Erze, Schlacken, Aschen",37832000,872268000,910100000
2011,11,WA27,Mineralische Brennstoffe usw.,2371802000,11248235000,13620037000
2011,11,WA28,Anorganische chemische Erzeugnisse,598166000,466492000,1064658000
2011,11,WA29,Organische chemische Erzeugnisse,1861509000,1833368000,3694877000
2011,11,WA30,Pharmazeutische Erzeugnisse,4420550000,3082906000,7503456000
2011,11,WA31,Düngemittel,210277000,102914000,313191000
2011,11,WA32,"Gerb- und Farbstoffe, Farben, Lacke usw.",788759000,459799000,1248558000
2011,11,WA33,"Etherische Öle, Riech-, Schönheitsmittel",668444000,401981000,1070425000
2011,11,WA34,"Seifen, Waschmittel usw.",502124000,267368000,769492000
2011,11,WA35,"Eiweißstoffe, Klebstoffe, Enzyme",230933000,138128000,369061000
2011,11,WA36,"Sprengstoffe, pyrotechnische Artikel usw.",25993000,33976000,59969000
2011,11,WA37,Photochemische Erzeugnisse,84211000,63133000,147344000
2011,11,WA38,Verschiedene Erzeugnisse der Chemischen Industrie,1498018000,909990000,2408008000
2011,11,WA39,Kunststoffe und Waren daraus,4056311000,2461740000,6518051000
2011,11,WA40,Kautschuk und Waren daraus,1198239000,1185384000,2383623000
2011,11,WA41,"Häute, Felle, Leder",89299000,82034000,171333000
2011,11,WA42,"Lederwaren, Sattlerwaren",133978000,254465000,388443000
2011,11,WA43,"Pelzfelle, künstliches Pelzwerk",15060000,13618000,28678000
2011,11,WA44,"Holz, Holzwaren, Holzkohle",565794000,550452000,1116246000
2011,11,WA45,"Kork, Korkwaren",2646000,6725000,9371000
2011,11,WA46,"Flechtwaren, Korbmacherwaren",3291000,9354000,12645000
2011,11,WA47,"Halbstoffe aus Holz usw., Papierabfall",102874000,288133000,391007000
2011,11,WA48,"Papier, Pappe und Waren daraus",1557158000,997027000,2554185000
2011,11,WA49,"Bücher, Zeitungen, Bilddrucke usw.",365829000,184305000,550134000
2011,11,WA50,Seide,5415000,7284000,12699000
2011,11,WA51,"Wolle, feine und grobe Tierhaare",63066000,72523000,135589000
2011,11,WA52,Baumwolle,106702000,104675000,211377000
2011,11,WA53,"Andere pflanzliche Spinnstoffe, Papiergarn",6260000,10461000,16721000
2011,11,WA54,Synthetisches oder künstliches Filament,170062000,124126000,294188000
2011,11,WA55,Synthetische oder künstliche Spinnfaser,157646000,137509000,295155000
2011,11,WA56,"Watte, Filz, Vliesstoff usw., Tauwerk",172594000,90902000,263496000
2011,11,WA57,"Teppiche, Fußbodenbelag aus Spinnstoff",49899000,93734000,143633000
2011,11,WA58,"Spezialgewebe, Spitzen, Tapisserien",44442000,27393000,71835000
2011,11,WA59,"Getränkte, bestrichene usw. Gewebe",165306000,102043000,267349000
2011,11,WA60,Gewirke und Gestricke,80167000,39679000,119846000
2011,11,WA61,"Bekleidung usw. aus Gewirken, Gestricken",517638000,1046439000,1564077000
2011,11,WA62,"Andere Bekleidung, Bekleidungszubehör",505638000,984001000,1489639000
2011,11,WA63,"Andere Konfektion, Spinnstoffwaren usw.",188979000,264611000,453590000
2011,11,WA64,"Schuhe, Gamaschen, ähnliche Waren",230149000,489163000,719312000
2011,11,WA65,Kopfbedeckungen und Teile davon,25115000,36924000,62039000
2011,11,WA66,"Schirme, Gehstöcke usw., Peitschen",5639000,12957000,18596000
2011,11,WA67,"Zugerichtete Federn, Daunen, künstliche Blumen",7126000,16041000,23167000
2011,11,WA68,"Waren aus Steinen, Gips, Zement usw.",312919000,214817000,527736000
2011,11,WA69,Keramische Waren,245094000,186755000,431849000
2011,11,WA70,Glas und Glaswaren,440230000,332016000,772246000
2011,11,WA71,"Perlen, Edelsteine, Edelmetalle",1522539000,1538094000,3060633000
2011,11,WA72,Eisen und Stahl,2111848000,2159756000,4271604000
2011,11,WA73,Waren aus Eisen oder Stahl,2125486000,1472850000,3598336000
2011,11,WA74,Kupfer und Waren daraus,845868000,793708000,1639576000
2011,11,WA75,Nickel und Waren daraus,90319000,142511000,232830000
2011,11,WA76,Aluminium und Waren daraus,1013628000,1050218000,2063846000
2011,11,WA78,Blei und Waren daraus,35030000,24285000,59315000
2011,11,WA79,Zink und Waren daraus,53725000,85167000,138892000
2011,11,WA80,Zinn und Waren daraus,10925000,32712000,43637000
2011,11,WA81,"Andere unedle Metalle, Cermets usw.",103456000,129102000,232558000
2011,11,WA82,"Werkzeuge, Schneidwaren, Essbestecke",563830000,364901000,928731000
2011,11,WA83,Verschiedene Waren aus unedlen Metallen,547303000,331695000,878998000
2011,11,WA84,"Maschinen, Apparate, mechanische Geräte",16675932000,9449239000,26125171000
2011,11,WA85,Elektrotechnische Erzeugnisse,9469116000,9191550000,18660666000
2011,11,WA86,Schienenfahrzeuge,302923000,106515000,409438000
2011,11,WA87,"Kraftfahrzeuge, Landfahrzeuge",16174818000,6317010000,22491828000
2011,11,WA88,"Luftfahrzeuge, Raumfahrzeuge",3354184000,1648305000,5002489000
2011,11,WA89,Wasserfahrzeuge,237159000,629210000,866369000
2011,11,WA90,"Optische, photografische usw. Erzeugnisse",4394480000,2410112000,6804592000
2011,11,WA91,Uhrmacherwaren,140371000,192099000,332470000
2011,11,WA92,Musikinstrumente,46185000,44931000,91116000
2011,11,WA93,Waffen und Munition,42788000,14275000,57063000
2011,11,WA94,"Möbel, Beleuchtungskörper usw.",1238497000,1231482000,2469979000
2011,11,WA95,"Spielzeug, Spiele usw., Sportgeräte",737221000,630306000,1367527000
2011,11,WA96,Verschiedene Waren,174139000,133899000,308038000
2011,11,WA97,"Kunstgegenstände, Sammlungsstücke",71657000,25798000,97455000
2011,11,WA98,Vollständige Fabrikationsanlagen,277330000,1957000,279287000
2011,11,WA99,Zusammenstellungen verschiedener Waren,1357603000,1087336000,2444939000
2011,12,WA01,Lebende Tiere,135071000,131481000,266552000
2011,12,WA02,Fleisch,623542000,556821000,1180363000
2011,12,WA03,"Fische, Krebs- und Weichtiere",115078000,297061000,412139000
2011,12,WA04,"Milch, Milcherzeugnisse, Eier, Honig",606298000,556063000,1162361000
2011,12,WA05,Andere Waren tierischen Ursprungs,55162000,74788000,129950000
2011,12,WA06,"Pflanzen, Waren des Blumenhandels",43902000,206452000,250354000
2011,12,WA07,"Gemüse, Pflanzen für Ernährung",65637000,374104000,439741000
2011,12,WA08,Genießbare Früchte und Nüsse,106579000,533765000,640344000
2011,12,WA09,"Kaffee, Tee, Mate, Gewürze",193420000,382218000,575638000
2011,12,WA10,Getreide,162882000,235091000,397973000
2011,12,WA11,"Müllereierzeugnisse, Malz usw.",107298000,43324000,150622000
2011,12,WA12,"Ölsamen usw., Heilpflanzen usw.",82149000,336200000,418349000
2011,12,WA13,"Schellack, Gummen, Harz, Pflanzensaft",29752000,36230000,65982000
2011,12,WA14,Flechtstoffe usw. pflanzlichen Ursprungs,586000,1879000,2465000
2011,12,WA15,"Tierische und pflanzliche Fette, Öle, Wachs",190278000,326025000,516303000
2011,12,WA16,"Zubereitungen von Fleisch, Fisch usw.",213924000,201097000,415021000
2011,12,WA17,Zucker und Zuckerwaren,172342000,107933000,280275000
2011,12,WA18,Kakao und Zubereitungen aus Kakao,290661000,257580000,548241000
2011,12,WA19,"Zubereitungen aus Getreide usw., Backwaren",364451000,224653000,589104000
2011,12,WA20,"Zubereitungen von Gemüse, Früchten usw.",171575000,368514000,540089000
2011,12,WA21,Verschiedene Lebensmittelzubereitungen,326502000,181299000,507801000
2011,12,WA22,"Getränke, alkoholhaltige Flüssigkeiten, Essig",374339000,607963000,982302000
2011,12,WA23,"Rückstände der Lebensmittelindustrie, Futter",262462000,255258000,517720000
2011,12,WA24,Tabak,294121000,150927000,445048000
2011,12,WA25,"Salz, Schwefel, Steine, Erden usw.",151037000,148966000,300003000
2011,12,WA26,"Erze, Schlacken, Aschen",28552000,588076000,616628000
2011,12,WA27,Mineralische Brennstoffe usw.,2570401000,11199859000,13770260000
2011,12,WA28,Anorganische chemische Erzeugnisse,678690000,574682000,1253372000
2011,12,WA29,Organische chemische Erzeugnisse,1758681000,2169137000,3927818000
2011,12,WA30,Pharmazeutische Erzeugnisse,4122748000,2740357000,6863105000
2011,12,WA31,Düngemittel,285845000,105248000,391093000
2011,12,WA32,"Gerb- und Farbstoffe, Farben, Lacke usw.",621447000,394213000,1015660000
2011,12,WA33,"Etherische Öle, Riech-, Schönheitsmittel",600002000,374913000,974915000
2011,12,WA34,"Seifen, Waschmittel usw.",430224000,254176000,684400000
2011,12,WA35,"Eiweißstoffe, Klebstoffe, Enzyme",177493000,127302000,304795000
2011,12,WA36,"Sprengstoffe, pyrotechnische Artikel usw.",27373000,22003000,49376000
2011,12,WA37,Photochemische Erzeugnisse,81149000,65324000,146473000
2011,12,WA38,Verschiedene Erzeugnisse der Chemischen Industrie,1258766000,868144000,2126910000
2011,12,WA39,Kunststoffe und Waren daraus,3268086000,2185177000,5453263000
2011,12,WA40,Kautschuk und Waren daraus,951913000,1005241000,1957154000
2011,12,WA41,"Häute, Felle, Leder",77565000,70926000,148491000
2011,12,WA42,"Lederwaren, Sattlerwaren",122274000,240822000,363096000
2011,12,WA43,"Pelzfelle, künstliches Pelzwerk",12968000,20403000,33371000
2011,12,WA44,"Holz, Holzwaren, Holzkohle",457420000,430858000,888278000
2011,12,WA45,"Kork, Korkwaren",2541000,8513000,11054000
2011,12,WA46,"Flechtwaren, Korbmacherwaren",2575000,11359000,13934000
2011,12,WA47,"Halbstoffe aus Holz usw., Papierabfall",82067000,261536000,343603000
2011,12,WA48,"Papier, Pappe und Waren daraus",1428698000,919176000,2347874000
2011,12,WA49,"Bücher, Zeitungen, Bilddrucke usw.",373718000,182673000,556391000
2011,12,WA50,Seide,5076000,6095000,11171000
2011,12,WA51,"Wolle, feine und grobe Tierhaare",66148000,58807000,124955000
2011,12,WA52,Baumwolle,96140000,85069000,181209000
2011,12,WA53,"Andere pflanzliche Spinnstoffe, Papiergarn",7046000,8056000,15102000
2011,12,WA54,Synthetisches oder künstliches Filament,132656000,96312000,228968000
2011,12,WA55,Synthetische oder künstliche Spinnfaser,141890000,106670000,248560000
2011,12,WA56,"Watte, Filz, Vliesstoff usw., Tauwerk",134760000,77248000,212008000
2011,12,WA57,"Teppiche, Fußbodenbelag aus Spinnstoff",39181000,99466000,138647000
2011,12,WA58,"Spezialgewebe, Spitzen, Tapisserien",31797000,22775000,54572000
2011,12,WA59,"Getränkte, bestrichene usw. Gewebe",142296000,84256000,226552000
2011,12,WA60,Gewirke und Gestricke,63517000,32925000,96442000
2011,12,WA61,"Bekleidung usw. aus Gewirken, Gestricken",410069000,901610000,1311679000
2011,12,WA62,"Andere Bekleidung, Bekleidungszubehör",418176000,981825000,1400001000
2011,12,WA63,"Andere Konfektion, Spinnstoffwaren usw.",159027000,244421000,403448000
2011,12,WA64,"Schuhe, Gamaschen, ähnliche Waren",212752000,482148000,694900000
2011,12,WA65,Kopfbedeckungen und Teile davon,15684000,28088000,43772000
2011,12,WA66,"Schirme, Gehstöcke usw., Peitschen",5527000,14043000,19570000
2011,12,WA67,"Zugerichtete Federn, Daunen, künstliche Blumen",5893000,16694000,22587000
2011,12,WA68,"Waren aus Steinen, Gips, Zement usw.",239059000,171387000,410446000
2011,12,WA69,Keramische Waren,242485000,173314000,415799000
2011,12,WA70,Glas und Glaswaren,349971000,287884000,637855000
2011,12,WA71,"Perlen, Edelsteine, Edelmetalle",1360928000,1503750000,2864678000
2011,12,WA72,Eisen und Stahl,1665453000,1760664000,3426117000
2011,12,WA73,Waren aus Eisen oder Stahl,2005458000,1301572000,3307030000
2011,12,WA74,Kupfer und Waren daraus,785055000,722493000,1507548000
2011,12,WA75,Nickel und Waren daraus,83648000,119093000,202741000
2011,12,WA76,Aluminium und Waren daraus,823234000,886020000,1709254000
2011,12,WA78,Blei und Waren daraus,26915000,19666000,46581000
2011,12,WA79,Zink und Waren daraus,43539000,68904000,112443000
2011,12,WA80,Zinn und Waren daraus,5797000,29222000,35019000
2011,12,WA81,"Andere unedle Metalle, Cermets usw.",102124000,121044000,223168000
2011,12,WA82,"Werkzeuge, Schneidwaren, Essbestecke",524035000,316657000,840692000
2011,12,WA83,Verschiedene Waren aus unedlen Metallen,420647000,268276000,688923000
2011,12,WA84,"Maschinen, Apparate, mechanische Geräte",16252808000,9459789000,25712597000
2011,12,WA85,Elektrotechnische Erzeugnisse,8445876000,8088380000,16534256000
2011,12,WA86,Schienenfahrzeuge,373178000,130893000,504071000
2011,12,WA87,"Kraftfahrzeuge, Landfahrzeuge",13519176000,5215369000,18734545000
2011,12,WA88,"Luftfahrzeuge, Raumfahrzeuge",2956259000,1463545000,4419804000
2011,12,WA89,Wasserfahrzeuge,155541000,372372000,527913000
2011,12,WA90,"Optische, photografische usw. Erzeugnisse",4323381000,2219876000,6543257000
2011,12,WA91,Uhrmacherwaren,141575000,159946000,301521000
2011,12,WA92,Musikinstrumente,50339000,50821000,101160000
2011,12,WA93,Waffen und Munition,35099000,12046000,47145000
2011,12,WA94,"Möbel, Beleuchtungskörper usw.",1015845000,1101287000,2117132000
2011,12,WA95,"Spielzeug, Spiele usw., Sportgeräte",440357000,384533000,824890000
2011,12,WA96,Verschiedene Waren,143366000,109754000,253120000
2011,12,WA97,"Kunstgegenstände, Sammlungsstücke",58477000,40600000,99077000
2011,12,WA98,Vollständige Fabrikationsanlagen,390318000,13329000,403647000
2011,12,WA99,Zusammenstellungen verschiedener Waren,1177435000,950384000,2127819000
2012,1,WA01,Lebende Tiere,116483000,125090000,241573000
2012,1,WA02,Fleisch,615880000,434180000,1050060000
2012,1,WA03,"Fische, Krebs- und Weichtiere",90038000,229987000,320025000
2012,1,WA04,"Milch, Milcherzeugnisse, Eier, Honig",644237000,483106000,1127343000
2012,1,WA05,Andere Waren tierischen Ursprungs,71719000,77091000,148810000
2012,1,WA06,"Pflanzen, Waren des Blumenhandels",41938000,194995000,236933000
2012,1,WA07,"Gemüse, Pflanzen für Ernährung",52623000,412016000,464639000
2012,1,WA08,Genießbare Früchte und Nüsse,91548000,523943000,615491000
2012,1,WA09,"Kaffee, Tee, Mate, Gewürze",199192000,396593000,595785000
2012,1,WA10,Getreide,143845000,206478000,350323000
2012,1,WA11,"Müllereierzeugnisse, Malz usw.",91023000,36641000,127664000
2012,1,WA12,"Ölsamen usw., Heilpflanzen usw.",105522000,381260000,486782000
2012,1,WA13,"Schellack, Gummen, Harz, Pflanzensaft",38754000,42982000,81736000
2012,1,WA14,Flechtstoffe usw. pflanzlichen Ursprungs,972000,2004000,2976000
2012,1,WA15,"Tierische und pflanzliche Fette, Öle, Wachs",187052000,322474000,509526000
2012,1,WA16,"Zubereitungen von Fleisch, Fisch usw.",197515000,185398000,382913000
2012,1,WA17,Zucker und Zuckerwaren,146897000,116402000,263299000
2012,1,WA18,Kakao und Zubereitungen aus Kakao,290316000,271793000,562109000
2012,1,WA19,"Zubereitungen aus Getreide usw., Backwaren",344767000,202232000,546999000
2012,1,WA20,"Zubereitungen von Gemüse, Früchten usw.",165012000,336278000,501290000
2012,1,WA21,Verschiedene Lebensmittelzubereitungen,327742000,192337000,520079000
2012,1,WA22,"Getränke, alkoholhaltige Flüssigkeiten, Essig",328420000,448794000,777214000
2012,1,WA23,"Rückstände der Lebensmittelindustrie, Futter",220832000,239704000,460536000
2012,1,WA24,Tabak,329264000,128579000,457843000
2012,1,WA25,"Salz, Schwefel, Steine, Erden usw.",155728000,141915000,297643000
2012,1,WA26,"Erze, Schlacken, Aschen",25724000,721062000,746786000
2012,1,WA27,Mineralische Brennstoffe usw.,2439910000,10504430000,12944340000
2012,1,WA28,Anorganische chemische Erzeugnisse,661831000,529368000,1191199000
2012,1,WA29,Organische chemische Erzeugnisse,2237941000,1790590000,4028531000
2012,1,WA30,Pharmazeutische Erzeugnisse,4600986000,2584531000,7185517000
2012,1,WA31,Düngemittel,238123000,104835000,342958000
2012,1,WA32,"Gerb- und Farbstoffe, Farben, Lacke usw.",864118000,448982000,1313100000
2012,1,WA33,"Etherische Öle, Riech-, Schönheitsmittel",623616000,358800000,982416000
2012,1,WA34,"Seifen, Waschmittel usw.",494242000,254613000,748855000
2012,1,WA35,"Eiweißstoffe, Klebstoffe, Enzyme",223490000,146950000,370440000
2012,1,WA36,"Sprengstoffe, pyrotechnische Artikel usw.",18640000,22396000,41036000
2012,1,WA37,Photochemische Erzeugnisse,79738000,57089000,136827000
2012,1,WA38,Verschiedene Erzeugnisse der Chemischen Industrie,1536407000,937060000,2473467000
2012,1,WA39,Kunststoffe und Waren daraus,4101674000,2512036000,6613710000
2012,1,WA40,Kautschuk und Waren daraus,1145341000,1146071000,2291412000
2012,1,WA41,"Häute, Felle, Leder",69327000,71585000,140912000
2012,1,WA42,"Lederwaren, Sattlerwaren",136951000,274166000,411117000
2012,1,WA43,"Pelzfelle, künstliches Pelzwerk",8575000,13836000,22411000
2012,1,WA44,"Holz, Holzwaren, Holzkohle",460785000,506950000,967735000
2012,1,WA45,"Kork, Korkwaren",2078000,6991000,9069000
2012,1,WA46,"Flechtwaren, Korbmacherwaren",2900000,11902000,14802000
2012,1,WA47,"Halbstoffe aus Holz usw., Papierabfall",106310000,283262000,389572000
2012,1,WA48,"Papier, Pappe und Waren daraus",1344089000,902313000,2246402000
2012,1,WA49,"Bücher, Zeitungen, Bilddrucke usw.",353324000,159082000,512406000
2012,1,WA50,Seide,6220000,6536000,12756000
2012,1,WA51,"Wolle, feine und grobe Tierhaare",52105000,64791000,116896000
2012,1,WA52,Baumwolle,85598000,92246000,177844000
2012,1,WA53,"Andere pflanzliche Spinnstoffe, Papiergarn",5503000,7715000,13218000
2012,1,WA54,Synthetisches oder künstliches Filament,159444000,117397000,276841000
2012,1,WA55,Synthetische oder künstliche Spinnfaser,156415000,124828000,281243000
2012,1,WA56,"Watte, Filz, Vliesstoff usw., Tauwerk",167793000,88926000,256719000
2012,1,WA57,"Teppiche, Fußbodenbelag aus Spinnstoff",47099000,89460000,136559000
2012,1,WA58,"Spezialgewebe, Spitzen, Tapisserien",37537000,26987000,64524000
2012,1,WA59,"Getränkte, bestrichene usw. Gewebe",154740000,92849000,247589000
2012,1,WA60,Gewirke und Gestricke,70962000,36558000,107520000
2012,1,WA61,"Bekleidung usw. aus Gewirken, Gestricken",525471000,1079181000,1604652000
2012,1,WA62,"Andere Bekleidung, Bekleidungszubehör",675300000,1264872000,1940172000
2012,1,WA63,"Andere Konfektion, Spinnstoffwaren usw.",155686000,280559000,436245000
2012,1,WA64,"Schuhe, Gamaschen, ähnliche Waren",348807000,682304000,1031111000
2012,1,WA65,Kopfbedeckungen und Teile davon,21280000,35614000,56894000
2012,1,WA66,"Schirme, Gehstöcke usw., Peitschen",6731000,21578000,28309000
2012,1,WA67,"Zugerichtete Federn, Daunen, künstliche Blumen",9109000,16789000,25898000
2012,1,WA68,"Waren aus Steinen, Gips, Zement usw.",281276000,192069000,473345000
2012,1,WA69,Keramische Waren,222278000,184152000,406430000
2012,1,WA70,Glas und Glaswaren,397521000,319284000,716805000
2012,1,WA71,"Perlen, Edelsteine, Edelmetalle",1245871000,1396861000,2642732000
2012,1,WA72,Eisen und Stahl,2058545000,2100463000,4159008000
2012,1,WA73,Waren aus Eisen oder Stahl,1964886000,1374779000,3339665000
2012,1,WA74,Kupfer und Waren daraus,1086059000,851411000,1937470000
2012,1,WA75,Nickel und Waren daraus,99047000,142667000,241714000
2012,1,WA76,Aluminium und Waren daraus,933328000,970721000,1904049000
2012,1,WA78,Blei und Waren daraus,29824000,16566000,46390000
2012,1,WA79,Zink und Waren daraus,50544000,64645000,115189000
2012,1,WA80,Zinn und Waren daraus,10134000,28844000,38978000
2012,1,WA81,"Andere unedle Metalle, Cermets usw.",113181000,128077000,241258000
2012,1,WA82,"Werkzeuge, Schneidwaren, Essbestecke",534848000,351588000,886436000
2012,1,WA83,Verschiedene Waren aus unedlen Metallen,527572000,333866000,861438000
2012,1,WA84,"Maschinen, Apparate, mechanische Geräte",14671550000,8819848000,23491398000
2012,1,WA85,Elektrotechnische Erzeugnisse,8466425000,7681673000,16148098000
2012,1,WA86,Schienenfahrzeuge,272036000,111570000,383606000
2012,1,WA87,"Kraftfahrzeuge, Landfahrzeuge",13923759000,5330047000,19253806000
2012,1,WA88,"Luftfahrzeuge, Raumfahrzeuge",1925159000,1463651000,3388810000
2012,1,WA89,Wasserfahrzeuge,743218000,559931000,1303149000
2012,1,WA90,"Optische, photografische usw. Erzeugnisse",3639072000,2135013000,5774085000
2012,1,WA91,Uhrmacherwaren,101031000,138044000,239075000
2012,1,WA92,Musikinstrumente,34566000,37543000,72109000
2012,1,WA93,Waffen und Munition,24636000,12275000,36911000
2012,1,WA94,"Möbel, Beleuchtungskörper usw.",1007246000,1218874000,2226120000
2012,1,WA95,"Spielzeug, Spiele usw., Sportgeräte",266863000,386581000,653444000
2012,1,WA96,Verschiedene Waren,259219000,187712000,446931000
2012,1,WA97,"Kunstgegenstände, Sammlungsstücke",44468000,23613000,68081000
2012,1,WA98,Vollständige Fabrikationsanlagen,187075000,1440000,188515000
2012,1,WA99,Zusammenstellungen verschiedener Waren,1343446000,910597000,2254043000
2012,2,WA01,Lebende Tiere,98238000,161493000,259731000
2012,2,WA02,Fleisch,605448000,475132000,1080580000
2012,2,WA03,"Fische, Krebs- und Weichtiere",90821000,285308000,376129000
2012,2,WA04,"Milch, Milcherzeugnisse, Eier, Honig",667479000,514781000,1182260000
2012,2,WA05,Andere Waren tierischen Ursprungs,70806000,72972000,143778000
2012,2,WA06,"Pflanzen, Waren des Blumenhandels",54782000,227659000,282441000
2012,2,WA07,"Gemüse, Pflanzen für Ernährung",60099000,432026000,492125000
2012,2,WA08,Genießbare Früchte und Nüsse,95145000,491149000,586294000
2012,2,WA09,"Kaffee, Tee, Mate, Gewürze",195385000,372007000,567392000
2012,2,WA10,Getreide,199395000,217197000,416592000
2012,2,WA11,"Müllereierzeugnisse, Malz usw.",98933000,36747000,135680000
2012,2,WA12,"Ölsamen usw., Heilpflanzen usw.",120764000,371795000,492559000
2012,2,WA13,"Schellack, Gummen, Harz, Pflanzensaft",38679000,44478000,83157000
2012,2,WA14,Flechtstoffe usw. pflanzlichen Ursprungs,613000,1965000,2578000
2012,2,WA15,"Tierische und pflanzliche Fette, Öle, Wachs",233330000,304799000,538129000
2012,2,WA16,"Zubereitungen von Fleisch, Fisch usw.",199058000,184583000,383641000
2012,2,WA17,Zucker und Zuckerwaren,134999000,110913000,245912000
2012,2,WA18,Kakao und Zubereitungen aus Kakao,301263000,265709000,566972000
2012,2,WA19,"Zubereitungen aus Getreide usw., Backwaren",398703000,226103000,624806000
2012,2,WA20,"Zubereitungen von Gemüse, Früchten usw.",177461000,353301000,530762000
2012,2,WA21,Verschiedene Lebensmittelzubereitungen,347727000,203884000,551611000
2012,2,WA22,"Getränke, alkoholhaltige Flüssigkeiten, Essig",362820000,473119000,835939000
2012,2,WA23,"Rückstände der Lebensmittelindustrie, Futter",253415000,273931000,527346000
2012,2,WA24,Tabak,353658000,142573000,496231000
2012,2,WA25,"Salz, Schwefel, Steine, Erden usw.",141550000,160839000,302389000
2012,2,WA26,"Erze, Schlacken, Aschen",37686000,761572000,799258000
2012,2,WA27,Mineralische Brennstoffe usw.,2527554000,10983018000,13510572000
2012,2,WA28,Anorganische chemische Erzeugnisse,865508000,636814000,1502322000
2012,2,WA29,Organische chemische Erzeugnisse,2027367000,1861862000,3889229000
2012,2,WA30,Pharmazeutische Erzeugnisse,4108261000,2704424000,6812685000
2012,2,WA31,Düngemittel,259757000,114320000,374077000
2012,2,WA32,"Gerb- und Farbstoffe, Farben, Lacke usw.",830080000,427775000,1257855000
2012,2,WA33,"Etherische Öle, Riech-, Schönheitsmittel",586963000,315187000,902150000
2012,2,WA34,"Seifen, Waschmittel usw.",491383000,241859000,733242000
2012,2,WA35,"Eiweißstoffe, Klebstoffe, Enzyme",226022000,144552000,370574000
2012,2,WA36,"Sprengstoffe, pyrotechnische Artikel usw.",19752000,13965000,33717000
2012,2,WA37,Photochemische Erzeugnisse,84006000,62390000,146396000
2012,2,WA38,Verschiedene Erzeugnisse der Chemischen Industrie,1515852000,970428000,2486280000
2012,2,WA39,Kunststoffe und Waren daraus,4124457000,2605392000,6729849000
2012,2,WA40,Kautschuk und Waren daraus,1217926000,1218044000,2435970000
2012,2,WA41,"Häute, Felle, Leder",91760000,67175000,158935000
2012,2,WA42,"Lederwaren, Sattlerwaren",131754000,251616000,383370000
2012,2,WA43,"Pelzfelle, künstliches Pelzwerk",13026000,8188000,21214000
2012,2,WA44,"Holz, Holzwaren, Holzkohle",551836000,536123000,1087959000
2012,2,WA45,"Kork, Korkwaren",3038000,12070000,15108000
2012,2,WA46,"Flechtwaren, Korbmacherwaren",2557000,10421000,12978000
2012,2,WA47,"Halbstoffe aus Holz usw., Papierabfall",100616000,285431000,386047000
2012,2,WA48,"Papier, Pappe und Waren daraus",1409865000,934799000,2344664000
2012,2,WA49,"Bücher, Zeitungen, Bilddrucke usw.",331099000,158205000,489304000
2012,2,WA50,Seide,6049000,6846000,12895000
2012,2,WA51,"Wolle, feine und grobe Tierhaare",66995000,71175000,138170000
2012,2,WA52,Baumwolle,84534000,83329000,167863000
2012,2,WA53,"Andere pflanzliche Spinnstoffe, Papiergarn",4282000,6153000,10435000
2012,2,WA54,Synthetisches oder künstliches Filament,161531000,120169000,281700000
2012,2,WA55,Synthetische oder künstliche Spinnfaser,166997000,128227000,295224000
2012,2,WA56,"Watte, Filz, Vliesstoff usw., Tauwerk",171776000,90847000,262623000
2012,2,WA57,"Teppiche, Fußbodenbelag aus Spinnstoff",43610000,101298000,144908000
2012,2,WA58,"Spezialgewebe, Spitzen, Tapisserien",39460000,26318000,65778000
2012,2,WA59,"Getränkte, bestrichene usw. Gewebe",170052000,99714000,269766000
2012,2,WA60,Gewirke und Gestricke,67171000,37584000,104755000
2012,2,WA61,"Bekleidung usw. aus Gewirken, Gestricken",551792000,1015017000,1566809000
2012,2,WA62,"Andere Bekleidung, Bekleidungszubehör",745984000,1301224000,2047208000
2012,2,WA63,"Andere Konfektion, Spinnstoffwaren usw.",137850000,258598000,396448000
2012,2,WA64,"Schuhe, Gamaschen, ähnliche Waren",349970000,690171000,1040141000
2012,2,WA65,Kopfbedeckungen und Teile davon,27522000,41952000,69474000
2012,2,WA66,"Schirme, Gehstöcke usw., Peitschen",5686000,28125000,33811000
2012,2,WA67,"Zugerichtete Federn, Daunen, künstliche Blumen",8612000,11902000,20514000
2012,2,WA68,"Waren aus Steinen, Gips, Zement usw.",278160000,209308000,487468000
2012,2,WA69,Keramische Waren,231962000,177936000,409898000
2012,2,WA70,Glas und Glaswaren,400595000,322514000,723109000
2012,2,WA71,"Perlen, Edelsteine, Edelmetalle",1328580000,1488712000,2817292000
2012,2,WA72,Eisen und Stahl,2136043000,2210627000,4346670000
2012,2,WA73,Waren aus Eisen oder Stahl,2116655000,1445551000,3562206000
2012,2,WA74,Kupfer und Waren daraus,1033333000,1000346000,2033679000
2012,2,WA75,Nickel und Waren daraus,93894000,170205000,264099000
2012,2,WA76,Aluminium und Waren daraus,1033469000,1111717000,2145186000
2012,2,WA78,Blei und Waren daraus,33684000,38705000,72389000
2012,2,WA79,Zink und Waren daraus,55120000,82075000,137195000
2012,2,WA80,Zinn und Waren daraus,9525000,35114000,44639000
2012,2,WA81,"Andere unedle Metalle, Cermets usw.",110403000,133781000,244184000
2012,2,WA82,"Werkzeuge, Schneidwaren, Essbestecke",552889000,352869000,905758000
2012,2,WA83,Verschiedene Waren aus unedlen Metallen,517861000,317739000,835600000
2012,2,WA84,"Maschinen, Apparate, mechanische Geräte",15941338000,9191977000,25133315000
2012,2,WA85,Elektrotechnische Erzeugnisse,8693168000,7938020000,16631188000
2012,2,WA86,Schienenfahrzeuge,347044000,121387000,468431000
2012,2,WA87,"Kraftfahrzeuge, Landfahrzeuge",16258740000,6187984000,22446724000
2012,2,WA88,"Luftfahrzeuge, Raumfahrzeuge",2723251000,995868000,3719119000
2012,2,WA89,Wasserfahrzeuge,80816000,672558000,753374000
2012,2,WA90,"Optische, photografische usw. Erzeugnisse",4069565000,2222920000,6292485000
2012,2,WA91,Uhrmacherwaren,108694000,134737000,243431000
2012,2,WA92,Musikinstrumente,41777000,44087000,85864000
2012,2,WA93,Waffen und Munition,33087000,16899000,49986000
2012,2,WA94,"Möbel, Beleuchtungskörper usw.",1056951000,1259168000,2316119000
2012,2,WA95,"Spielzeug, Spiele usw., Sportgeräte",288841000,375877000,664718000
2012,2,WA96,Verschiedene Waren,226093000,159594000,385687000
2012,2,WA97,"Kunstgegenstände, Sammlungsstücke",76899000,27599000,104498000
2012,2,WA98,Vollständige Fabrikationsanlagen,182479000,3152000,185631000
2012,2,WA99,Zusammenstellungen verschiedener Waren,1279278000,923057000,2202335000
2012,3,WA01,Lebende Tiere,114090000,147976000,262066000
2012,3,WA02,Fleisch,684975000,515797000,1200772000
2012,3,WA03,"Fische, Krebs- und Weichtiere",107234000,262291000,369525000
2012,3,WA04,"Milch, Milcherzeugnisse, Eier, Honig",677584000,571239000,1248823000
2012,3,WA05,Andere Waren tierischen Ursprungs,69232000,69596000,138828000
2012,3,WA06,"Pflanzen, Waren des Blumenhandels",104974000,351022000,455996000
2012,3,WA07,"Gemüse, Pflanzen für Ernährung",70168000,507676000,577844000
2012,3,WA08,Genießbare Früchte und Nüsse,106890000,514214000,621104000
2012,3,WA09,"Kaffee, Tee, Mate, Gewürze",205826000,428340000,634166000
2012,3,WA10,Getreide,195452000,220744000,416196000
2012,3,WA11,"Müllereierzeugnisse, Malz usw.",103023000,42629000,145652000
2012,3,WA12,"Ölsamen usw., Heilpflanzen usw.",128770000,361615000,490385000
2012,3,WA13,"Schellack, Gummen, Harz, Pflanzensaft",43146000,45022000,88168000
2012,3,WA14,Flechtstoffe usw. pflanzlichen Ursprungs,616000,2203000,2819000
2012,3,WA15,"Tierische und pflanzliche Fette, Öle, Wachs",229231000,333513000,562744000
2012,3,WA16,"Zubereitungen von Fleisch, Fisch usw.",214802000,194418000,409220000
2012,3,WA17,Zucker und Zuckerwaren,144287000,133942000,278229000
2012,3,WA18,Kakao und Zubereitungen aus Kakao,283147000,284466000,567613000
2012,3,WA19,"Zubereitungen aus Getreide usw., Backwaren",393555000,228690000,622245000
2012,3,WA20,"Zubereitungen von Gemüse, Früchten usw.",191135000,356180000,547315000
2012,3,WA21,Verschiedene Lebensmittelzubereitungen,374304000,224937000,599241000
2012,3,WA22,"Getränke, alkoholhaltige Flüssigkeiten, Essig",384606000,536583000,921189000
2012,3,WA23,"Rückstände der Lebensmittelindustrie, Futter",248447000,272003000,520450000
2012,3,WA24,Tabak,341511000,158676000,500187000
2012,3,WA25,"Salz, Schwefel, Steine, Erden usw.",178495000,135576000,314071000
2012,3,WA26,"Erze, Schlacken, Aschen",23778000,1024925000,1048703000
2012,3,WA27,Mineralische Brennstoffe usw.,2650144000,12342498000,14992642000
2012,3,WA28,Anorganische chemische Erzeugnisse,774407000,743006000,1517413000
2012,3,WA29,Organische chemische Erzeugnisse,2213923000,2341733000,4555656000
2012,3,WA30,Pharmazeutische Erzeugnisse,4564175000,2997380000,7561555000
2012,3,WA31,Düngemittel,330327000,187257000,517584000
2012,3,WA32,"Gerb- und Farbstoffe, Farben, Lacke usw.",937069000,488009000,1425078000
2012,3,WA33,"Etherische Öle, Riech-, Schönheitsmittel",756562000,457807000,1214369000
2012,3,WA34,"Seifen, Waschmittel usw.",537377000,286695000,824072000
2012,3,WA35,"Eiweißstoffe, Klebstoffe, Enzyme",234641000,163205000,397846000
2012,3,WA36,"Sprengstoffe, pyrotechnische Artikel usw.",22912000,14605000,37517000
2012,3,WA37,Photochemische Erzeugnisse,100227000,68987000,169214000
2012,3,WA38,Verschiedene Erzeugnisse der Chemischen Industrie,1704175000,1037798000,2741973000
2012,3,WA39,Kunststoffe und Waren daraus,4438508000,2821917000,7260425000
2012,3,WA40,Kautschuk und Waren daraus,1300440000,1290146000,2590586000
2012,3,WA41,"Häute, Felle, Leder",92099000,72577000,164676000
2012,3,WA42,"Lederwaren, Sattlerwaren",125370000,201722000,327092000
2012,3,WA43,"Pelzfelle, künstliches Pelzwerk",17648000,14376000,32024000
2012,3,WA44,"Holz, Holzwaren, Holzkohle",572851000,551361000,1124212000
2012,3,WA45,"Kork, Korkwaren",2868000,8669000,11537000
2012,3,WA46,"Flechtwaren, Korbmacherwaren",3739000,7691000,11430000
2012,3,WA47,"Halbstoffe aus Holz usw., Papierabfall",94061000,294756000,388817000
2012,3,WA48,"Papier, Pappe und Waren daraus",1452523000,973192000,2425715000
2012,3,WA49,"Bücher, Zeitungen, Bilddrucke usw.",365238000,164875000,530113000
2012,3,WA50,Seide,6134000,5327000,11461000
2012,3,WA51,"Wolle, feine und grobe Tierhaare",65296000,75327000,140623000
2012,3,WA52,Baumwolle,91354000,82661000,174015000
2012,3,WA53,"Andere pflanzliche Spinnstoffe, Papiergarn",3587000,6403000,9990000
2012,3,WA54,Synthetisches oder künstliches Filament,171094000,127041000,298135000
2012,3,WA55,Synthetische oder künstliche Spinnfaser,167122000,131214000,298336000
2012,3,WA56,"Watte, Filz, Vliesstoff usw., Tauwerk",186577000,100599000,287176000
2012,3,WA57,"Teppiche, Fußbodenbelag aus Spinnstoff",44343000,85129000,129472000
2012,3,WA58,"Spezialgewebe, Spitzen, Tapisserien",40895000,27821000,68716000
2012,3,WA59,"Getränkte, bestrichene usw. Gewebe",182561000,103924000,286485000
2012,3,WA60,Gewirke und Gestricke,71353000,40290000,111643000
2012,3,WA61,"Bekleidung usw. aus Gewirken, Gestricken",563555000,965250000,1528805000
2012,3,WA62,"Andere Bekleidung, Bekleidungszubehör",714923000,1109628000,1824551000
2012,3,WA63,"Andere Konfektion, Spinnstoffwaren usw.",197062000,254364000,451426000
2012,3,WA64,"Schuhe, Gamaschen, ähnliche Waren",335827000,566340000,902167000
2012,3,WA65,Kopfbedeckungen und Teile davon,22744000,31453000,54197000
2012,3,WA66,"Schirme, Gehstöcke usw., Peitschen",8002000,19100000,27102000
2012,3,WA67,"Zugerichtete Federn, Daunen, künstliche Blumen",7808000,7176000,14984000
2012,3,WA68,"Waren aus Steinen, Gips, Zement usw.",327115000,213250000,540365000
2012,3,WA69,Keramische Waren,256245000,180971000,437216000
2012,3,WA70,Glas und Glaswaren,435696000,339876000,775572000
2012,3,WA71,"Perlen, Edelsteine, Edelmetalle",1496494000,1217924000,2714418000
2012,3,WA72,Eisen und Stahl,2306762000,2311547000,4618309000
2012,3,WA73,Waren aus Eisen oder Stahl,2380916000,1468055000,3848971000
2012,3,WA74,Kupfer und Waren daraus,1055200000,1047516000,2102716000
2012,3,WA75,Nickel und Waren daraus,102355000,199555000,301910000
2012,3,WA76,Aluminium und Waren daraus,1103270000,1174804000,2278074000
2012,3,WA78,Blei und Waren daraus,48953000,33350000,82303000
2012,3,WA79,Zink und Waren daraus,58160000,89389000,147549000
2012,3,WA80,Zinn und Waren daraus,10830000,33466000,44296000
2012,3,WA81,"Andere unedle Metalle, Cermets usw.",118831000,152987000,271818000
2012,3,WA82,"Werkzeuge, Schneidwaren, Essbestecke",629766000,340528000,970294000
2012,3,WA83,Verschiedene Waren aus unedlen Metallen,566971000,324049000,891020000
2012,3,WA84,"Maschinen, Apparate, mechanische Geräte",17679975000,10160139000,27840114000
2012,3,WA85,Elektrotechnische Erzeugnisse,9356460000,8481858000,17838318000
2012,3,WA86,Schienenfahrzeuge,373938000,125616000,499554000
2012,3,WA87,"Kraftfahrzeuge, Landfahrzeuge",17371715000,7181250000,24552965000
2012,3,WA88,"Luftfahrzeuge, Raumfahrzeuge",2536599000,997199000,3533798000
2012,3,WA89,Wasserfahrzeuge,129029000,319865000,448894000
2012,3,WA90,"Optische, photografische usw. Erzeugnisse",4489617000,2355450000,6845067000
2012,3,WA91,Uhrmacherwaren,123197000,146917000,270114000
2012,3,WA92,Musikinstrumente,38915000,37614000,76529000
2012,3,WA93,Waffen und Munition,40748000,17001000,57749000
2012,3,WA94,"Möbel, Beleuchtungskörper usw.",1207445000,1190403000,2397848000
2012,3,WA95,"Spielzeug, Spiele usw., Sportgeräte",314904000,367859000,682763000
2012,3,WA96,Verschiedene Waren,324320000,174868000,499188000
2012,3,WA97,"Kunstgegenstände, Sammlungsstücke",54360000,30987000,85347000
2012,3,WA98,Vollständige Fabrikationsanlagen,247595000,810000,248405000
2012,3,WA99,Zusammenstellungen verschiedener Waren,1493699000,969573000,2463272000
2012,4,WA01,Lebende Tiere,104915000,144288000,249203000
2012,4,WA02,Fleisch,547979000,437278000,985257000
2012,4,WA03,"Fische, Krebs- und Weichtiere",96470000,205746000,302216000
2012,4,WA04,"Milch, Milcherzeugnisse, Eier, Honig",623035000,469379000,1092414000
2012,4,WA05,Andere Waren tierischen Ursprungs,52915000,72997000,125912000
2012,4,WA06,"Pflanzen, Waren des Blumenhandels",101344000,334161000,435505000
2012,4,WA07,"Gemüse, Pflanzen für Ernährung",73172000,491157000,564329000
2012,4,WA08,Genießbare Früchte und Nüsse,94912000,489002000,583914000
2012,4,WA09,"Kaffee, Tee, Mate, Gewürze",171576000,391347000,562923000
2012,4,WA10,Getreide,226598000,187718000,414316000
2012,4,WA11,"Müllereierzeugnisse, Malz usw.",85682000,39577000,125259000
2012,4,WA12,"Ölsamen usw., Heilpflanzen usw.",63965000,434134000,498099000
2012,4,WA13,"Schellack, Gummen, Harz, Pflanzensaft",40108000,38028000,78136000
2012,4,WA14,Flechtstoffe usw. pflanzlichen Ursprungs,1274000,2819000,4093000
2012,4,WA15,"Tierische und pflanzliche Fette, Öle, Wachs",211052000,241847000,452899000
2012,4,WA16,"Zubereitungen von Fleisch, Fisch usw.",212162000,177074000,389236000
2012,4,WA17,Zucker und Zuckerwaren,126774000,129071000,255845000
2012,4,WA18,Kakao und Zubereitungen aus Kakao,180999000,182949000,363948000
2012,4,WA19,"Zubereitungen aus Getreide usw., Backwaren",370745000,199781000,570526000
2012,4,WA20,"Zubereitungen von Gemüse, Früchten usw.",176458000,347605000,524063000
2012,4,WA21,Verschiedene Lebensmittelzubereitungen,312390000,170737000,483127000
2012,4,WA22,"Getränke, alkoholhaltige Flüssigkeiten, Essig",381405000,484394000,865799000
2012,4,WA23,"Rückstände der Lebensmittelindustrie, Futter",236995000,234557000,471552000
2012,4,WA24,Tabak,332090000,150504000,482594000
2012,4,WA25,"Salz, Schwefel, Steine, Erden usw.",174445000,154746000,329191000
2012,4,WA26,"Erze, Schlacken, Aschen",25704000,647585000,673289000
2012,4,WA27,Mineralische Brennstoffe usw.,2393506000,10427525000,12821031000
2012,4,WA28,Anorganische chemische Erzeugnisse,732233000,628702000,1360935000
2012,4,WA29,Organische chemische Erzeugnisse,1936086000,2087095000,4023181000
2012,4,WA30,Pharmazeutische Erzeugnisse,4082140000,2466128000,6548268000
2012,4,WA31,Düngemittel,253998000,142152000,396150000
2012,4,WA32,"Gerb- und Farbstoffe, Farben, Lacke usw.",830500000,435970000,1266470000
2012,4,WA33,"Etherische Öle, Riech-, Schönheitsmittel",631912000,354471000,986383000
2012,4,WA34,"Seifen, Waschmittel usw.",471872000,230748000,702620000
2012,4,WA35,"Eiweißstoffe, Klebstoffe, Enzyme",223094000,147281000,370375000
2012,4,WA36,"Sprengstoffe, pyrotechnische Artikel usw.",11790000,14869000,26659000
2012,4,WA37,Photochemische Erzeugnisse,78952000,59767000,138719000
2012,4,WA38,Verschiedene Erzeugnisse der Chemischen Industrie,1478955000,934300000,2413255000
2012,4,WA39,Kunststoffe und Waren daraus,4176303000,2640700000,6817003000
2012,4,WA40,Kautschuk und Waren daraus,1129046000,1115094000,2244140000
2012,4,WA41,"Häute, Felle, Leder",79601000,72466000,152067000
2012,4,WA42,"Lederwaren, Sattlerwaren",110924000,205237000,316161000
2012,4,WA43,"Pelzfelle, künstliches Pelzwerk",12689000,13682000,26371000
2012,4,WA44,"Holz, Holzwaren, Holzkohle",524381000,537283000,1061664000
2012,4,WA45,"Kork, Korkwaren",2673000,6827000,9500000
2012,4,WA46,"Flechtwaren, Korbmacherwaren",3116000,9282000,12398000
2012,4,WA47,"Halbstoffe aus Holz usw., Papierabfall",90065000,289410000,379475000
2012,4,WA48,"Papier, Pappe und Waren daraus",1326573000,898071000,2224644000
2012,4,WA49,"Bücher, Zeitungen, Bilddrucke usw.",313391000,153370000,466761000
2012,4,WA50,Seide,5396000,5706000,11102000
2012,4,WA51,"Wolle, feine und grobe Tierhaare",60513000,76746000,137259000
2012,4,WA52,Baumwolle,80777000,80560000,161337000
2012,4,WA53,"Andere pflanzliche Spinnstoffe, Papiergarn",3442000,5124000,8566000
2012,4,WA54,Synthetisches oder künstliches Filament,156307000,114639000,270946000
2012,4,WA55,Synthetische oder künstliche Spinnfaser,160050000,126615000,286665000
2012,4,WA56,"Watte, Filz, Vliesstoff usw., Tauwerk",171544000,95988000,267532000
2012,4,WA57,"Teppiche, Fußbodenbelag aus Spinnstoff",41308000,74646000,115954000
2012,4,WA58,"Spezialgewebe, Spitzen, Tapisserien",38033000,26603000,64636000
2012,4,WA59,"Getränkte, bestrichene usw. Gewebe",157682000,94306000,251988000
2012,4,WA60,Gewirke und Gestricke,75440000,43121000,118561000
2012,4,WA61,"Bekleidung usw. aus Gewirken, Gestricken",423661000,809674000,1233335000
2012,4,WA62,"Andere Bekleidung, Bekleidungszubehör",494787000,892944000,1387731000
2012,4,WA63,"Andere Konfektion, Spinnstoffwaren usw.",166595000,241903000,408498000
2012,4,WA64,"Schuhe, Gamaschen, ähnliche Waren",218630000,430349000,648979000
2012,4,WA65,Kopfbedeckungen und Teile davon,19047000,27433000,46480000
2012,4,WA66,"Schirme, Gehstöcke usw., Peitschen",8258000,16648000,24906000
2012,4,WA67,"Zugerichtete Federn, Daunen, künstliche Blumen",6030000,8953000,14983000
2012,4,WA68,"Waren aus Steinen, Gips, Zement usw.",293834000,211946000,505780000
2012,4,WA69,Keramische Waren,240922000,185458000,426380000
2012,4,WA70,Glas und Glaswaren,397163000,314264000,711427000
2012,4,WA71,"Perlen, Edelsteine, Edelmetalle",1186255000,1100374000,2286629000
2012,4,WA72,Eisen und Stahl,2134954000,2089970000,4224924000
2012,4,WA73,Waren aus Eisen oder Stahl,2075549000,1377817000,3453366000
2012,4,WA74,Kupfer und Waren daraus,838023000,881709000,1719732000
2012,4,WA75,Nickel und Waren daraus,98390000,128001000,226391000
2012,4,WA76,Aluminium und Waren daraus,969735000,1101558000,2071293000
2012,4,WA78,Blei und Waren daraus,30833000,23368000,54201000
2012,4,WA79,Zink und Waren daraus,50356000,95654000,146010000
2012,4,WA80,Zinn und Waren daraus,9564000,30485000,40049000
2012,4,WA81,"Andere unedle Metalle, Cermets usw.",119051000,133126000,252177000
2012,4,WA82,"Werkzeuge, Schneidwaren, Essbestecke",565565000,332466000,898031000
2012,4,WA83,Verschiedene Waren aus unedlen Metallen,523624000,292648000,816272000
2012,4,WA84,"Maschinen, Apparate, mechanische Geräte",15471251000,9004891000,24476142000
2012,4,WA85,Elektrotechnische Erzeugnisse,8424066000,7880271000,16304337000
2012,4,WA86,Schienenfahrzeuge,326096000,117646000,443742000
2012,4,WA87,"Kraftfahrzeuge, Landfahrzeuge",14959008000,5995211000,20954219000
2012,4,WA88,"Luftfahrzeuge, Raumfahrzeuge",2292292000,1974715000,4267007000
2012,4,WA89,Wasserfahrzeuge,211340000,281406000,492746000
2012,4,WA90,"Optische, photografische usw. Erzeugnisse",3841146000,2162802000,6003948000
2012,4,WA91,Uhrmacherwaren,92128000,170474000,262602000
2012,4,WA92,Musikinstrumente,38320000,35492000,73812000
2012,4,WA93,Waffen und Munition,33920000,19193000,53113000
2012,4,WA94,"Möbel, Beleuchtungskörper usw.",1080979000,1143576000,2224555000
2012,4,WA95,"Spielzeug, Spiele usw., Sportgeräte",303224000,332694000,635918000
2012,4,WA96,Verschiedene Waren,269605000,177208000,446813000
2012,4,WA97,"Kunstgegenstände, Sammlungsstücke",82022000,17737000,99759000
2012,4,WA98,Vollständige Fabrikationsanlagen,192453000,2065000,194518000
2012,4,WA99,Zusammenstellungen verschiedener Waren,1651151000,850994000,2502145000
2012,5,WA01,Lebende Tiere,101035000,164644000,265679000
2012,5,WA02,Fleisch,608970000,477561000,1086531000
2012,5,WA03,"Fische, Krebs- und Weichtiere",92165000,235878000,328043000
2012,5,WA04,"Milch, Milcherzeugnisse, Eier, Honig",692343000,528527000,1220870000
2012,5,WA05,Andere Waren tierischen Ursprungs,71897000,83860000,155757000
2012,5,WA06,"Pflanzen, Waren des Blumenhandels",86547000,333627000,420174000
2012,5,WA07,"Gemüse, Pflanzen für Ernährung",73806000,494397000,568203000
2012,5,WA08,Genießbare Früchte und Nüsse,98193000,588542000,686735000
2012,5,WA09,"Kaffee, Tee, Mate, Gewürze",216688000,363874000,580562000
2012,5,WA10,Getreide,184501000,185184000,369685000
2012,5,WA11,"Müllereierzeugnisse, Malz usw.",116094000,40127000,156221000
2012,5,WA12,"Ölsamen usw., Heilpflanzen usw.",61005000,471261000,532266000
2012,5,WA13,"Schellack, Gummen, Harz, Pflanzensaft",44992000,40779000,85771000
2012,5,WA14,Flechtstoffe usw. pflanzlichen Ursprungs,943000,2629000,3572000
2012,5,WA15,"Tierische und pflanzliche Fette, Öle, Wachs",249946000,295943000,545889000
2012,5,WA16,"Zubereitungen von Fleisch, Fisch usw.",221092000,199027000,420119000
2012,5,WA17,Zucker und Zuckerwaren,160813000,124639000,285452000
2012,5,WA18,Kakao und Zubereitungen aus Kakao,258036000,215429000,473465000
2012,5,WA19,"Zubereitungen aus Getreide usw., Backwaren",393399000,245000000,638399000
2012,5,WA20,"Zubereitungen von Gemüse, Früchten usw.",199325000,363975000,563300000
2012,5,WA21,Verschiedene Lebensmittelzubereitungen,440319000,234091000,674410000
2012,5,WA22,"Getränke, alkoholhaltige Flüssigkeiten, Essig",426316000,546104000,972420000
2012,5,WA23,"Rückstände der Lebensmittelindustrie, Futter",274113000,288673000,562786000
2012,5,WA24,Tabak,346700000,156799000,503499000
2012,5,WA25,"Salz, Schwefel, Steine, Erden usw.",181991000,160212000,342203000
2012,5,WA26,"Erze, Schlacken, Aschen",28591000,748566000,777157000
2012,5,WA27,Mineralische Brennstoffe usw.,2306863000,10475334000,12782197000
2012,5,WA28,Anorganische chemische Erzeugnisse,742785000,690300000,1433085000
2012,5,WA29,Organische chemische Erzeugnisse,2057357000,2185383000,4242740000
2012,5,WA30,Pharmazeutische Erzeugnisse,4612362000,2934481000,7546843000
2012,5,WA31,Düngemittel,274434000,128441000,402875000
2012,5,WA32,"Gerb- und Farbstoffe, Farben, Lacke usw.",881231000,435034000,1316265000
2012,5,WA33,"Etherische Öle, Riech-, Schönheitsmittel",669782000,383461000,1053243000
2012,5,WA34,"Seifen, Waschmittel usw.",530174000,256099000,786273000
2012,5,WA35,"Eiweißstoffe, Klebstoffe, Enzyme",234478000,159726000,394204000
2012,5,WA36,"Sprengstoffe, pyrotechnische Artikel usw.",19726000,15553000,35279000
2012,5,WA37,Photochemische Erzeugnisse,86730000,64422000,151152000
2012,5,WA38,Verschiedene Erzeugnisse der Chemischen Industrie,1533961000,1067760000,2601721000
2012,5,WA39,Kunststoffe und Waren daraus,4379114000,2723935000,7103049000
2012,5,WA40,Kautschuk und Waren daraus,1199120000,1120225000,2319345000
2012,5,WA41,"Häute, Felle, Leder",96310000,82564000,178874000
2012,5,WA42,"Lederwaren, Sattlerwaren",108426000,236732000,345158000
2012,5,WA43,"Pelzfelle, künstliches Pelzwerk",14801000,14890000,29691000
2012,5,WA44,"Holz, Holzwaren, Holzkohle",588906000,565719000,1154625000
2012,5,WA45,"Kork, Korkwaren",3001000,10322000,13323000
2012,5,WA46,"Flechtwaren, Korbmacherwaren",3524000,11757000,15281000
2012,5,WA47,"Halbstoffe aus Holz usw., Papierabfall",99292000,297489000,396781000
2012,5,WA48,"Papier, Pappe und Waren daraus",1510760000,981917000,2492677000
2012,5,WA49,"Bücher, Zeitungen, Bilddrucke usw.",305466000,160915000,466381000
2012,5,WA50,Seide,7228000,6740000,13968000
2012,5,WA51,"Wolle, feine und grobe Tierhaare",70402000,81859000,152261000
2012,5,WA52,Baumwolle,94700000,87425000,182125000
2012,5,WA53,"Andere pflanzliche Spinnstoffe, Papiergarn",3007000,5762000,8769000
2012,5,WA54,Synthetisches oder künstliches Filament,166321000,127783000,294104000
2012,5,WA55,Synthetische oder künstliche Spinnfaser,171947000,138430000,310377000
2012,5,WA56,"Watte, Filz, Vliesstoff usw., Tauwerk",188006000,102940000,290946000
2012,5,WA57,"Teppiche, Fußbodenbelag aus Spinnstoff",42629000,80913000,123542000
2012,5,WA58,"Spezialgewebe, Spitzen, Tapisserien",42028000,29388000,71416000
2012,5,WA59,"Getränkte, bestrichene usw. Gewebe",181231000,98448000,279679000
2012,5,WA60,Gewirke und Gestricke,72831000,45242000,118073000
2012,5,WA61,"Bekleidung usw. aus Gewirken, Gestricken",400616000,842283000,1242899000
2012,5,WA62,"Andere Bekleidung, Bekleidungszubehör",426822000,880742000,1307564000
2012,5,WA63,"Andere Konfektion, Spinnstoffwaren usw.",183850000,270204000,454054000
2012,5,WA64,"Schuhe, Gamaschen, ähnliche Waren",197599000,463334000,660933000
2012,5,WA65,Kopfbedeckungen und Teile davon,18964000,29450000,48414000
2012,5,WA66,"Schirme, Gehstöcke usw., Peitschen",7756000,13284000,21040000
2012,5,WA67,"Zugerichtete Federn, Daunen, künstliche Blumen",6477000,11551000,18028000
2012,5,WA68,"Waren aus Steinen, Gips, Zement usw.",310334000,235611000,545945000
2012,5,WA69,Keramische Waren,247251000,197388000,444639000
2012,5,WA70,Glas und Glaswaren,429001000,337610000,766611000
2012,5,WA71,"Perlen, Edelsteine, Edelmetalle",1248361000,1288511000,2536872000
2012,5,WA72,Eisen und Stahl,2187609000,2215225000,4402834000
2012,5,WA73,Waren aus Eisen oder Stahl,2123884000,1485747000,3609631000
2012,5,WA74,Kupfer und Waren daraus,1055199000,1012888000,2068087000
2012,5,WA75,Nickel und Waren daraus,94229000,159664000,253893000
2012,5,WA76,Aluminium und Waren daraus,1055894000,1162274000,2218168000
2012,5,WA78,Blei und Waren daraus,27752000,28994000,56746000
2012,5,WA79,Zink und Waren daraus,58933000,92570000,151503000
2012,5,WA80,Zinn und Waren daraus,10902000,41662000,52564000
2012,5,WA81,"Andere unedle Metalle, Cermets usw.",123474000,142032000,265506000
2012,5,WA82,"Werkzeuge, Schneidwaren, Essbestecke",558489000,350191000,908680000
2012,5,WA83,Verschiedene Waren aus unedlen Metallen,558239000,340873000,899112000
2012,5,WA84,"Maschinen, Apparate, mechanische Geräte",16023668000,9241040000,25264708000
2012,5,WA85,Elektrotechnische Erzeugnisse,9104198000,8465843000,17570041000
2012,5,WA86,Schienenfahrzeuge,242592000,128954000,371546000
2012,5,WA87,"Kraftfahrzeuge, Landfahrzeuge",15429929000,6396398000,21826327000
2012,5,WA88,"Luftfahrzeuge, Raumfahrzeuge",2849412000,1758914000,4608326000
2012,5,WA89,Wasserfahrzeuge,687604000,356329000,1043933000
2012,5,WA90,"Optische, photografische usw. Erzeugnisse",4075561000,2245690000,6321251000
2012,5,WA91,Uhrmacherwaren,159352000,174752000,334104000
2012,5,WA92,Musikinstrumente,42206000,42596000,84802000
2012,5,WA93,Waffen und Munition,37492000,19572000,57064000
2012,5,WA94,"Möbel, Beleuchtungskörper usw.",1129577000,1179504000,2309081000
2012,5,WA95,"Spielzeug, Spiele usw., Sportgeräte",342157000,327306000,669463000
2012,5,WA96,Verschiedene Waren,287946000,189631000,477577000
2012,5,WA97,"Kunstgegenstände, Sammlungsstücke",67404000,34826000,102230000
2012,5,WA98,Vollständige Fabrikationsanlagen,304123000,2607000,306730000
2012,5,WA99,Zusammenstellungen verschiedener Waren,1401675000,894820000,2296495000
2012,6,WA01,Lebende Tiere,121248000,139242000,260490000
2012,6,WA02,Fleisch,646235000,459566000,1105801000
2012,6,WA03,"Fische, Krebs- und Weichtiere",83201000,243041000,326242000
2012,6,WA04,"Milch, Milcherzeugnisse, Eier, Honig",651194000,482407000,1133601000
2012,6,WA05,Andere Waren tierischen Ursprungs,60581000,79984000,140565000
2012,6,WA06,"Pflanzen, Waren des Blumenhandels",50474000,235429000,285903000
2012,6,WA07,"Gemüse, Pflanzen für Ernährung",84964000,397745000,482709000
2012,6,WA08,Genießbare Früchte und Nüsse,125523000,583320000,708843000
2012,6,WA09,"Kaffee, Tee, Mate, Gewürze",200013000,368140000,568153000
2012,6,WA10,Getreide,185084000,159415000,344499000
2012,6,WA11,"Müllereierzeugnisse, Malz usw.",93081000,38810000,131891000
2012,6,WA12,"Ölsamen usw., Heilpflanzen usw.",54888000,369227000,424115000
2012,6,WA13,"Schellack, Gummen, Harz, Pflanzensaft",41780000,39606000,81386000
2012,6,WA14,Flechtstoffe usw. pflanzlichen Ursprungs,1074000,2413000,3487000
2012,6,WA15,"Tierische und pflanzliche Fette, Öle, Wachs",253438000,288557000,541995000
2012,6,WA16,"Zubereitungen von Fleisch, Fisch usw.",221445000,199129000,420574000
2012,6,WA17,Zucker und Zuckerwaren,150641000,154700000,305341000
2012,6,WA18,Kakao und Zubereitungen aus Kakao,213141000,212419000,425560000
2012,6,WA19,"Zubereitungen aus Getreide usw., Backwaren",403194000,231823000,635017000
2012,6,WA20,"Zubereitungen von Gemüse, Früchten usw.",185912000,366079000,551991000
2012,6,WA21,Verschiedene Lebensmittelzubereitungen,388579000,216303000,604882000
2012,6,WA22,"Getränke, alkoholhaltige Flüssigkeiten, Essig",453784000,582353000,1036137000
2012,6,WA23,"Rückstände der Lebensmittelindustrie, Futter",289453000,282941000,572394000
2012,6,WA24,Tabak,355153000,144325000,499478000
2012,6,WA25,"Salz, Schwefel, Steine, Erden usw.",181790000,159017000,340807000
2012,6,WA26,"Erze, Schlacken, Aschen",30130000,629453000,659583000
2012,6,WA27,Mineralische Brennstoffe usw.,2107362000,10484507000,12591869000
2012,6,WA28,Anorganische chemische Erzeugnisse,754792000,655866000,1410658000
2012,6,WA29,Organische chemische Erzeugnisse,1971785000,2047662000,4019447000
2012,6,WA30,Pharmazeutische Erzeugnisse,4606879000,3070157000,7677036000
2012,6,WA31,Düngemittel,256615000,123980000,380595000
2012,6,WA32,"Gerb- und Farbstoffe, Farben, Lacke usw.",916273000,462086000,1378359000
2012,6,WA33,"Etherische Öle, Riech-, Schönheitsmittel",675447000,406846000,1082293000
2012,6,WA34,"Seifen, Waschmittel usw.",519392000,255530000,774922000
2012,6,WA35,"Eiweißstoffe, Klebstoffe, Enzyme",231595000,160197000,391792000
2012,6,WA36,"Sprengstoffe, pyrotechnische Artikel usw.",19285000,20335000,39620000
2012,6,WA37,Photochemische Erzeugnisse,92186000,67216000,159402000
2012,6,WA38,Verschiedene Erzeugnisse der Chemischen Industrie,1478603000,971529000,2450132000
2012,6,WA39,Kunststoffe und Waren daraus,4422763000,2773547000,7196310000
2012,6,WA40,Kautschuk und Waren daraus,1216296000,1118312000,2334608000
2012,6,WA41,"Häute, Felle, Leder",85387000,78423000,163810000
2012,6,WA42,"Lederwaren, Sattlerwaren",122417000,256766000,379183000
2012,6,WA43,"Pelzfelle, künstliches Pelzwerk",19611000,18534000,38145000
2012,6,WA44,"Holz, Holzwaren, Holzkohle",586334000,547302000,1133636000
2012,6,WA45,"Kork, Korkwaren",2518000,6776000,9294000
2012,6,WA46,"Flechtwaren, Korbmacherwaren",3161000,10698000,13859000
2012,6,WA47,"Halbstoffe aus Holz usw., Papierabfall",90054000,304231000,394285000
2012,6,WA48,"Papier, Pappe und Waren daraus",1469112000,975129000,2444241000
2012,6,WA49,"Bücher, Zeitungen, Bilddrucke usw.",314220000,158211000,472431000
2012,6,WA50,Seide,6667000,7375000,14042000
2012,6,WA51,"Wolle, feine und grobe Tierhaare",68577000,72680000,141257000
2012,6,WA52,Baumwolle,84464000,94520000,178984000
2012,6,WA53,"Andere pflanzliche Spinnstoffe, Papiergarn",2934000,6215000,9149000
2012,6,WA54,Synthetisches oder künstliches Filament,166460000,120524000,286984000
2012,6,WA55,Synthetische oder künstliche Spinnfaser,164275000,132607000,296882000
2012,6,WA56,"Watte, Filz, Vliesstoff usw., Tauwerk",182047000,101122000,283169000
2012,6,WA57,"Teppiche, Fußbodenbelag aus Spinnstoff",40643000,76416000,117059000
2012,6,WA58,"Spezialgewebe, Spitzen, Tapisserien",42780000,27844000,70624000
2012,6,WA59,"Getränkte, bestrichene usw. Gewebe",171685000,97240000,268925000
2012,6,WA60,Gewirke und Gestricke,70178000,41337000,111515000
2012,6,WA61,"Bekleidung usw. aus Gewirken, Gestricken",418871000,977752000,1396623000
2012,6,WA62,"Andere Bekleidung, Bekleidungszubehör",443780000,981612000,1425392000
2012,6,WA63,"Andere Konfektion, Spinnstoffwaren usw.",191296000,266964000,458260000
2012,6,WA64,"Schuhe, Gamaschen, ähnliche Waren",232653000,540033000,772686000
2012,6,WA65,Kopfbedeckungen und Teile davon,17098000,30153000,47251000
2012,6,WA66,"Schirme, Gehstöcke usw., Peitschen",7479000,13346000,20825000
2012,6,WA67,"Zugerichtete Federn, Daunen, künstliche Blumen",6007000,12943000,18950000
2012,6,WA68,"Waren aus Steinen, Gips, Zement usw.",336189000,228113000,564302000
2012,6,WA69,Keramische Waren,243173000,197676000,440849000
2012,6,WA70,Glas und Glaswaren,461607000,352748000,814355000
2012,6,WA71,"Perlen, Edelsteine, Edelmetalle",1473802000,1398310000,2872112000
2012,6,WA72,Eisen und Stahl,2213379000,2170743000,4384122000
2012,6,WA73,Waren aus Eisen oder Stahl,2240655000,1510898000,3751553000
2012,6,WA74,Kupfer und Waren daraus,904594000,831997000,1736591000
2012,6,WA75,Nickel und Waren daraus,92359000,142711000,235070000
2012,6,WA76,Aluminium und Waren daraus,966053000,1176307000,2142360000
2012,6,WA78,Blei und Waren daraus,36101000,22004000,58105000
2012,6,WA79,Zink und Waren daraus,52938000,95998000,148936000
2012,6,WA80,Zinn und Waren daraus,9884000,26415000,36299000
2012,6,WA81,"Andere unedle Metalle, Cermets usw.",121765000,139191000,260956000
2012,6,WA82,"Werkzeuge, Schneidwaren, Essbestecke",580146000,345649000,925795000
2012,6,WA83,Verschiedene Waren aus unedlen Metallen,558658000,330083000,888741000
2012,6,WA84,"Maschinen, Apparate, mechanische Geräte",16940643000,9401114000,26341757000
2012,6,WA85,Elektrotechnische Erzeugnisse,9369510000,8390113000,17759623000
2012,6,WA86,Schienenfahrzeuge,434414000,144297000,578711000
2012,6,WA87,"Kraftfahrzeuge, Landfahrzeuge",15565196000,6683074000,22248270000
2012,6,WA88,"Luftfahrzeuge, Raumfahrzeuge",3220136000,1241207000,4461343000
2012,6,WA89,Wasserfahrzeuge,364190000,229797000,593987000
2012,6,WA90,"Optische, photografische usw. Erzeugnisse",4266902000,2261261000,6528163000
2012,6,WA91,Uhrmacherwaren,143581000,180329000,323910000
2012,6,WA92,Musikinstrumente,41810000,47320000,89130000
2012,6,WA93,Waffen und Munition,36553000,18963000,55516000
2012,6,WA94,"Möbel, Beleuchtungskörper usw.",1158581000,1142503000,2301084000
2012,6,WA95,"Spielzeug, Spiele usw., Sportgeräte",244998000,328935000,573933000
2012,6,WA96,Verschiedene Waren,286203000,176958000,463161000
2012,6,WA97,"Kunstgegenstände, Sammlungsstücke",160984000,32400000,193384000
2012,6,WA98,Vollständige Fabrikationsanlagen,325687000,11111000,336798000
2012,6,WA99,Zusammenstellungen verschiedener Waren,1381478000,926417000,2307895000
2012,7,WA01,Lebende Tiere,115176000,135049000,250225000
2012,7,WA02,Fleisch,639416000,449584000,1089000000
2012,7,WA03,"Fische, Krebs- und Weichtiere",80546000,234939000,315485000
2012,7,WA04,"Milch, Milcherzeugnisse, Eier, Honig",675639000,511421000,1187060000
2012,7,WA05,Andere Waren tierischen Ursprungs,64167000,84172000,148339000
2012,7,WA06,"Pflanzen, Waren des Blumenhandels",43890000,187778000,231668000
2012,7,WA07,"Gemüse, Pflanzen für Ernährung",71139000,342395000,413534000
2012,7,WA08,Genießbare Früchte und Nüsse,102691000,646203000,748894000
2012,7,WA09,"Kaffee, Tee, Mate, Gewürze",194121000,378110000,572231000
2012,7,WA10,Getreide,129069000,151714000,280783000
2012,7,WA11,"Müllereierzeugnisse, Malz usw.",100064000,42508000,142572000
2012,7,WA12,"Ölsamen usw., Heilpflanzen usw.",76298000,341847000,418145000
2012,7,WA13,"Schellack, Gummen, Harz, Pflanzensaft",41555000,32474000,74029000
2012,7,WA14,Flechtstoffe usw. pflanzlichen Ursprungs,771000,2589000,3360000
2012,7,WA15,"Tierische und pflanzliche Fette, Öle, Wachs",263064000,312699000,575763000
2012,7,WA16,"Zubereitungen von Fleisch, Fisch usw.",217490000,192081000,409571000
2012,7,WA17,Zucker und Zuckerwaren,163324000,155945000,319269000
2012,7,WA18,Kakao und Zubereitungen aus Kakao,267845000,245046000,512891000
2012,7,WA19,"Zubereitungen aus Getreide usw., Backwaren",368748000,232786000,601534000
2012,7,WA20,"Zubereitungen von Gemüse, Früchten usw.",184891000,341677000,526568000
2012,7,WA21,Verschiedene Lebensmittelzubereitungen,402934000,213487000,616421000
2012,7,WA22,"Getränke, alkoholhaltige Flüssigkeiten, Essig",478202000,586869000,1065071000
2012,7,WA23,"Rückstände der Lebensmittelindustrie, Futter",294786000,310176000,604962000
2012,7,WA24,Tabak,341469000,175607000,517076000
2012,7,WA25,"Salz, Schwefel, Steine, Erden usw.",180719000,165565000,346284000
2012,7,WA26,"Erze, Schlacken, Aschen",43946000,900689000,944635000
2012,7,WA27,Mineralische Brennstoffe usw.,2199549000,10009609000,12209158000
2012,7,WA28,Anorganische chemische Erzeugnisse,693311000,630167000,1323478000
2012,7,WA29,Organische chemische Erzeugnisse,2047575000,2077360000,4124935000
2012,7,WA30,Pharmazeutische Erzeugnisse,4692304000,2908257000,7600561000
2012,7,WA31,Düngemittel,207938000,115406000,323344000
2012,7,WA32,"Gerb- und Farbstoffe, Farben, Lacke usw.",871215000,445256000,1316471000
2012,7,WA33,"Etherische Öle, Riech-, Schönheitsmittel",718275000,421478000,1139753000
2012,7,WA34,"Seifen, Waschmittel usw.",523509000,270759000,794268000
2012,7,WA35,"Eiweißstoffe, Klebstoffe, Enzyme",237084000,163372000,400456000
2012,7,WA36,"Sprengstoffe, pyrotechnische Artikel usw.",14583000,20445000,35028000
2012,7,WA37,Photochemische Erzeugnisse,94076000,66494000,160570000
2012,7,WA38,Verschiedene Erzeugnisse der Chemischen Industrie,1489178000,1012616000,2501794000
2012,7,WA39,Kunststoffe und Waren daraus,4301252000,2747552000,7048804000
2012,7,WA40,Kautschuk und Waren daraus,1160668000,1181094000,2341762000
2012,7,WA41,"Häute, Felle, Leder",83830000,67004000,150834000
2012,7,WA42,"Lederwaren, Sattlerwaren",147915000,275611000,423526000
2012,7,WA43,"Pelzfelle, künstliches Pelzwerk",22984000,22467000,45451000
2012,7,WA44,"Holz, Holzwaren, Holzkohle",573995000,557108000,1131103000
2012,7,WA45,"Kork, Korkwaren",2508000,10763000,13271000
2012,7,WA46,"Flechtwaren, Korbmacherwaren",3136000,10398000,13534000
2012,7,WA47,"Halbstoffe aus Holz usw., Papierabfall",96140000,285905000,382045000
2012,7,WA48,"Papier, Pappe und Waren daraus",1354429000,952647000,2307076000
2012,7,WA49,"Bücher, Zeitungen, Bilddrucke usw.",323663000,157134000,480797000
2012,7,WA50,Seide,6048000,5862000,11910000
2012,7,WA51,"Wolle, feine und grobe Tierhaare",47361000,56101000,103462000
2012,7,WA52,Baumwolle,73515000,79938000,153453000
2012,7,WA53,"Andere pflanzliche Spinnstoffe, Papiergarn",3007000,5776000,8783000
2012,7,WA54,Synthetisches oder künstliches Filament,149297000,115479000,264776000
2012,7,WA55,Synthetische oder künstliche Spinnfaser,151727000,134899000,286626000
2012,7,WA56,"Watte, Filz, Vliesstoff usw., Tauwerk",179904000,102966000,282870000
2012,7,WA57,"Teppiche, Fußbodenbelag aus Spinnstoff",40826000,82211000,123037000
2012,7,WA58,"Spezialgewebe, Spitzen, Tapisserien",40184000,28440000,68624000
2012,7,WA59,"Getränkte, bestrichene usw. Gewebe",167216000,95824000,263040000
2012,7,WA60,Gewirke und Gestricke,59678000,39757000,99435000
2012,7,WA61,"Bekleidung usw. aus Gewirken, Gestricken",575260000,1251093000,1826353000
2012,7,WA62,"Andere Bekleidung, Bekleidungszubehör",621789000,1260673000,1882462000
2012,7,WA63,"Andere Konfektion, Spinnstoffwaren usw.",177945000,271783000,449728000
2012,7,WA64,"Schuhe, Gamaschen, ähnliche Waren",323258000,732132000,1055390000
2012,7,WA65,Kopfbedeckungen und Teile davon,22859000,36278000,59137000
2012,7,WA66,"Schirme, Gehstöcke usw., Peitschen",6125000,11142000,17267000
2012,7,WA67,"Zugerichtete Federn, Daunen, künstliche Blumen",7956000,16914000,24870000
2012,7,WA68,"Waren aus Steinen, Gips, Zement usw.",318223000,236775000,554998000
2012,7,WA69,Keramische Waren,240066000,196853000,436919000
2012,7,WA70,Glas und Glaswaren,425028000,328116000,753144000
2012,7,WA71,"Perlen, Edelsteine, Edelmetalle",1147441000,1479864000,2627305000
2012,7,WA72,Eisen und Stahl,1982165000,2155956000,4138121000
2012,7,WA73,Waren aus Eisen oder Stahl,2118752000,1489563000,3608315000
2012,7,WA74,Kupfer und Waren daraus,991327000,996701000,1988028000
2012,7,WA75,Nickel und Waren daraus,93826000,142120000,235946000
2012,7,WA76,Aluminium und Waren daraus,1131609000,1214805000,2346414000
2012,7,WA78,Blei und Waren daraus,31445000,25397000,56842000
2012,7,WA79,Zink und Waren daraus,54695000,96361000,151056000
2012,7,WA80,Zinn und Waren daraus,9405000,30785000,40190000
2012,7,WA81,"Andere unedle Metalle, Cermets usw.",119840000,146518000,266358000
2012,7,WA82,"Werkzeuge, Schneidwaren, Essbestecke",585963000,367616000,953579000
2012,7,WA83,Verschiedene Waren aus unedlen Metallen,530677000,330821000,861498000
2012,7,WA84,"Maschinen, Apparate, mechanische Geräte",16625334000,9006858000,25632192000
2012,7,WA85,Elektrotechnische Erzeugnisse,9218735000,7848422000,17067157000
2012,7,WA86,Schienenfahrzeuge,315415000,163763000,479178000
2012,7,WA87,"Kraftfahrzeuge, Landfahrzeuge",16445934000,5920174000,22366108000
2012,7,WA88,"Luftfahrzeuge, Raumfahrzeuge",2376636000,2116148000,4492784000
2012,7,WA89,Wasserfahrzeuge,217152000,112857000,330009000
2012,7,WA90,"Optische, photografische usw. Erzeugnisse",4124670000,2301878000,6426548000
2012,7,WA91,Uhrmacherwaren,148528000,195976000,344504000
2012,7,WA92,Musikinstrumente,37548000,37497000,75045000
2012,7,WA93,Waffen und Munition,43268000,19549000,62817000
2012,7,WA94,"Möbel, Beleuchtungskörper usw.",1098575000,1060562000,2159137000
2012,7,WA95,"Spielzeug, Spiele usw., Sportgeräte",300984000,377756000,678740000
2012,7,WA96,Verschiedene Waren,286238000,210868000,497106000
2012,7,WA97,"Kunstgegenstände, Sammlungsstücke",52089000,37173000,89262000
2012,7,WA98,Vollständige Fabrikationsanlagen,418290000,5353000,423643000
2012,7,WA99,Zusammenstellungen verschiedener Waren,1553406000,871417000,2424823000
2012,8,WA01,Lebende Tiere,129182000,157255000,286437000
2012,8,WA02,Fleisch,723761000,489653000,1213414000
2012,8,WA03,"Fische, Krebs- und Weichtiere",90149000,244434000,334583000
2012,8,WA04,"Milch, Milcherzeugnisse, Eier, Honig",663715000,490015000,1153730000
2012,8,WA05,Andere Waren tierischen Ursprungs,50865000,73324000,124189000
2012,8,WA06,"Pflanzen, Waren des Blumenhandels",46379000,180940000,227319000
2012,8,WA07,"Gemüse, Pflanzen für Ernährung",75644000,304374000,380018000
2012,8,WA08,Genießbare Früchte und Nüsse,101185000,617574000,718759000
2012,8,WA09,"Kaffee, Tee, Mate, Gewürze",206825000,370447000,577272000
2012,8,WA10,Getreide,158394000,176250000,334644000
2012,8,WA11,"Müllereierzeugnisse, Malz usw.",94947000,42877000,137824000
2012,8,WA12,"Ölsamen usw., Heilpflanzen usw.",88936000,447442000,536378000
2012,8,WA13,"Schellack, Gummen, Harz, Pflanzensaft",40155000,37008000,77163000
2012,8,WA14,Flechtstoffe usw. pflanzlichen Ursprungs,560000,1697000,2257000
2012,8,WA15,"Tierische und pflanzliche Fette, Öle, Wachs",258282000,256832000,515114000
2012,8,WA16,"Zubereitungen von Fleisch, Fisch usw.",218973000,190580000,409553000
2012,8,WA17,Zucker und Zuckerwaren,156134000,136981000,293115000
2012,8,WA18,Kakao und Zubereitungen aus Kakao,325944000,253714000,579658000
2012,8,WA19,"Zubereitungen aus Getreide usw., Backwaren",421176000,225851000,647027000
2012,8,WA20,"Zubereitungen von Gemüse, Früchten usw.",164174000,337703000,501877000
2012,8,WA21,Verschiedene Lebensmittelzubereitungen,360762000,200014000,560776000
2012,8,WA22,"Getränke, alkoholhaltige Flüssigkeiten, Essig",419682000,553839000,973521000
2012,8,WA23,"Rückstände der Lebensmittelindustrie, Futter",328756000,283871000,612627000
2012,8,WA24,Tabak,361553000,159728000,521281000
2012,8,WA25,"Salz, Schwefel, Steine, Erden usw.",156961000,163372000,320333000
2012,8,WA26,"Erze, Schlacken, Aschen",33801000,748362000,782163000
2012,8,WA27,Mineralische Brennstoffe usw.,2425102000,9935368000,12360470000
2012,8,WA28,Anorganische chemische Erzeugnisse,661726000,541844000,1203570000
2012,8,WA29,Organische chemische Erzeugnisse,2170799000,2008529000,4179328000
2012,8,WA30,Pharmazeutische Erzeugnisse,4715779000,2785491000,7501270000
2012,8,WA31,Düngemittel,237462000,120379000,357841000
2012,8,WA32,"Gerb- und Farbstoffe, Farben, Lacke usw.",818133000,423195000,1241328000
2012,8,WA33,"Etherische Öle, Riech-, Schönheitsmittel",725278000,442235000,1167513000
2012,8,WA34,"Seifen, Waschmittel usw.",507624000,259798000,767422000
2012,8,WA35,"Eiweißstoffe, Klebstoffe, Enzyme",214047000,162541000,376588000
2012,8,WA36,"Sprengstoffe, pyrotechnische Artikel usw.",17440000,22449000,39889000
2012,8,WA37,Photochemische Erzeugnisse,85711000,63133000,148844000
2012,8,WA38,Verschiedene Erzeugnisse der Chemischen Industrie,1425675000,935759000,2361434000
2012,8,WA39,Kunststoffe und Waren daraus,4161509000,2587077000,6748586000
2012,8,WA40,Kautschuk und Waren daraus,1152632000,1131591000,2284223000
2012,8,WA41,"Häute, Felle, Leder",74824000,62467000,137291000
2012,8,WA42,"Lederwaren, Sattlerwaren",142676000,283524000,426200000
2012,8,WA43,"Pelzfelle, künstliches Pelzwerk",24775000,22025000,46800000
2012,8,WA44,"Holz, Holzwaren, Holzkohle",514878000,496921000,1011799000
2012,8,WA45,"Kork, Korkwaren",2771000,6681000,9452000
2012,8,WA46,"Flechtwaren, Korbmacherwaren",3224000,10595000,13819000
2012,8,WA47,"Halbstoffe aus Holz usw., Papierabfall",97468000,325611000,423079000
2012,8,WA48,"Papier, Pappe und Waren daraus",1568282000,1022550000,2590832000
2012,8,WA49,"Bücher, Zeitungen, Bilddrucke usw.",368291000,163522000,531813000
2012,8,WA50,Seide,3688000,3995000,7683000
2012,8,WA51,"Wolle, feine und grobe Tierhaare",41607000,39505000,81112000
2012,8,WA52,Baumwolle,66604000,65988000,132592000
2012,8,WA53,"Andere pflanzliche Spinnstoffe, Papiergarn",2498000,5815000,8313000
2012,8,WA54,Synthetisches oder künstliches Filament,139817000,111832000,251649000
2012,8,WA55,Synthetische oder künstliche Spinnfaser,146557000,120959000,267516000
2012,8,WA56,"Watte, Filz, Vliesstoff usw., Tauwerk",167590000,94727000,262317000
2012,8,WA57,"Teppiche, Fußbodenbelag aus Spinnstoff",41021000,76361000,117382000
2012,8,WA58,"Spezialgewebe, Spitzen, Tapisserien",33725000,24721000,58446000
2012,8,WA59,"Getränkte, bestrichene usw. Gewebe",155721000,79794000,235515000
2012,8,WA60,Gewirke und Gestricke,48187000,31376000,79563000
2012,8,WA61,"Bekleidung usw. aus Gewirken, Gestricken",625682000,1341723000,1967405000
2012,8,WA62,"Andere Bekleidung, Bekleidungszubehör",745296000,1425062000,2170358000
2012,8,WA63,"Andere Konfektion, Spinnstoffwaren usw.",169445000,271925000,441370000
2012,8,WA64,"Schuhe, Gamaschen, ähnliche Waren",381998000,791428000,1173426000
2012,8,WA65,Kopfbedeckungen und Teile davon,25847000,45553000,71400000
2012,8,WA66,"Schirme, Gehstöcke usw., Peitschen",6467000,10121000,16588000
2012,8,WA67,"Zugerichtete Federn, Daunen, künstliche Blumen",8274000,18555000,26829000
2012,8,WA68,"Waren aus Steinen, Gips, Zement usw.",307778000,215966000,523744000
2012,8,WA69,Keramische Waren,237264000,191040000,428304000
2012,8,WA70,Glas und Glaswaren,419845000,330912000,750757000
2012,8,WA71,"Perlen, Edelsteine, Edelmetalle",1354061000,1432737000,2786798000
2012,8,WA72,Eisen und Stahl,1891577000,1740709000,3632286000
2012,8,WA73,Waren aus Eisen oder Stahl,2135701000,1374213000,3509914000
2012,8,WA74,Kupfer und Waren daraus,886294000,755548000,1641842000
2012,8,WA75,Nickel und Waren daraus,83092000,110081000,193173000
2012,8,WA76,Aluminium und Waren daraus,1001963000,1060313000,2062276000
2012,8,WA78,Blei und Waren daraus,29323000,20337000,49660000
2012,8,WA79,Zink und Waren daraus,53552000,82588000,136140000
2012,8,WA80,Zinn und Waren daraus,9914000,35833000,45747000
2012,8,WA81,"Andere unedle Metalle, Cermets usw.",105738000,122266000,228004000
2012,8,WA82,"Werkzeuge, Schneidwaren, Essbestecke",553859000,366547000,920406000
2012,8,WA83,Verschiedene Waren aus unedlen Metallen,539104000,312621000,851725000
2012,8,WA84,"Maschinen, Apparate, mechanische Geräte",15334019000,8553876000,23887895000
2012,8,WA85,Elektrotechnische Erzeugnisse,8966419000,7832363000,16798782000
2012,8,WA86,Schienenfahrzeuge,473518000,177449000,650967000
2012,8,WA87,"Kraftfahrzeuge, Landfahrzeuge",13728667000,5010764000,18739431000
2012,8,WA88,"Luftfahrzeuge, Raumfahrzeuge",2570423000,2038204000,4608627000
2012,8,WA89,Wasserfahrzeuge,550896000,688044000,1238940000
2012,8,WA90,"Optische, photografische usw. Erzeugnisse",4104845000,2145993000,6250838000
2012,8,WA91,Uhrmacherwaren,124119000,174270000,298389000
2012,8,WA92,Musikinstrumente,37757000,42614000,80371000
2012,8,WA93,Waffen und Munition,40167000,17413000,57580000
2012,8,WA94,"Möbel, Beleuchtungskörper usw.",1003465000,1130102000,2133567000
2012,8,WA95,"Spielzeug, Spiele usw., Sportgeräte",286057000,411855000,697912000
2012,8,WA96,Verschiedene Waren,266724000,177768000,444492000
2012,8,WA97,"Kunstgegenstände, Sammlungsstücke",38958000,26668000,65626000
2012,8,WA98,Vollständige Fabrikationsanlagen,355950000,526000,356476000
2012,8,WA99,Zusammenstellungen verschiedener Waren,1801962000,804326000,2606288000
2012,9,WA01,Lebende Tiere,128276000,147151000,275427000
2012,9,WA02,Fleisch,598198000,473165000,1071363000
2012,9,WA03,"Fische, Krebs- und Weichtiere",98986000,232331000,331317000
2012,9,WA04,"Milch, Milcherzeugnisse, Eier, Honig",633380000,501637000,1135017000
2012,9,WA05,Andere Waren tierischen Ursprungs,66035000,66939000,132974000
2012,9,WA06,"Pflanzen, Waren des Blumenhandels",64090000,188750000,252840000
2012,9,WA07,"Gemüse, Pflanzen für Ernährung",86497000,296377000,382874000
2012,9,WA08,Genießbare Früchte und Nüsse,91018000,556488000,647506000
2012,9,WA09,"Kaffee, Tee, Mate, Gewürze",196199000,323317000,519516000
2012,9,WA10,Getreide,218912000,206123000,425035000
2012,9,WA11,"Müllereierzeugnisse, Malz usw.",97445000,45307000,142752000
2012,9,WA12,"Ölsamen usw., Heilpflanzen usw.",53291000,439806000,493097000
2012,9,WA13,"Schellack, Gummen, Harz, Pflanzensaft",36608000,31494000,68102000
2012,9,WA14,Flechtstoffe usw. pflanzlichen Ursprungs,1155000,2422000,3577000
2012,9,WA15,"Tierische und pflanzliche Fette, Öle, Wachs",288427000,318774000,607201000
2012,9,WA16,"Zubereitungen von Fleisch, Fisch usw.",206470000,188723000,395193000
2012,9,WA17,Zucker und Zuckerwaren,169347000,133643000,302990000
2012,9,WA18,Kakao und Zubereitungen aus Kakao,359576000,275393000,634969000
2012,9,WA19,"Zubereitungen aus Getreide usw., Backwaren",390381000,225221000,615602000
2012,9,WA20,"Zubereitungen von Gemüse, Früchten usw.",188298000,338523000,526821000
2012,9,WA21,Verschiedene Lebensmittelzubereitungen,343378000,190195000,533573000
2012,9,WA22,"Getränke, alkoholhaltige Flüssigkeiten, Essig",397469000,536563000,934032000
2012,9,WA23,"Rückstände der Lebensmittelindustrie, Futter",304822000,337185000,642007000
2012,9,WA24,Tabak,325600000,167084000,492684000
2012,9,WA25,"Salz, Schwefel, Steine, Erden usw.",163407000,169189000,332596000
2012,9,WA26,"Erze, Schlacken, Aschen",21870000,600747000,622617000
2012,9,WA27,Mineralische Brennstoffe usw.,2500812000,10262494000,12763306000
2012,9,WA28,Anorganische chemische Erzeugnisse,815427000,627875000,1443302000
2012,9,WA29,Organische chemische Erzeugnisse,2033811000,2419230000,4453041000
2012,9,WA30,Pharmazeutische Erzeugnisse,4833822000,2826256000,7660078000
2012,9,WA31,Düngemittel,185879000,121226000,307105000
2012,9,WA32,"Gerb- und Farbstoffe, Farben, Lacke usw.",819451000,465387000,1284838000
2012,9,WA33,"Etherische Öle, Riech-, Schönheitsmittel",696938000,429234000,1126172000
2012,9,WA34,"Seifen, Waschmittel usw.",493603000,265458000,759061000
2012,9,WA35,"Eiweißstoffe, Klebstoffe, Enzyme",225336000,151190000,376526000
2012,9,WA36,"Sprengstoffe, pyrotechnische Artikel usw.",19948000,27171000,47119000
2012,9,WA37,Photochemische Erzeugnisse,89328000,68359000,157687000
2012,9,WA38,Verschiedene Erzeugnisse der Chemischen Industrie,1344803000,872635000,2217438000
2012,9,WA39,Kunststoffe und Waren daraus,4153628000,2598196000,6751824000
2012,9,WA40,Kautschuk und Waren daraus,1178938000,1122610000,2301548000
2012,9,WA41,"Häute, Felle, Leder",81025000,62726000,143751000
2012,9,WA42,"Lederwaren, Sattlerwaren",139404000,243142000,382546000
2012,9,WA43,"Pelzfelle, künstliches Pelzwerk",19180000,15970000,35150000
2012,9,WA44,"Holz, Holzwaren, Holzkohle",518913000,509252000,1028165000
2012,9,WA45,"Kork, Korkwaren",2510000,5837000,8347000
2012,9,WA46,"Flechtwaren, Korbmacherwaren",3400000,8516000,11916000
2012,9,WA47,"Halbstoffe aus Holz usw., Papierabfall",94851000,265014000,359865000
2012,9,WA48,"Papier, Pappe und Waren daraus",1409918000,936130000,2346048000
2012,9,WA49,"Bücher, Zeitungen, Bilddrucke usw.",358524000,164124000,522648000
2012,9,WA50,Seide,6662000,6810000,13472000
2012,9,WA51,"Wolle, feine und grobe Tierhaare",47096000,62336000,109432000
2012,9,WA52,Baumwolle,82382000,79296000,161678000
2012,9,WA53,"Andere pflanzliche Spinnstoffe, Papiergarn",3106000,5105000,8211000
2012,9,WA54,Synthetisches oder künstliches Filament,148497000,106974000,255471000
2012,9,WA55,Synthetische oder künstliche Spinnfaser,152135000,124241000,276376000
2012,9,WA56,"Watte, Filz, Vliesstoff usw., Tauwerk",176635000,92015000,268650000
2012,9,WA57,"Teppiche, Fußbodenbelag aus Spinnstoff",40164000,79746000,119910000
2012,9,WA58,"Spezialgewebe, Spitzen, Tapisserien",35980000,24866000,60846000
2012,9,WA59,"Getränkte, bestrichene usw. Gewebe",153946000,88998000,242944000
2012,9,WA60,Gewirke und Gestricke,60897000,37328000,98225000
2012,9,WA61,"Bekleidung usw. aus Gewirken, Gestricken",630486000,1183743000,1814229000
2012,9,WA62,"Andere Bekleidung, Bekleidungszubehör",741716000,1278154000,2019870000
2012,9,WA63,"Andere Konfektion, Spinnstoffwaren usw.",174081000,255728000,429809000
2012,9,WA64,"Schuhe, Gamaschen, ähnliche Waren",311684000,614330000,926014000
2012,9,WA65,Kopfbedeckungen und Teile davon,28154000,44265000,72419000
2012,9,WA66,"Schirme, Gehstöcke usw., Peitschen",5780000,8561000,14341000
2012,9,WA67,"Zugerichtete Federn, Daunen, künstliche Blumen",9850000,15561000,25411000
2012,9,WA68,"Waren aus Steinen, Gips, Zement usw.",295820000,211520000,507340000
2012,9,WA69,Keramische Waren,233696000,196533000,430229000
2012,9,WA70,Glas und Glaswaren,406258000,324394000,730652000
2012,9,WA71,"Perlen, Edelsteine, Edelmetalle",1297307000,1578203000,2875510000
2012,9,WA72,Eisen und Stahl,2039816000,1917841000,3957657000
2012,9,WA73,Waren aus Eisen oder Stahl,1997641000,1405806000,3403447000
2012,9,WA74,Kupfer und Waren daraus,881718000,860814000,1742532000
2012,9,WA75,Nickel und Waren daraus,88327000,139436000,227763000
2012,9,WA76,Aluminium und Waren daraus,992645000,1057129000,2049774000
2012,9,WA78,Blei und Waren daraus,36922000,21965000,58887000
2012,9,WA79,Zink und Waren daraus,50760000,88135000,138895000
2012,9,WA80,Zinn und Waren daraus,7736000,23432000,31168000
2012,9,WA81,"Andere unedle Metalle, Cermets usw.",99221000,113664000,212885000
2012,9,WA82,"Werkzeuge, Schneidwaren, Essbestecke",532472000,337697000,870169000
2012,9,WA83,Verschiedene Waren aus unedlen Metallen,523921000,305393000,829314000
2012,9,WA84,"Maschinen, Apparate, mechanische Geräte",15143814000,8864501000,24008315000
2012,9,WA85,Elektrotechnische Erzeugnisse,8738017000,8363219000,17101236000
2012,9,WA86,Schienenfahrzeuge,292751000,144184000,436935000
2012,9,WA87,"Kraftfahrzeuge, Landfahrzeuge",15278340000,5929081000,21207421000
2012,9,WA88,"Luftfahrzeuge, Raumfahrzeuge",3297888000,1121302000,4419190000
2012,9,WA89,Wasserfahrzeuge,625863000,339845000,965708000
2012,9,WA90,"Optische, photografische usw. Erzeugnisse",4077873000,2204983000,6282856000
2012,9,WA91,Uhrmacherwaren,145758000,193392000,339150000
2012,9,WA92,Musikinstrumente,46644000,50718000,97362000
2012,9,WA93,Waffen und Munition,39359000,17257000,56616000
2012,9,WA94,"Möbel, Beleuchtungskörper usw.",1096277000,1145787000,2242064000
2012,9,WA95,"Spielzeug, Spiele usw., Sportgeräte",332460000,483788000,816248000
2012,9,WA96,Verschiedene Waren,295153000,175287000,470440000
2012,9,WA97,"Kunstgegenstände, Sammlungsstücke",52389000,21309000,73698000
2012,9,WA98,Vollständige Fabrikationsanlagen,316662000,2595000,319257000
2012,9,WA99,Zusammenstellungen verschiedener Waren,1469720000,841950000,2311670000
2012,10,WA01,Lebende Tiere,140653000,168664000,309317000
2012,10,WA02,Fleisch,810510000,647490000,1458000000
2012,10,WA03,"Fische, Krebs- und Weichtiere",111349000,288034000,399383000
2012,10,WA04,"Milch, Milcherzeugnisse, Eier, Honig",695247000,552965000,1248212000
2012,10,WA05,Andere Waren tierischen Ursprungs,67262000,85500000,152762000
2012,10,WA06,"Pflanzen, Waren des Blumenhandels",68578000,195606000,264184000
2012,10,WA07,"Gemüse, Pflanzen für Ernährung",107384000,337037000,444421000
2012,10,WA08,Genießbare Früchte und Nüsse,114884000,593966000,708850000
2012,10,WA09,"Kaffee, Tee, Mate, Gewürze",213989000,384091000,598080000
2012,10,WA10,Getreide,365263000,215885000,581148000
2012,10,WA11,"Müllereierzeugnisse, Malz usw.",107915000,46323000,154238000
2012,10,WA12,"Ölsamen usw., Heilpflanzen usw.",62059000,458726000,520785000
2012,10,WA13,"Schellack, Gummen, Harz, Pflanzensaft",37203000,33439000,70642000
2012,10,WA14,Flechtstoffe usw. pflanzlichen Ursprungs,1080000,2426000,3506000
2012,10,WA15,"Tierische und pflanzliche Fette, Öle, Wachs",279285000,333100000,612385000
2012,10,WA16,"Zubereitungen von Fleisch, Fisch usw.",241240000,236427000,477667000
2012,10,WA17,Zucker und Zuckerwaren,201396000,137572000,338968000
2012,10,WA18,Kakao und Zubereitungen aus Kakao,438145000,312867000,751012000
2012,10,WA19,"Zubereitungen aus Getreide usw., Backwaren",462527000,253131000,715658000
2012,10,WA20,"Zubereitungen von Gemüse, Früchten usw.",190095000,401859000,591954000
2012,10,WA21,Verschiedene Lebensmittelzubereitungen,393903000,219005000,612908000
2012,10,WA22,"Getränke, alkoholhaltige Flüssigkeiten, Essig",434797000,635539000,1070336000
2012,10,WA23,"Rückstände der Lebensmittelindustrie, Futter",335740000,373339000,709079000
2012,10,WA24,Tabak,337033000,169068000,506101000
2012,10,WA25,"Salz, Schwefel, Steine, Erden usw.",194854000,150183000,345037000
2012,10,WA26,"Erze, Schlacken, Aschen",36819000,745022000,781841000
2012,10,WA27,Mineralische Brennstoffe usw.,2506100000,12438306000,14944406000
2012,10,WA28,Anorganische chemische Erzeugnisse,794929000,535704000,1330633000
2012,10,WA29,Organische chemische Erzeugnisse,2159176000,2020058000,4179234000
2012,10,WA30,Pharmazeutische Erzeugnisse,4893165000,3112618000,8005783000
2012,10,WA31,Düngemittel,190977000,137536000,328513000
2012,10,WA32,"Gerb- und Farbstoffe, Farben, Lacke usw.",938343000,481035000,1419378000
2012,10,WA33,"Etherische Öle, Riech-, Schönheitsmittel",762873000,469883000,1232756000
2012,10,WA34,"Seifen, Waschmittel usw.",567034000,310385000,877419000
2012,10,WA35,"Eiweißstoffe, Klebstoffe, Enzyme",232984000,156698000,389682000
2012,10,WA36,"Sprengstoffe, pyrotechnische Artikel usw.",19387000,36859000,56246000
2012,10,WA37,Photochemische Erzeugnisse,97180000,64291000,161471000
2012,10,WA38,Verschiedene Erzeugnisse der Chemischen Industrie,1524676000,946533000,2471209000
2012,10,WA39,Kunststoffe und Waren daraus,4468535000,2764998000,7233533000
2012,10,WA40,Kautschuk und Waren daraus,1292566000,1256264000,2548830000
2012,10,WA41,"Häute, Felle, Leder",101414000,85052000,186466000
2012,10,WA42,"Lederwaren, Sattlerwaren",138983000,260304000,399287000
2012,10,WA43,"Pelzfelle, künstliches Pelzwerk",20377000,14882000,35259000
2012,10,WA44,"Holz, Holzwaren, Holzkohle",600963000,574003000,1174966000
2012,10,WA45,"Kork, Korkwaren",3053000,9093000,12146000
2012,10,WA46,"Flechtwaren, Korbmacherwaren",4213000,11726000,15939000
2012,10,WA47,"Halbstoffe aus Holz usw., Papierabfall",89415000,309897000,399312000
2012,10,WA48,"Papier, Pappe und Waren daraus",1546861000,1049362000,2596223000
2012,10,WA49,"Bücher, Zeitungen, Bilddrucke usw.",400217000,190241000,590458000
2012,10,WA50,Seide,7490000,9290000,16780000
2012,10,WA51,"Wolle, feine und grobe Tierhaare",49893000,70299000,120192000
2012,10,WA52,Baumwolle,102116000,102804000,204920000
2012,10,WA53,"Andere pflanzliche Spinnstoffe, Papiergarn",4730000,8452000,13182000
2012,10,WA54,Synthetisches oder künstliches Filament,171345000,131274000,302619000
2012,10,WA55,Synthetische oder künstliche Spinnfaser,164014000,139783000,303797000
2012,10,WA56,"Watte, Filz, Vliesstoff usw., Tauwerk",186151000,102085000,288236000
2012,10,WA57,"Teppiche, Fußbodenbelag aus Spinnstoff",47184000,89162000,136346000
2012,10,WA58,"Spezialgewebe, Spitzen, Tapisserien",43807000,29149000,72956000
2012,10,WA59,"Getränkte, bestrichene usw. Gewebe",173442000,99178000,272620000
2012,10,WA60,Gewirke und Gestricke,70827000,43929000,114756000
2012,10,WA61,"Bekleidung usw. aus Gewirken, Gestricken",570756000,1180053000,1750809000
2012,10,WA62,"Andere Bekleidung, Bekleidungszubehör",632703000,1108093000,1740796000
2012,10,WA63,"Andere Konfektion, Spinnstoffwaren usw.",199621000,284634000,484255000
2012,10,WA64,"Schuhe, Gamaschen, ähnliche Waren",262274000,546718000,808992000
2012,10,WA65,Kopfbedeckungen und Teile davon,32304000,41517000,73821000
2012,10,WA66,"Schirme, Gehstöcke usw., Peitschen",6733000,9604000,16337000
2012,10,WA67,"Zugerichtete Federn, Daunen, künstliche Blumen",8504000,12951000,21455000
2012,10,WA68,"Waren aus Steinen, Gips, Zement usw.",339114000,234520000,573634000
2012,10,WA69,Keramische Waren,279973000,212874000,492847000
2012,10,WA70,Glas und Glaswaren,456792000,371521000,828313000
2012,10,WA71,"Perlen, Edelsteine, Edelmetalle",1365801000,1434970000,2800771000
2012,10,WA72,Eisen und Stahl,2124820000,2063206000,4188026000
2012,10,WA73,Waren aus Eisen oder Stahl,2381528000,1565562000,3947090000
2012,10,WA74,Kupfer und Waren daraus,1026779000,1076185000,2102964000
2012,10,WA75,Nickel und Waren daraus,87507000,256661000,344168000
2012,10,WA76,Aluminium und Waren daraus,1127043000,1190613000,2317656000
2012,10,WA78,Blei und Waren daraus,48202000,26830000,75032000
2012,10,WA79,Zink und Waren daraus,54926000,105337000,160263000
2012,10,WA80,Zinn und Waren daraus,9505000,37156000,46661000
2012,10,WA81,"Andere unedle Metalle, Cermets usw.",103853000,141090000,244943000
2012,10,WA82,"Werkzeuge, Schneidwaren, Essbestecke",610534000,376861000,987395000
2012,10,WA83,Verschiedene Waren aus unedlen Metallen,569301000,341692000,910993000
2012,10,WA84,"Maschinen, Apparate, mechanische Geräte",16509690000,9783149000,26292839000
2012,10,WA85,Elektrotechnische Erzeugnisse,9498351000,8975287000,18473638000
2012,10,WA86,Schienenfahrzeuge,296854000,158720000,455574000
2012,10,WA87,"Kraftfahrzeuge, Landfahrzeuge",16577655000,6634091000,23211746000
2012,10,WA88,"Luftfahrzeuge, Raumfahrzeuge",3361206000,1407198000,4768404000
2012,10,WA89,Wasserfahrzeuge,70078000,324754000,394832000
2012,10,WA90,"Optische, photografische usw. Erzeugnisse",4451535000,2496996000,6948531000
2012,10,WA91,Uhrmacherwaren,154529000,216174000,370703000
2012,10,WA92,Musikinstrumente,52914000,50277000,103191000
2012,10,WA93,Waffen und Munition,47666000,20162000,67828000
2012,10,WA94,"Möbel, Beleuchtungskörper usw.",1273653000,1302197000,2575850000
2012,10,WA95,"Spielzeug, Spiele usw., Sportgeräte",402051000,590433000,992484000
2012,10,WA96,Verschiedene Waren,298232000,213905000,512137000
2012,10,WA97,"Kunstgegenstände, Sammlungsstücke",77221000,44287000,121508000
2012,10,WA98,Vollständige Fabrikationsanlagen,283644000,11511000,295155000
2012,10,WA99,Zusammenstellungen verschiedener Waren,1605422000,914190000,2519612000
2012,11,WA01,Lebende Tiere,105366000,149019000,254385000
2012,11,WA02,Fleisch,681887000,508364000,1190251000
2012,11,WA03,"Fische, Krebs- und Weichtiere",115913000,279991000,395904000
2012,11,WA04,"Milch, Milcherzeugnisse, Eier, Honig",669347000,507293000,1176640000
2012,11,WA05,Andere Waren tierischen Ursprungs,64114000,72144000,136258000
2012,11,WA06,"Pflanzen, Waren des Blumenhandels",52887000,195954000,248841000
2012,11,WA07,"Gemüse, Pflanzen für Ernährung",70514000,346669000,417183000
2012,11,WA08,Genießbare Früchte und Nüsse,106309000,579163000,685472000
2012,11,WA09,"Kaffee, Tee, Mate, Gewürze",213163000,372180000,585343000
2012,11,WA10,Getreide,354985000,283584000,638569000
2012,11,WA11,"Müllereierzeugnisse, Malz usw.",100114000,47125000,147239000
2012,11,WA12,"Ölsamen usw., Heilpflanzen usw.",69117000,482286000,551403000
2012,11,WA13,"Schellack, Gummen, Harz, Pflanzensaft",40290000,35614000,75904000
2012,11,WA14,Flechtstoffe usw. pflanzlichen Ursprungs,710000,1803000,2513000
2012,11,WA15,"Tierische und pflanzliche Fette, Öle, Wachs",253906000,280810000,534716000
2012,11,WA16,"Zubereitungen von Fleisch, Fisch usw.",204096000,207589000,411685000
2012,11,WA17,Zucker und Zuckerwaren,211307000,141042000,352349000
2012,11,WA18,Kakao und Zubereitungen aus Kakao,383746000,273315000,657061000
2012,11,WA19,"Zubereitungen aus Getreide usw., Backwaren",438848000,230809000,669657000
2012,11,WA20,"Zubereitungen von Gemüse, Früchten usw.",185808000,357671000,543479000
2012,11,WA21,Verschiedene Lebensmittelzubereitungen,357879000,200051000,557930000
2012,11,WA22,"Getränke, alkoholhaltige Flüssigkeiten, Essig",424900000,608155000,1033055000
2012,11,WA23,"Rückstände der Lebensmittelindustrie, Futter",334512000,307449000,641961000
2012,11,WA24,Tabak,325025000,169778000,494803000
2012,11,WA25,"Salz, Schwefel, Steine, Erden usw.",156851000,140571000,297422000
2012,11,WA26,"Erze, Schlacken, Aschen",29362000,632785000,662147000
2012,11,WA27,Mineralische Brennstoffe usw.,2215098000,10428870000,12643968000
2012,11,WA28,Anorganische chemische Erzeugnisse,648116000,580416000,1228532000
2012,11,WA29,Organische chemische Erzeugnisse,2084114000,2740238000,4824352000
2012,11,WA30,Pharmazeutische Erzeugnisse,4800410000,2920083000,7720493000
2012,11,WA31,Düngemittel,237770000,121865000,359635000
2012,11,WA32,"Gerb- und Farbstoffe, Farben, Lacke usw.",785026000,343693000,1128719000
2012,11,WA33,"Etherische Öle, Riech-, Schönheitsmittel",737459000,425087000,1162546000
2012,11,WA34,"Seifen, Waschmittel usw.",522681000,268963000,791644000
2012,11,WA35,"Eiweißstoffe, Klebstoffe, Enzyme",230223000,153053000,383276000
2012,11,WA36,"Sprengstoffe, pyrotechnische Artikel usw.",19673000,27626000,47299000
2012,11,WA37,Photochemische Erzeugnisse,86738000,57760000,144498000
2012,11,WA38,Verschiedene Erzeugnisse der Chemischen Industrie,1516622000,835421000,2352043000
2012,11,WA39,Kunststoffe und Waren daraus,4123129000,2502068000,6625197000
2012,11,WA40,Kautschuk und Waren daraus,1158857000,994969000,2153826000
2012,11,WA41,"Häute, Felle, Leder",87751000,74490000,162241000
2012,11,WA42,"Lederwaren, Sattlerwaren",126522000,244944000,371466000
2012,11,WA43,"Pelzfelle, künstliches Pelzwerk",14872000,12226000,27098000
2012,11,WA44,"Holz, Holzwaren, Holzkohle",534693000,503442000,1038135000
2012,11,WA45,"Kork, Korkwaren",2478000,6765000,9243000
2012,11,WA46,"Flechtwaren, Korbmacherwaren",3418000,8881000,12299000
2012,11,WA47,"Halbstoffe aus Holz usw., Papierabfall",85921000,282742000,368663000
2012,11,WA48,"Papier, Pappe und Waren daraus",1487737000,971508000,2459245000
2012,11,WA49,"Bücher, Zeitungen, Bilddrucke usw.",348314000,174347000,522661000
2012,11,WA50,Seide,8203000,9519000,17722000
2012,11,WA51,"Wolle, feine und grobe Tierhaare",55115000,65529000,120644000
2012,11,WA52,Baumwolle,102267000,96043000,198310000
2012,11,WA53,"Andere pflanzliche Spinnstoffe, Papiergarn",5328000,7551000,12879000
2012,11,WA54,Synthetisches oder künstliches Filament,153448000,113528000,266976000
2012,11,WA55,Synthetische oder künstliche Spinnfaser,154480000,128112000,282592000
2012,11,WA56,"Watte, Filz, Vliesstoff usw., Tauwerk",171905000,90339000,262244000
2012,11,WA57,"Teppiche, Fußbodenbelag aus Spinnstoff",40841000,81290000,122131000
2012,11,WA58,"Spezialgewebe, Spitzen, Tapisserien",39137000,26122000,65259000
2012,11,WA59,"Getränkte, bestrichene usw. Gewebe",164003000,89894000,253897000
2012,11,WA60,Gewirke und Gestricke,65991000,38477000,104468000
2012,11,WA61,"Bekleidung usw. aus Gewirken, Gestricken",483795000,1016753000,1500548000
2012,11,WA62,"Andere Bekleidung, Bekleidungszubehör",457146000,943710000,1400856000
2012,11,WA63,"Andere Konfektion, Spinnstoffwaren usw.",179024000,262098000,441122000
2012,11,WA64,"Schuhe, Gamaschen, ähnliche Waren",187968000,447776000,635744000
2012,11,WA65,Kopfbedeckungen und Teile davon,21575000,32425000,54000000
2012,11,WA66,"Schirme, Gehstöcke usw., Peitschen",6097000,7771000,13868000
2012,11,WA67,"Zugerichtete Federn, Daunen, künstliche Blumen",6834000,13724000,20558000
2012,11,WA68,"Waren aus Steinen, Gips, Zement usw.",287868000,201656000,489524000
2012,11,WA69,Keramische Waren,239955000,187575000,427530000
2012,11,WA70,Glas und Glaswaren,421758000,312485000,734243000
2012,11,WA71,"Perlen, Edelsteine, Edelmetalle",1280850000,1339876000,2620726000
2012,11,WA72,Eisen und Stahl,1937351000,1847021000,3784372000
2012,11,WA73,Waren aus Eisen oder Stahl,2011851000,1373020000,3384871000
2012,11,WA74,Kupfer und Waren daraus,951237000,794977000,1746214000
2012,11,WA75,Nickel und Waren daraus,84616000,148613000,233229000
2012,11,WA76,Aluminium und Waren daraus,1025970000,990792000,2016762000
2012,11,WA78,Blei und Waren daraus,37110000,17345000,54455000
2012,11,WA79,Zink und Waren daraus,50523000,85337000,135860000
2012,11,WA80,Zinn und Waren daraus,9979000,18929000,28908000
2012,11,WA81,"Andere unedle Metalle, Cermets usw.",101898000,109759000,211657000
2012,11,WA82,"Werkzeuge, Schneidwaren, Essbestecke",574090000,331604000,905694000
2012,11,WA83,Verschiedene Waren aus unedlen Metallen,533693000,308378000,842071000
2012,11,WA84,"Maschinen, Apparate, mechanische Geräte",16100860000,9439111000,25539971000
2012,11,WA85,Elektrotechnische Erzeugnisse,9295100000,8517602000,17812702000
2012,11,WA86,Schienenfahrzeuge,293432000,190936000,484368000
2012,11,WA87,"Kraftfahrzeuge, Landfahrzeuge",15713725000,6107646000,21821371000
2012,11,WA88,"Luftfahrzeuge, Raumfahrzeuge",3523636000,2383998000,5907634000
2012,11,WA89,Wasserfahrzeuge,100900000,267435000,368335000
2012,11,WA90,"Optische, photografische usw. Erzeugnisse",4545723000,2366558000,6912281000
2012,11,WA91,Uhrmacherwaren,162699000,209530000,372229000
2012,11,WA92,Musikinstrumente,52979000,60702000,113681000
2012,11,WA93,Waffen und Munition,42392000,15411000,57803000
2012,11,WA94,"Möbel, Beleuchtungskörper usw.",1150325000,1176863000,2327188000
2012,11,WA95,"Spielzeug, Spiele usw., Sportgeräte",457944000,618611000,1076555000
2012,11,WA96,Verschiedene Waren,286276000,184620000,470896000
2012,11,WA97,"Kunstgegenstände, Sammlungsstücke",112751000,24207000,136958000
2012,11,WA98,Vollständige Fabrikationsanlagen,304290000,519000,304809000
2012,11,WA99,Zusammenstellungen verschiedener Waren,1541687000,1002885000,2544572000
2012,12,WA01,Lebende Tiere,119759000,144316000,264075000
2012,12,WA02,Fleisch,631320000,542808000,1174128000
2012,12,WA03,"Fische, Krebs- und Weichtiere",103678000,268090000,371768000
2012,12,WA04,"Milch, Milcherzeugnisse, Eier, Honig",629912000,562951000,1192863000
2012,12,WA05,Andere Waren tierischen Ursprungs,56217000,65058000,121275000
2012,12,WA06,"Pflanzen, Waren des Blumenhandels",49839000,180803000,230642000
2012,12,WA07,"Gemüse, Pflanzen für Ernährung",70707000,428395000,499102000
2012,12,WA08,Genießbare Früchte und Nüsse,107271000,580383000,687654000
2012,12,WA09,"Kaffee, Tee, Mate, Gewürze",167190000,288533000,455723000
2012,12,WA10,Getreide,219376000,197267000,416643000
2012,12,WA11,"Müllereierzeugnisse, Malz usw.",97256000,37918000,135174000
2012,12,WA12,"Ölsamen usw., Heilpflanzen usw.",73247000,350501000,423748000
2012,12,WA13,"Schellack, Gummen, Harz, Pflanzensaft",33227000,29444000,62671000
2012,12,WA14,Flechtstoffe usw. pflanzlichen Ursprungs,967000,1554000,2521000
2012,12,WA15,"Tierische und pflanzliche Fette, Öle, Wachs",219815000,242867000,462682000
2012,12,WA16,"Zubereitungen von Fleisch, Fisch usw.",206277000,201133000,407410000
2012,12,WA17,Zucker und Zuckerwaren,160944000,109279000,270223000
2012,12,WA18,Kakao und Zubereitungen aus Kakao,304062000,205093000,509155000
2012,12,WA19,"Zubereitungen aus Getreide usw., Backwaren",353416000,220928000,574344000
2012,12,WA20,"Zubereitungen von Gemüse, Früchten usw.",174165000,349106000,523271000
2012,12,WA21,Verschiedene Lebensmittelzubereitungen,326304000,178648000,504952000
2012,12,WA22,"Getränke, alkoholhaltige Flüssigkeiten, Essig",385291000,539442000,924733000
2012,12,WA23,"Rückstände der Lebensmittelindustrie, Futter",309898000,327194000,637092000
2012,12,WA24,Tabak,285339000,129253000,414592000
2012,12,WA25,"Salz, Schwefel, Steine, Erden usw.",123637000,133187000,256824000
2012,12,WA26,"Erze, Schlacken, Aschen",29693000,644459000,674152000
2012,12,WA27,Mineralische Brennstoffe usw.,2402050000,11863600000,14265650000
2012,12,WA28,Anorganische chemische Erzeugnisse,655796000,536397000,1192193000
2012,12,WA29,Organische chemische Erzeugnisse,1851433000,1788381000,3639814000
2012,12,WA30,Pharmazeutische Erzeugnisse,3852518000,2269694000,6122212000
2012,12,WA31,Düngemittel,164701000,92362000,257063000
2012,12,WA32,"Gerb- und Farbstoffe, Farben, Lacke usw.",646510000,399279000,1045789000
2012,12,WA33,"Etherische Öle, Riech-, Schönheitsmittel",571244000,379766000,951010000
2012,12,WA34,"Seifen, Waschmittel usw.",398969000,228721000,627690000
2012,12,WA35,"Eiweißstoffe, Klebstoffe, Enzyme",192111000,126911000,319022000
2012,12,WA36,"Sprengstoffe, pyrotechnische Artikel usw.",29482000,24544000,54026000
2012,12,WA37,Photochemische Erzeugnisse,100988000,68165000,169153000
2012,12,WA38,Verschiedene Erzeugnisse der Chemischen Industrie,1218608000,817042000,2035650000
2012,12,WA39,Kunststoffe und Waren daraus,3167370000,2147122000,5314492000
2012,12,WA40,Kautschuk und Waren daraus,893744000,728384000,1622128000
2012,12,WA41,"Häute, Felle, Leder",67732000,58999000,126731000
2012,12,WA42,"Lederwaren, Sattlerwaren",114079000,232931000,347010000
2012,12,WA43,"Pelzfelle, künstliches Pelzwerk",10684000,14081000,24765000
2012,12,WA44,"Holz, Holzwaren, Holzkohle",382741000,422653000,805394000
2012,12,WA45,"Kork, Korkwaren",1994000,5619000,7613000
2012,12,WA46,"Flechtwaren, Korbmacherwaren",2457000,8082000,10539000
2012,12,WA47,"Halbstoffe aus Holz usw., Papierabfall",79580000,252670000,332250000
2012,12,WA48,"Papier, Pappe und Waren daraus",1198741000,802630000,2001371000
2012,12,WA49,"Bücher, Zeitungen, Bilddrucke usw.",344444000,146730000,491174000
2012,12,WA50,Seide,7935000,6773000,14708000
2012,12,WA51,"Wolle, feine und grobe Tierhaare",43002000,56948000,99950000
2012,12,WA52,Baumwolle,77367000,76495000,153862000
2012,12,WA53,"Andere pflanzliche Spinnstoffe, Papiergarn",5227000,7251000,12478000
2012,12,WA54,Synthetisches oder künstliches Filament,117118000,88472000,205590000
2012,12,WA55,Synthetische oder künstliche Spinnfaser,126469000,99751000,226220000
2012,12,WA56,"Watte, Filz, Vliesstoff usw., Tauwerk",126268000,79324000,205592000
2012,12,WA57,"Teppiche, Fußbodenbelag aus Spinnstoff",36144000,73829000,109973000
2012,12,WA58,"Spezialgewebe, Spitzen, Tapisserien",27987000,20713000,48700000
2012,12,WA59,"Getränkte, bestrichene usw. Gewebe",124568000,71940000,196508000
2012,12,WA60,Gewirke und Gestricke,49050000,30893000,79943000
2012,12,WA61,"Bekleidung usw. aus Gewirken, Gestricken",384257000,834062000,1218319000
2012,12,WA62,"Andere Bekleidung, Bekleidungszubehör",388817000,855689000,1244506000
2012,12,WA63,"Andere Konfektion, Spinnstoffwaren usw.",146697000,225725000,372422000
2012,12,WA64,"Schuhe, Gamaschen, ähnliche Waren",172708000,471655000,644363000
2012,12,WA65,Kopfbedeckungen und Teile davon,16027000,29603000,45630000
2012,12,WA66,"Schirme, Gehstöcke usw., Peitschen",3504000,9550000,13054000
2012,12,WA67,"Zugerichtete Federn, Daunen, künstliche Blumen",5217000,13912000,19129000
2012,12,WA68,"Waren aus Steinen, Gips, Zement usw.",216912000,162238000,379150000
2012,12,WA69,Keramische Waren,198077000,149963000,348040000
2012,12,WA70,Glas und Glaswaren,331641000,241186000,572827000
2012,12,WA71,"Perlen, Edelsteine, Edelmetalle",1167240000,1087231000,2254471000
2012,12,WA72,Eisen und Stahl,1432426000,1370633000,2803059000
2012,12,WA73,Waren aus Eisen oder Stahl,1566616000,1098390000,2665006000
2012,12,WA74,Kupfer und Waren daraus,863012000,688294000,1551306000
2012,12,WA75,Nickel und Waren daraus,75640000,93197000,168837000
2012,12,WA76,Aluminium und Waren daraus,752385000,800935000,1553320000
2012,12,WA78,Blei und Waren daraus,41145000,37479000,78624000
2012,12,WA79,Zink und Waren daraus,34582000,69997000,104579000
2012,12,WA80,Zinn und Waren daraus,6768000,22439000,29207000
2012,12,WA81,"Andere unedle Metalle, Cermets usw.",88252000,104558000,192810000
2012,12,WA82,"Werkzeuge, Schneidwaren, Essbestecke",444677000,286089000,730766000
2012,12,WA83,Verschiedene Waren aus unedlen Metallen,377315000,238862000,616177000
2012,12,WA84,"Maschinen, Apparate, mechanische Geräte",14851422000,8153261000,23004683000
2012,12,WA85,Elektrotechnische Erzeugnisse,7665467000,6773653000,14439120000
2012,12,WA86,Schienenfahrzeuge,249146000,155425000,404571000
2012,12,WA87,"Kraftfahrzeuge, Landfahrzeuge",11689985000,4666761000,16356746000
2012,12,WA88,"Luftfahrzeuge, Raumfahrzeuge",3131793000,1021835000,4153628000
2012,12,WA89,Wasserfahrzeuge,172046000,598440000,770486000
2012,12,WA90,"Optische, photografische usw. Erzeugnisse",3914700000,2085797000,6000497000
2012,12,WA91,Uhrmacherwaren,141870000,167422000,309292000
2012,12,WA92,Musikinstrumente,44586000,42898000,87484000
2012,12,WA93,Waffen und Munition,33753000,14159000,47912000
2012,12,WA94,"Möbel, Beleuchtungskörper usw.",926197000,981552000,1907749000
2012,12,WA95,"Spielzeug, Spiele usw., Sportgeräte",370173000,466051000,836224000
2012,12,WA96,Verschiedene Waren,243668000,166394000,410062000
2012,12,WA97,"Kunstgegenstände, Sammlungsstücke",47802000,32579000,80381000
2012,12,WA98,Vollständige Fabrikationsanlagen,204141000,1626000,205767000
2012,12,WA99,Zusammenstellungen verschiedener Waren,1488361000,786389000,2274750000
2013,1,WA01,Lebende Tiere,140536000,186662000,327198000
2013,1,WA02,Fleisch,659866000,508336000,1168202000
2013,1,WA03,"Fische, Krebs- und Weichtiere",92019000,275364000,367383000
2013,1,WA04,"Milch, Milcherzeugnisse, Eier, Honig",761427000,523935000,1285362000
2013,1,WA05,Andere Waren tierischen Ursprungs,80740000,81887000,162627000
2013,1,WA06,"Pflanzen, Waren des Blumenhandels",40345000,175119000,215464000
2013,1,WA07,"Gemüse, Pflanzen für Ernährung",104456000,441061000,545517000
2013,1,WA08,Genießbare Früchte und Nüsse,110854000,550848000,661702000
2013,1,WA09,"Kaffee, Tee, Mate, Gewürze",209973000,368401000,578374000
2013,1,WA10,Getreide,292914000,256190000,549104000
2013,1,WA11,"Müllereierzeugnisse, Malz usw.",103996000,42896000,146892000
2013,1,WA12,"Ölsamen usw., Heilpflanzen usw.",106714000,388523000,495237000
2013,1,WA13,"Schellack, Gummen, Harz, Pflanzensaft",43845000,43064000,86909000
2013,1,WA14,Flechtstoffe usw. pflanzlichen Ursprungs,765000,1918000,2683000
2013,1,WA15,"Tierische und pflanzliche Fette, Öle, Wachs",249780000,274363000,524143000
2013,1,WA16,"Zubereitungen von Fleisch, Fisch usw.",236046000,201760000,437806000
2013,1,WA17,Zucker und Zuckerwaren,160059000,127459000,287518000
2013,1,WA18,Kakao und Zubereitungen aus Kakao,303230000,288215000,591445000
2013,1,WA19,"Zubereitungen aus Getreide usw., Backwaren",414635000,243050000,657685000
2013,1,WA20,"Zubereitungen von Gemüse, Früchten usw.",188062000,334237000,522299000
2013,1,WA21,Verschiedene Lebensmittelzubereitungen,378218000,211487000,589705000
2013,1,WA22,"Getränke, alkoholhaltige Flüssigkeiten, Essig",361059000,518076000,879135000
2013,1,WA23,"Rückstände der Lebensmittelindustrie, Futter",316055000,357411000,673466000
2013,1,WA24,Tabak,303057000,137044000,440101000
2013,1,WA25,"Salz, Schwefel, Steine, Erden usw.",148304000,130397000,278701000
2013,1,WA26,"Erze, Schlacken, Aschen",24528000,696164000,720692000
2013,1,WA27,Mineralische Brennstoffe usw.,2392387000,10842019000,13234406000
2013,1,WA28,Anorganische chemische Erzeugnisse,722567000,488963000,1211530000
2013,1,WA29,Organische chemische Erzeugnisse,2684939000,2151015000,4835954000
2013,1,WA30,Pharmazeutische Erzeugnisse,4631365000,2562831000,7194196000
2013,1,WA31,Düngemittel,238103000,134748000,372851000
2013,1,WA32,"Gerb- und Farbstoffe, Farben, Lacke usw.",884399000,462913000,1347312000
2013,1,WA33,"Etherische Öle, Riech-, Schönheitsmittel",703649000,434248000,1137897000
2013,1,WA34,"Seifen, Waschmittel usw.",538247000,284793000,823040000
2013,1,WA35,"Eiweißstoffe, Klebstoffe, Enzyme",226777000,163126000,389903000
2013,1,WA36,"Sprengstoffe, pyrotechnische Artikel usw.",15613000,11441000,27054000
2013,1,WA37,Photochemische Erzeugnisse,96029000,61026000,157055000
2013,1,WA38,Verschiedene Erzeugnisse der Chemischen Industrie,1658051000,913805000,2571856000
2013,1,WA39,Kunststoffe und Waren daraus,4274151000,2692848000,6966999000
2013,1,WA40,Kautschuk und Waren daraus,1111326000,1069390000,2180716000
2013,1,WA41,"Häute, Felle, Leder",83680000,66752000,150432000
2013,1,WA42,"Lederwaren, Sattlerwaren",131392000,279351000,410743000
2013,1,WA43,"Pelzfelle, künstliches Pelzwerk",9415000,9856000,19271000
2013,1,WA44,"Holz, Holzwaren, Holzkohle",498413000,508468000,1006881000
2013,1,WA45,"Kork, Korkwaren",2473000,8260000,10733000
2013,1,WA46,"Flechtwaren, Korbmacherwaren",3246000,9759000,13005000
2013,1,WA47,"Halbstoffe aus Holz usw., Papierabfall",97060000,280987000,378047000
2013,1,WA48,"Papier, Pappe und Waren daraus",1447325000,983846000,2431171000
2013,1,WA49,"Bücher, Zeitungen, Bilddrucke usw.",340004000,157599000,497603000
2013,1,WA50,Seide,6986000,6509000,13495000
2013,1,WA51,"Wolle, feine und grobe Tierhaare",58655000,96652000,155307000
2013,1,WA52,Baumwolle,89385000,86745000,176130000
2013,1,WA53,"Andere pflanzliche Spinnstoffe, Papiergarn",5570000,6948000,12518000
2013,1,WA54,Synthetisches oder künstliches Filament,155419000,119920000,275339000
2013,1,WA55,Synthetische oder künstliche Spinnfaser,161545000,125008000,286553000
2013,1,WA56,"Watte, Filz, Vliesstoff usw., Tauwerk",178154000,95666000,273820000
2013,1,WA57,"Teppiche, Fußbodenbelag aus Spinnstoff",41126000,99429000,140555000
2013,1,WA58,"Spezialgewebe, Spitzen, Tapisserien",36622000,23954000,60576000
2013,1,WA59,"Getränkte, bestrichene usw. Gewebe",168814000,95135000,263949000
2013,1,WA60,Gewirke und Gestricke,61990000,33123000,95113000
2013,1,WA61,"Bekleidung usw. aus Gewirken, Gestricken",547152000,1176466000,1723618000
2013,1,WA62,"Andere Bekleidung, Bekleidungszubehör",689588000,1306856000,1996444000
2013,1,WA63,"Andere Konfektion, Spinnstoffwaren usw.",163071000,274652000,437723000
2013,1,WA64,"Schuhe, Gamaschen, ähnliche Waren",373458000,744121000,1117579000
2013,1,WA65,Kopfbedeckungen und Teile davon,23894000,34414000,58308000
2013,1,WA66,"Schirme, Gehstöcke usw., Peitschen",6565000,21404000,27969000
2013,1,WA67,"Zugerichtete Federn, Daunen, künstliche Blumen",9558000,15707000,25265000
2013,1,WA68,"Waren aus Steinen, Gips, Zement usw.",266929000,188567000,455496000
2013,1,WA69,Keramische Waren,222306000,169629000,391935000
2013,1,WA70,Glas und Glaswaren,411972000,320789000,732761000
2013,1,WA71,"Perlen, Edelsteine, Edelmetalle",1327273000,1318966000,2646239000
2013,1,WA72,Eisen und Stahl,1966076000,2044947000,4011023000
2013,1,WA73,Waren aus Eisen oder Stahl,2000975000,1338699000,3339674000
2013,1,WA74,Kupfer und Waren daraus,943813000,942469000,1886282000
2013,1,WA75,Nickel und Waren daraus,96216000,158094000,254310000
2013,1,WA76,Aluminium und Waren daraus,1025580000,1054181000,2079761000
2013,1,WA78,Blei und Waren daraus,43081000,30392000,73473000
2013,1,WA79,Zink und Waren daraus,47012000,76148000,123160000
2013,1,WA80,Zinn und Waren daraus,10276000,32054000,42330000
2013,1,WA81,"Andere unedle Metalle, Cermets usw.",107032000,113010000,220042000
2013,1,WA82,"Werkzeuge, Schneidwaren, Essbestecke",566771000,347559000,914330000
2013,1,WA83,Verschiedene Waren aus unedlen Metallen,528448000,320074000,848522000
2013,1,WA84,"Maschinen, Apparate, mechanische Geräte",14699786000,9032258000,23732044000
2013,1,WA85,Elektrotechnische Erzeugnisse,8759493000,7891098000,16650591000
2013,1,WA86,Schienenfahrzeuge,250135000,187750000,437885000
2013,1,WA87,"Kraftfahrzeuge, Landfahrzeuge",13819748000,5268363000,19088111000
2013,1,WA88,"Luftfahrzeuge, Raumfahrzeuge",2116321000,1527204000,3643525000
2013,1,WA89,Wasserfahrzeuge,152342000,644615000,796957000
2013,1,WA90,"Optische, photografische usw. Erzeugnisse",3839596000,2205427000,6045023000
2013,1,WA91,Uhrmacherwaren,119738000,168427000,288165000
2013,1,WA92,Musikinstrumente,35929000,33683000,69612000
2013,1,WA93,Waffen und Munition,32475000,13721000,46196000
2013,1,WA94,"Möbel, Beleuchtungskörper usw.",1005332000,1218281000,2223613000
2013,1,WA95,"Spielzeug, Spiele usw., Sportgeräte",233822000,416157000,649979000
2013,1,WA96,Verschiedene Waren,289405000,208802000,498207000
2013,1,WA97,"Kunstgegenstände, Sammlungsstücke",36653000,35057000,71710000
2013,1,WA98,Vollständige Fabrikationsanlagen,444441000,3561000,448002000
2013,1,WA99,Zusammenstellungen verschiedener Waren,1321323000,852050000,2173373000
2013,2,WA01,Lebende Tiere,109258000,151770000,261028000
2013,2,WA02,Fleisch,618621000,459635000,1078256000
2013,2,WA03,"Fische, Krebs- und Weichtiere",96032000,237304000,333336000
2013,2,WA04,"Milch, Milcherzeugnisse, Eier, Honig",660464000,486439000,1146903000
2013,2,WA05,Andere Waren tierischen Ursprungs,68407000,73272000,141679000
2013,2,WA06,"Pflanzen, Waren des Blumenhandels",56390000,226998000,283388000
2013,2,WA07,"Gemüse, Pflanzen für Ernährung",79320000,461227000,540547000
2013,2,WA08,Genießbare Früchte und Nüsse,103357000,563334000,666691000
2013,2,WA09,"Kaffee, Tee, Mate, Gewürze",181965000,313352000,495317000
2013,2,WA10,Getreide,244606000,218332000,462938000
2013,2,WA11,"Müllereierzeugnisse, Malz usw.",106956000,37229000,144185000
2013,2,WA12,"Ölsamen usw., Heilpflanzen usw.",134271000,418455000,552726000
2013,2,WA13,"Schellack, Gummen, Harz, Pflanzensaft",40594000,39514000,80108000
2013,2,WA14,Flechtstoffe usw. pflanzlichen Ursprungs,982000,2025000,3007000
2013,2,WA15,"Tierische und pflanzliche Fette, Öle, Wachs",200167000,258893000,459060000
2013,2,WA16,"Zubereitungen von Fleisch, Fisch usw.",207925000,170230000,378155000
2013,2,WA17,Zucker und Zuckerwaren,151629000,113174000,264803000
2013,2,WA18,Kakao und Zubereitungen aus Kakao,315281000,231242000,546523000
2013,2,WA19,"Zubereitungen aus Getreide usw., Backwaren",385193000,245618000,630811000
2013,2,WA20,"Zubereitungen von Gemüse, Früchten usw.",175056000,325577000,500633000
2013,2,WA21,Verschiedene Lebensmittelzubereitungen,359359000,207520000,566879000
2013,2,WA22,"Getränke, alkoholhaltige Flüssigkeiten, Essig",370628000,499927000,870555000
2013,2,WA23,"Rückstände der Lebensmittelindustrie, Futter",304290000,270406000,574696000
2013,2,WA24,Tabak,307032000,156187000,463219000
2013,2,WA25,"Salz, Schwefel, Steine, Erden usw.",154192000,132921000,287113000
2013,2,WA26,"Erze, Schlacken, Aschen",27696000,561157000,588853000
2013,2,WA27,Mineralische Brennstoffe usw.,2388167000,11001667000,13389834000
2013,2,WA28,Anorganische chemische Erzeugnisse,736422000,477679000,1214101000
2013,2,WA29,Organische chemische Erzeugnisse,2105562000,1936935000,4042497000
2013,2,WA30,Pharmazeutische Erzeugnisse,4554030000,2803641000,7357671000
2013,2,WA31,Düngemittel,262918000,156443000,419361000
2013,2,WA32,"Gerb- und Farbstoffe, Farben, Lacke usw.",810417000,433156000,1243573000
2013,2,WA33,"Etherische Öle, Riech-, Schönheitsmittel",666669000,397723000,1064392000
2013,2,WA34,"Seifen, Waschmittel usw.",506950000,256064000,763014000
2013,2,WA35,"Eiweißstoffe, Klebstoffe, Enzyme",225049000,148162000,373211000
2013,2,WA36,"Sprengstoffe, pyrotechnische Artikel usw.",17157000,10671000,27828000
2013,2,WA37,Photochemische Erzeugnisse,87084000,59021000,146105000
2013,2,WA38,Verschiedene Erzeugnisse der Chemischen Industrie,1544981000,930702000,2475683000
2013,2,WA39,Kunststoffe und Waren daraus,4127311000,2546561000,6673872000
2013,2,WA40,Kautschuk und Waren daraus,1100148000,1069955000,2170103000
2013,2,WA41,"Häute, Felle, Leder",83482000,75146000,158628000
2013,2,WA42,"Lederwaren, Sattlerwaren",137966000,259122000,397088000
2013,2,WA43,"Pelzfelle, künstliches Pelzwerk",14809000,11283000,26092000
2013,2,WA44,"Holz, Holzwaren, Holzkohle",510587000,514983000,1025570000
2013,2,WA45,"Kork, Korkwaren",1849000,5776000,7625000
2013,2,WA46,"Flechtwaren, Korbmacherwaren",2774000,7953000,10727000
2013,2,WA47,"Halbstoffe aus Holz usw., Papierabfall",101509000,276148000,377657000
2013,2,WA48,"Papier, Pappe und Waren daraus",1270205000,874812000,2145017000
2013,2,WA49,"Bücher, Zeitungen, Bilddrucke usw.",328648000,141029000,469677000
2013,2,WA50,Seide,5129000,5869000,10998000
2013,2,WA51,"Wolle, feine und grobe Tierhaare",47544000,47832000,95376000
2013,2,WA52,Baumwolle,74884000,76401000,151285000
2013,2,WA53,"Andere pflanzliche Spinnstoffe, Papiergarn",3996000,5477000,9473000
2013,2,WA54,Synthetisches oder künstliches Filament,150467000,103525000,253992000
2013,2,WA55,Synthetische oder künstliche Spinnfaser,153320000,117464000,270784000
2013,2,WA56,"Watte, Filz, Vliesstoff usw., Tauwerk",169548000,94016000,263564000
2013,2,WA57,"Teppiche, Fußbodenbelag aus Spinnstoff",43288000,90562000,133850000
2013,2,WA58,"Spezialgewebe, Spitzen, Tapisserien",34257000,22023000,56280000
2013,2,WA59,"Getränkte, bestrichene usw. Gewebe",164542000,86939000,251481000
2013,2,WA60,Gewirke und Gestricke,59165000,29597000,88762000
2013,2,WA61,"Bekleidung usw. aus Gewirken, Gestricken",524967000,1006625000,1531592000
2013,2,WA62,"Andere Bekleidung, Bekleidungszubehör",681459000,1165370000,1846829000
2013,2,WA63,"Andere Konfektion, Spinnstoffwaren usw.",158753000,247650000,406403000
2013,2,WA64,"Schuhe, Gamaschen, ähnliche Waren",376292000,737579000,1113871000
2013,2,WA65,Kopfbedeckungen und Teile davon,24667000,34542000,59209000
2013,2,WA66,"Schirme, Gehstöcke usw., Peitschen",6450000,22303000,28753000
2013,2,WA67,"Zugerichtete Federn, Daunen, künstliche Blumen",9323000,14366000,23689000
2013,2,WA68,"Waren aus Steinen, Gips, Zement usw.",275124000,187911000,463035000
2013,2,WA69,Keramische Waren,207665000,168722000,376387000
2013,2,WA70,Glas und Glaswaren,399940000,295282000,695222000
2013,2,WA71,"Perlen, Edelsteine, Edelmetalle",1117989000,1290393000,2408382000
2013,2,WA72,Eisen und Stahl,1929307000,1895544000,3824851000
2013,2,WA73,Waren aus Eisen oder Stahl,2066865000,1322974000,3389839000
2013,2,WA74,Kupfer und Waren daraus,960478000,854677000,1815155000
2013,2,WA75,Nickel und Waren daraus,83959000,130203000,214162000
2013,2,WA76,Aluminium und Waren daraus,1003759000,1108099000,2111858000
2013,2,WA78,Blei und Waren daraus,37432000,36431000,73863000
2013,2,WA79,Zink und Waren daraus,44380000,86679000,131059000
2013,2,WA80,Zinn und Waren daraus,10021000,38602000,48623000
2013,2,WA81,"Andere unedle Metalle, Cermets usw.",104852000,129606000,234458000
2013,2,WA82,"Werkzeuge, Schneidwaren, Essbestecke",559717000,321314000,881031000
2013,2,WA83,Verschiedene Waren aus unedlen Metallen,509385000,309045000,818430000
2013,2,WA84,"Maschinen, Apparate, mechanische Geräte",14951763000,8616642000,23568405000
2013,2,WA85,Elektrotechnische Erzeugnisse,8169773000,7178814000,15348587000
2013,2,WA86,Schienenfahrzeuge,239046000,177842000,416888000
2013,2,WA87,"Kraftfahrzeuge, Landfahrzeuge",15172027000,5757290000,20929317000
2013,2,WA88,"Luftfahrzeuge, Raumfahrzeuge",2691978000,1234845000,3926823000
2013,2,WA89,Wasserfahrzeuge,238043000,121191000,359234000
2013,2,WA90,"Optische, photografische usw. Erzeugnisse",3948717000,2128916000,6077633000
2013,2,WA91,Uhrmacherwaren,121224000,157308000,278532000
2013,2,WA92,Musikinstrumente,36489000,43303000,79792000
2013,2,WA93,Waffen und Munition,40011000,12996000,53007000
2013,2,WA94,"Möbel, Beleuchtungskörper usw.",1040234000,1234921000,2275155000
2013,2,WA95,"Spielzeug, Spiele usw., Sportgeräte",247722000,390170000,637892000
2013,2,WA96,Verschiedene Waren,259095000,181534000,440629000
2013,2,WA97,"Kunstgegenstände, Sammlungsstücke",39980000,17788000,57768000
2013,2,WA98,Vollständige Fabrikationsanlagen,284278000,1101000,285379000
2013,2,WA99,Zusammenstellungen verschiedener Waren,1338823000,727144000,2065967000
2013,3,WA01,Lebende Tiere,130085000,170570000,300655000
2013,3,WA02,Fleisch,661414000,520399000,1181813000
2013,3,WA03,"Fische, Krebs- und Weichtiere",104228000,271928000,376156000
2013,3,WA04,"Milch, Milcherzeugnisse, Eier, Honig",714343000,544286000,1258629000
2013,3,WA05,Andere Waren tierischen Ursprungs,71654000,74724000,146378000
2013,3,WA06,"Pflanzen, Waren des Blumenhandels",102122000,309594000,411716000
2013,3,WA07,"Gemüse, Pflanzen für Ernährung",99363000,548220000,647583000
2013,3,WA08,Genießbare Früchte und Nüsse,118561000,568765000,687326000
2013,3,WA09,"Kaffee, Tee, Mate, Gewürze",194132000,302166000,496298000
2013,3,WA10,Getreide,334982000,254817000,589799000
2013,3,WA11,"Müllereierzeugnisse, Malz usw.",104743000,46078000,150821000
2013,3,WA12,"Ölsamen usw., Heilpflanzen usw.",136995000,410749000,547744000
2013,3,WA13,"Schellack, Gummen, Harz, Pflanzensaft",45580000,41317000,86897000
2013,3,WA14,Flechtstoffe usw. pflanzlichen Ursprungs,743000,2410000,3153000
2013,3,WA15,"Tierische und pflanzliche Fette, Öle, Wachs",287586000,254322000,541908000
2013,3,WA16,"Zubereitungen von Fleisch, Fisch usw.",224332000,188162000,412494000
2013,3,WA17,Zucker und Zuckerwaren,152318000,133318000,285636000
2013,3,WA18,Kakao und Zubereitungen aus Kakao,273928000,224151000,498079000
2013,3,WA19,"Zubereitungen aus Getreide usw., Backwaren",422702000,247886000,670588000
2013,3,WA20,"Zubereitungen von Gemüse, Früchten usw.",202328000,331142000,533470000
2013,3,WA21,Verschiedene Lebensmittelzubereitungen,384413000,217485000,601898000
2013,3,WA22,"Getränke, alkoholhaltige Flüssigkeiten, Essig",384936000,533624000,918560000
2013,3,WA23,"Rückstände der Lebensmittelindustrie, Futter",308320000,262130000,570450000
2013,3,WA24,Tabak,337353000,156134000,493487000
2013,3,WA25,"Salz, Schwefel, Steine, Erden usw.",164400000,146219000,310619000
2013,3,WA26,"Erze, Schlacken, Aschen",33158000,844618000,877776000
2013,3,WA27,Mineralische Brennstoffe usw.,2612270000,10166227000,12778497000
2013,3,WA28,Anorganische chemische Erzeugnisse,733244000,662631000,1395875000
2013,3,WA29,Organische chemische Erzeugnisse,2165018000,2061224000,4226242000
2013,3,WA30,Pharmazeutische Erzeugnisse,4398088000,2770755000,7168843000
2013,3,WA31,Düngemittel,287451000,144072000,431523000
2013,3,WA32,"Gerb- und Farbstoffe, Farben, Lacke usw.",870029000,458044000,1328073000
2013,3,WA33,"Etherische Öle, Riech-, Schönheitsmittel",710159000,453756000,1163915000
2013,3,WA34,"Seifen, Waschmittel usw.",519600000,260352000,779952000
2013,3,WA35,"Eiweißstoffe, Klebstoffe, Enzyme",220097000,158614000,378711000
2013,3,WA36,"Sprengstoffe, pyrotechnische Artikel usw.",18946000,13750000,32696000
2013,3,WA37,Photochemische Erzeugnisse,93972000,68336000,162308000
2013,3,WA38,Verschiedene Erzeugnisse der Chemischen Industrie,1696122000,998820000,2694942000
2013,3,WA39,Kunststoffe und Waren daraus,4305376000,2697674000,7003050000
2013,3,WA40,Kautschuk und Waren daraus,1159547000,1125918000,2285465000
2013,3,WA41,"Häute, Felle, Leder",91415000,76415000,167830000
2013,3,WA42,"Lederwaren, Sattlerwaren",131761000,245085000,376846000
2013,3,WA43,"Pelzfelle, künstliches Pelzwerk",18338000,13817000,32155000
2013,3,WA44,"Holz, Holzwaren, Holzkohle",552808000,529191000,1081999000
2013,3,WA45,"Kork, Korkwaren",2386000,10258000,12644000
2013,3,WA46,"Flechtwaren, Korbmacherwaren",3139000,8646000,11785000
2013,3,WA47,"Halbstoffe aus Holz usw., Papierabfall",105782000,294565000,400347000
2013,3,WA48,"Papier, Pappe und Waren daraus",1477340000,979769000,2457109000
2013,3,WA49,"Bücher, Zeitungen, Bilddrucke usw.",341885000,133940000,475825000
2013,3,WA50,Seide,6210000,5769000,11979000
2013,3,WA51,"Wolle, feine und grobe Tierhaare",48464000,55778000,104242000
2013,3,WA52,Baumwolle,80472000,81208000,161680000
2013,3,WA53,"Andere pflanzliche Spinnstoffe, Papiergarn",3016000,5164000,8180000
2013,3,WA54,Synthetisches oder künstliches Filament,158162000,115736000,273898000
2013,3,WA55,Synthetische oder künstliche Spinnfaser,154879000,119898000,274777000
2013,3,WA56,"Watte, Filz, Vliesstoff usw., Tauwerk",195909000,98742000,294651000
2013,3,WA57,"Teppiche, Fußbodenbelag aus Spinnstoff",39024000,79328000,118352000
2013,3,WA58,"Spezialgewebe, Spitzen, Tapisserien",40194000,24004000,64198000
2013,3,WA59,"Getränkte, bestrichene usw. Gewebe",167801000,91505000,259306000
2013,3,WA60,Gewirke und Gestricke,69864000,37604000,107468000
2013,3,WA61,"Bekleidung usw. aus Gewirken, Gestricken",558993000,969298000,1528291000
2013,3,WA62,"Andere Bekleidung, Bekleidungszubehör",683281000,1110430000,1793711000
2013,3,WA63,"Andere Konfektion, Spinnstoffwaren usw.",167374000,240583000,407957000
2013,3,WA64,"Schuhe, Gamaschen, ähnliche Waren",340834000,616526000,957360000
2013,3,WA65,Kopfbedeckungen und Teile davon,24269000,36032000,60301000
2013,3,WA66,"Schirme, Gehstöcke usw., Peitschen",7123000,19824000,26947000
2013,3,WA67,"Zugerichtete Federn, Daunen, künstliche Blumen",7448000,8873000,16321000
2013,3,WA68,"Waren aus Steinen, Gips, Zement usw.",308339000,197497000,505836000
2013,3,WA69,Keramische Waren,247516000,178401000,425917000
2013,3,WA70,Glas und Glaswaren,429723000,332437000,762160000
2013,3,WA71,"Perlen, Edelsteine, Edelmetalle",1210819000,1201934000,2412753000
2013,3,WA72,Eisen und Stahl,1948602000,1980457000,3929059000
2013,3,WA73,Waren aus Eisen oder Stahl,2215300000,1384920000,3600220000
2013,3,WA74,Kupfer und Waren daraus,959187000,924512000,1883699000
2013,3,WA75,Nickel und Waren daraus,90191000,123642000,213833000
2013,3,WA76,Aluminium und Waren daraus,1056753000,1117331000,2174084000
2013,3,WA78,Blei und Waren daraus,29718000,34379000,64097000
2013,3,WA79,Zink und Waren daraus,42839000,85230000,128069000
2013,3,WA80,Zinn und Waren daraus,12094000,34173000,46267000
2013,3,WA81,"Andere unedle Metalle, Cermets usw.",114303000,124802000,239105000
2013,3,WA82,"Werkzeuge, Schneidwaren, Essbestecke",599164000,330142000,929306000
2013,3,WA83,Verschiedene Waren aus unedlen Metallen,523348000,310567000,833915000
2013,3,WA84,"Maschinen, Apparate, mechanische Geräte",16106503000,9141147000,25247650000
2013,3,WA85,Elektrotechnische Erzeugnisse,9106097000,7679007000,16785104000
2013,3,WA86,Schienenfahrzeuge,288367000,228640000,517007000
2013,3,WA87,"Kraftfahrzeuge, Landfahrzeuge",15800510000,6359853000,22160363000
2013,3,WA88,"Luftfahrzeuge, Raumfahrzeuge",2759339000,2439706000,5199045000
2013,3,WA89,Wasserfahrzeuge,792901000,215009000,1007910000
2013,3,WA90,"Optische, photografische usw. Erzeugnisse",4388426000,2302814000,6691240000
2013,3,WA91,Uhrmacherwaren,132652000,141034000,273686000
2013,3,WA92,Musikinstrumente,37366000,31003000,68369000
2013,3,WA93,Waffen und Munition,42995000,18058000,61053000
2013,3,WA94,"Möbel, Beleuchtungskörper usw.",1105371000,1181590000,2286961000
2013,3,WA95,"Spielzeug, Spiele usw., Sportgeräte",250133000,340135000,590268000
2013,3,WA96,Verschiedene Waren,291122000,177843000,468965000
2013,3,WA97,"Kunstgegenstände, Sammlungsstücke",37941000,31063000,69004000
2013,3,WA98,Vollständige Fabrikationsanlagen,273391000,832000,274223000
2013,3,WA99,Zusammenstellungen verschiedener Waren,1422414000,787707000,2210121000
2013,4,WA01,Lebende Tiere,105906000,179616000,285522000
2013,4,WA02,Fleisch,612376000,477761000,1090137000
2013,4,WA03,"Fische, Krebs- und Weichtiere",94257000,230980000,325237000
2013,4,WA04,"Milch, Milcherzeugnisse, Eier, Honig",738845000,525954000,1264799000
2013,4,WA05,Andere Waren tierischen Ursprungs,72979000,75825000,148804000
2013,4,WA06,"Pflanzen, Waren des Blumenhandels",118725000,316497000,435222000
2013,4,WA07,"Gemüse, Pflanzen für Ernährung",105392000,541599000,646991000
2013,4,WA08,Genießbare Früchte und Nüsse,103172000,596992000,700164000
2013,4,WA09,"Kaffee, Tee, Mate, Gewürze",190500000,356268000,546768000
2013,4,WA10,Getreide,271708000,195724000,467432000
2013,4,WA11,"Müllereierzeugnisse, Malz usw.",105447000,41436000,146883000
2013,4,WA12,"Ölsamen usw., Heilpflanzen usw.",67154000,408606000,475760000
2013,4,WA13,"Schellack, Gummen, Harz, Pflanzensaft",43997000,43989000,87986000
2013,4,WA14,Flechtstoffe usw. pflanzlichen Ursprungs,665000,2547000,3212000
2013,4,WA15,"Tierische und pflanzliche Fette, Öle, Wachs",239765000,339125000,578890000
2013,4,WA16,"Zubereitungen von Fleisch, Fisch usw.",213130000,188348000,401478000
2013,4,WA17,Zucker und Zuckerwaren,147745000,151956000,299701000
2013,4,WA18,Kakao und Zubereitungen aus Kakao,250358000,240467000,490825000
2013,4,WA19,"Zubereitungen aus Getreide usw., Backwaren",390351000,227943000,618294000
2013,4,WA20,"Zubereitungen von Gemüse, Früchten usw.",184699000,335107000,519806000
2013,4,WA21,Verschiedene Lebensmittelzubereitungen,404900000,217084000,621984000
2013,4,WA22,"Getränke, alkoholhaltige Flüssigkeiten, Essig",414215000,515277000,929492000
2013,4,WA23,"Rückstände der Lebensmittelindustrie, Futter",297836000,288388000,586224000
2013,4,WA24,Tabak,306396000,155399000,461795000
2013,4,WA25,"Salz, Schwefel, Steine, Erden usw.",168653000,166567000,335220000
2013,4,WA26,"Erze, Schlacken, Aschen",26387000,781426000,807813000
2013,4,WA27,Mineralische Brennstoffe usw.,2129482000,10324113000,12453595000
2013,4,WA28,Anorganische chemische Erzeugnisse,687245000,414878000,1102123000
2013,4,WA29,Organische chemische Erzeugnisse,2057572000,2363356000,4420928000
2013,4,WA30,Pharmazeutische Erzeugnisse,4878209000,2883647000,7761856000
2013,4,WA31,Düngemittel,257840000,141788000,399628000
2013,4,WA32,"Gerb- und Farbstoffe, Farben, Lacke usw.",914407000,525749000,1440156000
2013,4,WA33,"Etherische Öle, Riech-, Schönheitsmittel",687507000,434762000,1122269000
2013,4,WA34,"Seifen, Waschmittel usw.",538425000,271345000,809770000
2013,4,WA35,"Eiweißstoffe, Klebstoffe, Enzyme",248586000,167309000,415895000
2013,4,WA36,"Sprengstoffe, pyrotechnische Artikel usw.",13073000,13039000,26112000
2013,4,WA37,Photochemische Erzeugnisse,100522000,65614000,166136000
2013,4,WA38,Verschiedene Erzeugnisse der Chemischen Industrie,1633769000,974375000,2608144000
2013,4,WA39,Kunststoffe und Waren daraus,4462153000,2748926000,7211079000
2013,4,WA40,Kautschuk und Waren daraus,1203983000,1180663000,2384646000
2013,4,WA41,"Häute, Felle, Leder",93338000,78320000,171658000
2013,4,WA42,"Lederwaren, Sattlerwaren",116983000,209895000,326878000
2013,4,WA43,"Pelzfelle, künstliches Pelzwerk",15231000,15120000,30351000
2013,4,WA44,"Holz, Holzwaren, Holzkohle",564770000,538737000,1103507000
2013,4,WA45,"Kork, Korkwaren",2894000,7411000,10305000
2013,4,WA46,"Flechtwaren, Korbmacherwaren",3689000,7051000,10740000
2013,4,WA47,"Halbstoffe aus Holz usw., Papierabfall",102299000,316048000,418347000
2013,4,WA48,"Papier, Pappe und Waren daraus",1408220000,900488000,2308708000
2013,4,WA49,"Bücher, Zeitungen, Bilddrucke usw.",339388000,142431000,481819000
2013,4,WA50,Seide,5987000,6127000,12114000
2013,4,WA51,"Wolle, feine und grobe Tierhaare",55003000,62047000,117050000
2013,4,WA52,Baumwolle,76833000,83762000,160595000
2013,4,WA53,"Andere pflanzliche Spinnstoffe, Papiergarn",2968000,5219000,8187000
2013,4,WA54,Synthetisches oder künstliches Filament,162913000,118602000,281515000
2013,4,WA55,Synthetische oder künstliche Spinnfaser,169611000,139384000,308995000
2013,4,WA56,"Watte, Filz, Vliesstoff usw., Tauwerk",185902000,103440000,289342000
2013,4,WA57,"Teppiche, Fußbodenbelag aus Spinnstoff",42169000,81785000,123954000
2013,4,WA58,"Spezialgewebe, Spitzen, Tapisserien",41503000,25106000,66609000
2013,4,WA59,"Getränkte, bestrichene usw. Gewebe",173556000,95431000,268987000
2013,4,WA60,Gewirke und Gestricke,74399000,42624000,117023000
2013,4,WA61,"Bekleidung usw. aus Gewirken, Gestricken",442015000,907372000,1349387000
2013,4,WA62,"Andere Bekleidung, Bekleidungszubehör",514291000,963171000,1477462000
2013,4,WA63,"Andere Konfektion, Spinnstoffwaren usw.",180372000,245547000,425919000
2013,4,WA64,"Schuhe, Gamaschen, ähnliche Waren",246003000,462042000,708045000
2013,4,WA65,Kopfbedeckungen und Teile davon,22259000,28615000,50874000
2013,4,WA66,"Schirme, Gehstöcke usw., Peitschen",7788000,14385000,22173000
2013,4,WA67,"Zugerichtete Federn, Daunen, künstliche Blumen",6307000,7582000,13889000
2013,4,WA68,"Waren aus Steinen, Gips, Zement usw.",320113000,216699000,536812000
2013,4,WA69,Keramische Waren,241650000,183466000,425116000
2013,4,WA70,Glas und Glaswaren,439460000,332699000,772159000
2013,4,WA71,"Perlen, Edelsteine, Edelmetalle",1222484000,1460556000,2683040000
2013,4,WA72,Eisen und Stahl,1933360000,2037060000,3970420000
2013,4,WA73,Waren aus Eisen oder Stahl,2306484000,1416912000,3723396000
2013,4,WA74,Kupfer und Waren daraus,906410000,823347000,1729757000
2013,4,WA75,Nickel und Waren daraus,88944000,125893000,214837000
2013,4,WA76,Aluminium und Waren daraus,1056819000,1098557000,2155376000
2013,4,WA78,Blei und Waren daraus,32227000,30848000,63075000
2013,4,WA79,Zink und Waren daraus,50391000,85836000,136227000
2013,4,WA80,Zinn und Waren daraus,9613000,42681000,52294000
2013,4,WA81,"Andere unedle Metalle, Cermets usw.",104796000,134595000,239391000
2013,4,WA82,"Werkzeuge, Schneidwaren, Essbestecke",585130000,326516000,911646000
2013,4,WA83,Verschiedene Waren aus unedlen Metallen,556704000,314126000,870830000
2013,4,WA84,"Maschinen, Apparate, mechanische Geräte",16457335000,9479696000,25937031000
2013,4,WA85,Elektrotechnische Erzeugnisse,9002092000,8202190000,17204282000
2013,4,WA86,Schienenfahrzeuge,368758000,200035000,568793000
2013,4,WA87,"Kraftfahrzeuge, Landfahrzeuge",16523716000,6557827000,23081543000
2013,4,WA88,"Luftfahrzeuge, Raumfahrzeuge",2310213000,1450716000,3760929000
2013,4,WA89,Wasserfahrzeuge,521228000,166220000,687448000
2013,4,WA90,"Optische, photografische usw. Erzeugnisse",4209808000,2341420000,6551228000
2013,4,WA91,Uhrmacherwaren,140203000,177601000,317804000
2013,4,WA92,Musikinstrumente,39204000,33509000,72713000
2013,4,WA93,Waffen und Munition,43932000,20841000,64773000
2013,4,WA94,"Möbel, Beleuchtungskörper usw.",1118651000,1160807000,2279458000
2013,4,WA95,"Spielzeug, Spiele usw., Sportgeräte",227960000,276750000,504710000
2013,4,WA96,Verschiedene Waren,292220000,177152000,469372000
2013,4,WA97,"Kunstgegenstände, Sammlungsstücke",48878000,32209000,81087000
2013,4,WA98,Vollständige Fabrikationsanlagen,255880000,1047000,256927000
2013,4,WA99,Zusammenstellungen verschiedener Waren,1563892000,793168000,2357060000
2013,5,WA01,Lebende Tiere,127283000,152986000,280269000
2013,5,WA02,Fleisch,617493000,474298000,1091791000
2013,5,WA03,"Fische, Krebs- und Weichtiere",110746000,257467000,368213000
2013,5,WA04,"Milch, Milcherzeugnisse, Eier, Honig",781113000,536359000,1317472000
2013,5,WA05,Andere Waren tierischen Ursprungs,72242000,75606000,147848000
2013,5,WA06,"Pflanzen, Waren des Blumenhandels",102527000,363191000,465718000
2013,5,WA07,"Gemüse, Pflanzen für Ernährung",106309000,559801000,666110000
2013,5,WA08,Genießbare Früchte und Nüsse,120242000,657399000,777641000
2013,5,WA09,"Kaffee, Tee, Mate, Gewürze",173835000,305623000,479458000
2013,5,WA10,Getreide,242061000,196450000,438511000
2013,5,WA11,"Müllereierzeugnisse, Malz usw.",107287000,43571000,150858000
2013,5,WA12,"Ölsamen usw., Heilpflanzen usw.",60125000,443612000,503737000
2013,5,WA13,"Schellack, Gummen, Harz, Pflanzensaft",49251000,43805000,93056000
2013,5,WA14,Flechtstoffe usw. pflanzlichen Ursprungs,729000,2921000,3650000
2013,5,WA15,"Tierische und pflanzliche Fette, Öle, Wachs",285836000,299262000,585098000
2013,5,WA16,"Zubereitungen von Fleisch, Fisch usw.",237201000,191755000,428956000
2013,5,WA17,Zucker und Zuckerwaren,152874000,139363000,292237000
2013,5,WA18,Kakao und Zubereitungen aus Kakao,251581000,203031000,454612000
2013,5,WA19,"Zubereitungen aus Getreide usw., Backwaren",427883000,289339000,717222000
2013,5,WA20,"Zubereitungen von Gemüse, Früchten usw.",207849000,363471000,571320000
2013,5,WA21,Verschiedene Lebensmittelzubereitungen,423149000,226175000,649324000
2013,5,WA22,"Getränke, alkoholhaltige Flüssigkeiten, Essig",457022000,545911000,1002933000
2013,5,WA23,"Rückstände der Lebensmittelindustrie, Futter",301084000,327047000,628131000
2013,5,WA24,Tabak,287073000,146959000,434032000
2013,5,WA25,"Salz, Schwefel, Steine, Erden usw.",178966000,139316000,318282000
2013,5,WA26,"Erze, Schlacken, Aschen",23032000,567726000,590758000
2013,5,WA27,Mineralische Brennstoffe usw.,2130758000,10396617000,12527375000
2013,5,WA28,Anorganische chemische Erzeugnisse,739770000,619396000,1359166000
2013,5,WA29,Organische chemische Erzeugnisse,1913226000,2254271000,4167497000
2013,5,WA30,Pharmazeutische Erzeugnisse,4222738000,2690491000,6913229000
2013,5,WA31,Düngemittel,225760000,133896000,359656000
2013,5,WA32,"Gerb- und Farbstoffe, Farben, Lacke usw.",893299000,474538000,1367837000
2013,5,WA33,"Etherische Öle, Riech-, Schönheitsmittel",693983000,395314000,1089297000
2013,5,WA34,"Seifen, Waschmittel usw.",530295000,250559000,780854000
2013,5,WA35,"Eiweißstoffe, Klebstoffe, Enzyme",230933000,154404000,385337000
2013,5,WA36,"Sprengstoffe, pyrotechnische Artikel usw.",20766000,14360000,35126000
2013,5,WA37,Photochemische Erzeugnisse,90594000,60501000,151095000
2013,5,WA38,Verschiedene Erzeugnisse der Chemischen Industrie,1566558000,952112000,2518670000
2013,5,WA39,Kunststoffe und Waren daraus,4467041000,2781581000,7248622000
2013,5,WA40,Kautschuk und Waren daraus,1153401000,1065668000,2219069000
2013,5,WA41,"Häute, Felle, Leder",90481000,77680000,168161000
2013,5,WA42,"Lederwaren, Sattlerwaren",110157000,242425000,352582000
2013,5,WA43,"Pelzfelle, künstliches Pelzwerk",16325000,16045000,32370000
2013,5,WA44,"Holz, Holzwaren, Holzkohle",585144000,571240000,1156384000
2013,5,WA45,"Kork, Korkwaren",1834000,5818000,7652000
2013,5,WA46,"Flechtwaren, Korbmacherwaren",3146000,7787000,10933000
2013,5,WA47,"Halbstoffe aus Holz usw., Papierabfall",100836000,322383000,423219000
2013,5,WA48,"Papier, Pappe und Waren daraus",1432883000,904850000,2337733000
2013,5,WA49,"Bücher, Zeitungen, Bilddrucke usw.",322097000,148787000,470884000
2013,5,WA50,Seide,7161000,7324000,14485000
2013,5,WA51,"Wolle, feine und grobe Tierhaare",52476000,59107000,111583000
2013,5,WA52,Baumwolle,83138000,82479000,165617000
2013,5,WA53,"Andere pflanzliche Spinnstoffe, Papiergarn",2729000,4727000,7456000
2013,5,WA54,Synthetisches oder künstliches Filament,152686000,120846000,273532000
2013,5,WA55,Synthetische oder künstliche Spinnfaser,168887000,135584000,304471000
2013,5,WA56,"Watte, Filz, Vliesstoff usw., Tauwerk",184044000,100964000,285008000
2013,5,WA57,"Teppiche, Fußbodenbelag aus Spinnstoff",37834000,80421000,118255000
2013,5,WA58,"Spezialgewebe, Spitzen, Tapisserien",39003000,25154000,64157000
2013,5,WA59,"Getränkte, bestrichene usw. Gewebe",168515000,93492000,262007000
2013,5,WA60,Gewirke und Gestricke,74177000,41515000,115692000
2013,5,WA61,"Bekleidung usw. aus Gewirken, Gestricken",383256000,874775000,1258031000
2013,5,WA62,"Andere Bekleidung, Bekleidungszubehör",398562000,877183000,1275745000
2013,5,WA63,"Andere Konfektion, Spinnstoffwaren usw.",178961000,269508000,448469000
2013,5,WA64,"Schuhe, Gamaschen, ähnliche Waren",202328000,478886000,681214000
2013,5,WA65,Kopfbedeckungen und Teile davon,17927000,25902000,43829000
2013,5,WA66,"Schirme, Gehstöcke usw., Peitschen",6672000,14881000,21553000
2013,5,WA67,"Zugerichtete Federn, Daunen, künstliche Blumen",5994000,8492000,14486000
2013,5,WA68,"Waren aus Steinen, Gips, Zement usw.",306187000,214568000,520755000
2013,5,WA69,Keramische Waren,234531000,187677000,422208000
2013,5,WA70,Glas und Glaswaren,433587000,330543000,764130000
2013,5,WA71,"Perlen, Edelsteine, Edelmetalle",1003504000,1473865000,2477369000
2013,5,WA72,Eisen und Stahl,1931972000,1868281000,3800253000
2013,5,WA73,Waren aus Eisen oder Stahl,2141759000,1400177000,3541936000
2013,5,WA74,Kupfer und Waren daraus,855909000,733056000,1588965000
2013,5,WA75,Nickel und Waren daraus,86881000,128307000,215188000
2013,5,WA76,Aluminium und Waren daraus,1030115000,1100507000,2130622000
2013,5,WA78,Blei und Waren daraus,32837000,23525000,56362000
2013,5,WA79,Zink und Waren daraus,50172000,85862000,136034000
2013,5,WA80,Zinn und Waren daraus,9098000,28661000,37759000
2013,5,WA81,"Andere unedle Metalle, Cermets usw.",90659000,121151000,211810000
2013,5,WA82,"Werkzeuge, Schneidwaren, Essbestecke",527937000,314566000,842503000
2013,5,WA83,Verschiedene Waren aus unedlen Metallen,549105000,312789000,861894000
2013,5,WA84,"Maschinen, Apparate, mechanische Geräte",15540303000,8580545000,24120848000
2013,5,WA85,Elektrotechnische Erzeugnisse,8802658000,7819670000,16622328000
2013,5,WA86,Schienenfahrzeuge,309520000,169535000,479055000
2013,5,WA87,"Kraftfahrzeuge, Landfahrzeuge",14343779000,6185022000,20528801000
2013,5,WA88,"Luftfahrzeuge, Raumfahrzeuge",2163775000,2179947000,4343722000
2013,5,WA89,Wasserfahrzeuge,132329000,341838000,474167000
2013,5,WA90,"Optische, photografische usw. Erzeugnisse",4125857000,2282540000,6408397000
2013,5,WA91,Uhrmacherwaren,149822000,181441000,331263000
2013,5,WA92,Musikinstrumente,41380000,34817000,76197000
2013,5,WA93,Waffen und Munition,40845000,15739000,56584000
2013,5,WA94,"Möbel, Beleuchtungskörper usw.",1049423000,1144845000,2194268000
2013,5,WA95,"Spielzeug, Spiele usw., Sportgeräte",251652000,298227000,549879000
2013,5,WA96,Verschiedene Waren,283756000,185624000,469380000
2013,5,WA97,"Kunstgegenstände, Sammlungsstücke",47912000,33627000,81539000
2013,5,WA98,Vollständige Fabrikationsanlagen,239467000,1133000,240600000
2013,5,WA99,Zusammenstellungen verschiedener Waren,1361965000,784785000,2146750000
2013,6,WA01,Lebende Tiere,123080000,176026000,299106000
2013,6,WA02,Fleisch,647778000,489794000,1137572000
2013,6,WA03,"Fische, Krebs- und Weichtiere",99668000,229348000,329016000
2013,6,WA04,"Milch, Milcherzeugnisse, Eier, Honig",712549000,540367000,1252916000
2013,6,WA05,Andere Waren tierischen Ursprungs,75414000,75944000,151358000
2013,6,WA06,"Pflanzen, Waren des Blumenhandels",54587000,206851000,261438000
2013,6,WA07,"Gemüse, Pflanzen für Ernährung",100638000,477186000,577824000
2013,6,WA08,Genießbare Früchte und Nüsse,126646000,698750000,825396000
2013,6,WA09,"Kaffee, Tee, Mate, Gewürze",187574000,291452000,479026000
2013,6,WA10,Getreide,283687000,165241000,448928000
2013,6,WA11,"Müllereierzeugnisse, Malz usw.",101445000,43866000,145311000
2013,6,WA12,"Ölsamen usw., Heilpflanzen usw.",58269000,365415000,423684000
2013,6,WA13,"Schellack, Gummen, Harz, Pflanzensaft",42296000,37042000,79338000
2013,6,WA14,Flechtstoffe usw. pflanzlichen Ursprungs,697000,3131000,3828000
2013,6,WA15,"Tierische und pflanzliche Fette, Öle, Wachs",293068000,308778000,601846000
2013,6,WA16,"Zubereitungen von Fleisch, Fisch usw.",220650000,190672000,411322000
2013,6,WA17,Zucker und Zuckerwaren,149201000,147736000,296937000
2013,6,WA18,Kakao und Zubereitungen aus Kakao,231416000,208380000,439796000
2013,6,WA19,"Zubereitungen aus Getreide usw., Backwaren",391912000,256648000,648560000
2013,6,WA20,"Zubereitungen von Gemüse, Früchten usw.",194288000,339904000,534192000
2013,6,WA21,Verschiedene Lebensmittelzubereitungen,388975000,218377000,607352000
2013,6,WA22,"Getränke, alkoholhaltige Flüssigkeiten, Essig",444617000,567055000,1011672000
2013,6,WA23,"Rückstände der Lebensmittelindustrie, Futter",322278000,314323000,636601000
2013,6,WA24,Tabak,315930000,137314000,453244000
2013,6,WA25,"Salz, Schwefel, Steine, Erden usw.",179039000,154158000,333197000
2013,6,WA26,"Erze, Schlacken, Aschen",26073000,776124000,802197000
2013,6,WA27,Mineralische Brennstoffe usw.,2152684000,10756095000,12908779000
2013,6,WA28,Anorganische chemische Erzeugnisse,704096000,528434000,1232530000
2013,6,WA29,Organische chemische Erzeugnisse,1894908000,1959814000,3854722000
2013,6,WA30,Pharmazeutische Erzeugnisse,4560041000,2769209000,7329250000
2013,6,WA31,Düngemittel,170415000,104425000,274840000
2013,6,WA32,"Gerb- und Farbstoffe, Farben, Lacke usw.",909991000,465566000,1375557000
2013,6,WA33,"Etherische Öle, Riech-, Schönheitsmittel",671265000,469315000,1140580000
2013,6,WA34,"Seifen, Waschmittel usw.",527602000,256515000,784117000
2013,6,WA35,"Eiweißstoffe, Klebstoffe, Enzyme",241096000,167789000,408885000
2013,6,WA36,"Sprengstoffe, pyrotechnische Artikel usw.",20349000,17554000,37903000
2013,6,WA37,Photochemische Erzeugnisse,90746000,62895000,153641000
2013,6,WA38,Verschiedene Erzeugnisse der Chemischen Industrie,1549227000,987371000,2536598000
2013,6,WA39,Kunststoffe und Waren daraus,4472595000,2735160000,7207755000
2013,6,WA40,Kautschuk und Waren daraus,1154627000,1113674000,2268301000
2013,6,WA41,"Häute, Felle, Leder",95802000,81954000,177756000
2013,6,WA42,"Lederwaren, Sattlerwaren",136042000,260968000,397010000
2013,6,WA43,"Pelzfelle, künstliches Pelzwerk",19562000,18310000,37872000
2013,6,WA44,"Holz, Holzwaren, Holzkohle",564034000,567938000,1131972000
2013,6,WA45,"Kork, Korkwaren",2536000,10249000,12785000
2013,6,WA46,"Flechtwaren, Korbmacherwaren",2716000,8053000,10769000
2013,6,WA47,"Halbstoffe aus Holz usw., Papierabfall",99342000,292629000,391971000
2013,6,WA48,"Papier, Pappe und Waren daraus",1404740000,927565000,2332305000
2013,6,WA49,"Bücher, Zeitungen, Bilddrucke usw.",306237000,139695000,445932000
2013,6,WA50,Seide,5125000,5308000,10433000
2013,6,WA51,"Wolle, feine und grobe Tierhaare",47357000,52398000,99755000
2013,6,WA52,Baumwolle,83268000,81275000,164543000
2013,6,WA53,"Andere pflanzliche Spinnstoffe, Papiergarn",2613000,4360000,6973000
2013,6,WA54,Synthetisches oder künstliches Filament,169673000,119013000,288686000
2013,6,WA55,Synthetische oder künstliche Spinnfaser,162153000,129598000,291751000
2013,6,WA56,"Watte, Filz, Vliesstoff usw., Tauwerk",182661000,96542000,279203000
2013,6,WA57,"Teppiche, Fußbodenbelag aus Spinnstoff",39311000,78327000,117638000
2013,6,WA58,"Spezialgewebe, Spitzen, Tapisserien",38901000,23548000,62449000
2013,6,WA59,"Getränkte, bestrichene usw. Gewebe",167269000,91536000,258805000
2013,6,WA60,Gewirke und Gestricke,70440000,36858000,107298000
2013,6,WA61,"Bekleidung usw. aus Gewirken, Gestricken",422108000,955538000,1377646000
2013,6,WA62,"Andere Bekleidung, Bekleidungszubehör",425452000,928776000,1354228000
2013,6,WA63,"Andere Konfektion, Spinnstoffwaren usw.",181865000,254628000,436493000
2013,6,WA64,"Schuhe, Gamaschen, ähnliche Waren",266033000,506664000,772697000
2013,6,WA65,Kopfbedeckungen und Teile davon,19230000,29372000,48602000
2013,6,WA66,"Schirme, Gehstöcke usw., Peitschen",5872000,10524000,16396000
2013,6,WA67,"Zugerichtete Federn, Daunen, künstliche Blumen",6823000,12391000,19214000
2013,6,WA68,"Waren aus Steinen, Gips, Zement usw.",336259000,210548000,546807000
2013,6,WA69,Keramische Waren,257331000,188367000,445698000
2013,6,WA70,Glas und Glaswaren,454537000,348223000,802760000
2013,6,WA71,"Perlen, Edelsteine, Edelmetalle",1057085000,1524897000,2581982000
2013,6,WA72,Eisen und Stahl,1927700000,2026714000,3954414000
2013,6,WA73,Waren aus Eisen oder Stahl,2186234000,1476434000,3662668000
2013,6,WA74,Kupfer und Waren daraus,899204000,853746000,1752950000
2013,6,WA75,Nickel und Waren daraus,80288000,114330000,194618000
2013,6,WA76,Aluminium und Waren daraus,1063559000,1134560000,2198119000
2013,6,WA78,Blei und Waren daraus,34765000,22444000,57209000
2013,6,WA79,Zink und Waren daraus,49662000,90380000,140042000
2013,6,WA80,Zinn und Waren daraus,11117000,31710000,42827000
2013,6,WA81,"Andere unedle Metalle, Cermets usw.",124034000,129334000,253368000
2013,6,WA82,"Werkzeuge, Schneidwaren, Essbestecke",594835000,347006000,941841000
2013,6,WA83,Verschiedene Waren aus unedlen Metallen,571407000,331768000,903175000
2013,6,WA84,"Maschinen, Apparate, mechanische Geräte",16319342000,8915854000,25235196000
2013,6,WA85,Elektrotechnische Erzeugnisse,9149678000,7799977000,16949655000
2013,6,WA86,Schienenfahrzeuge,310665000,195609000,506274000
2013,6,WA87,"Kraftfahrzeuge, Landfahrzeuge",15266655000,6331536000,21598191000
2013,6,WA88,"Luftfahrzeuge, Raumfahrzeuge",3198888000,2083399000,5282287000
2013,6,WA89,Wasserfahrzeuge,243984000,169414000,413398000
2013,6,WA90,"Optische, photografische usw. Erzeugnisse",4302903000,2339745000,6642648000
2013,6,WA91,Uhrmacherwaren,157988000,184402000,342390000
2013,6,WA92,Musikinstrumente,40771000,33455000,74226000
2013,6,WA93,Waffen und Munition,53006000,20463000,73469000
2013,6,WA94,"Möbel, Beleuchtungskörper usw.",1109466000,1101487000,2210953000
2013,6,WA95,"Spielzeug, Spiele usw., Sportgeräte",231406000,299378000,530784000
2013,6,WA96,Verschiedene Waren,294010000,187784000,481794000
2013,6,WA97,"Kunstgegenstände, Sammlungsstücke",65339000,36640000,101979000
2013,6,WA98,Vollständige Fabrikationsanlagen,220243000,921000,221164000
2013,6,WA99,Zusammenstellungen verschiedener Waren,1456499000,777426000,2233925000
2013,7,WA01,Lebende Tiere,127225000,148241000,275466000
2013,7,WA02,Fleisch,646774000,473925000,1120699000
2013,7,WA03,"Fische, Krebs- und Weichtiere",98977000,243959000,342936000
2013,7,WA04,"Milch, Milcherzeugnisse, Eier, Honig",787717000,517133000,1304850000
2013,7,WA05,Andere Waren tierischen Ursprungs,73756000,75774000,149530000
2013,7,WA06,"Pflanzen, Waren des Blumenhandels",43831000,146916000,190747000
2013,7,WA07,"Gemüse, Pflanzen für Ernährung",88590000,399450000,488040000
2013,7,WA08,Genießbare Früchte und Nüsse,127797000,707645000,835442000
2013,7,WA09,"Kaffee, Tee, Mate, Gewürze",180368000,308546000,488914000
2013,7,WA10,Getreide,240080000,163462000,403542000
2013,7,WA11,"Müllereierzeugnisse, Malz usw.",100284000,46449000,146733000
2013,7,WA12,"Ölsamen usw., Heilpflanzen usw.",80527000,407104000,487631000
2013,7,WA13,"Schellack, Gummen, Harz, Pflanzensaft",43892000,41975000,85867000
2013,7,WA14,Flechtstoffe usw. pflanzlichen Ursprungs,457000,2683000,3140000
2013,7,WA15,"Tierische und pflanzliche Fette, Öle, Wachs",269066000,342530000,611596000
2013,7,WA16,"Zubereitungen von Fleisch, Fisch usw.",244647000,192489000,437136000
2013,7,WA17,Zucker und Zuckerwaren,158972000,155391000,314363000
2013,7,WA18,Kakao und Zubereitungen aus Kakao,288878000,241653000,530531000
2013,7,WA19,"Zubereitungen aus Getreide usw., Backwaren",411047000,272680000,683727000
2013,7,WA20,"Zubereitungen von Gemüse, Früchten usw.",203840000,362600000,566440000
2013,7,WA21,Verschiedene Lebensmittelzubereitungen,420106000,232961000,653067000
2013,7,WA22,"Getränke, alkoholhaltige Flüssigkeiten, Essig",487433000,590084000,1077517000
2013,7,WA23,"Rückstände der Lebensmittelindustrie, Futter",286106000,293303000,579409000
2013,7,WA24,Tabak,303174000,158798000,461972000
2013,7,WA25,"Salz, Schwefel, Steine, Erden usw.",180842000,154646000,335488000
2013,7,WA26,"Erze, Schlacken, Aschen",23030000,687735000,710765000
2013,7,WA27,Mineralische Brennstoffe usw.,2125599000,10484285000,12609884000
2013,7,WA28,Anorganische chemische Erzeugnisse,638850000,591222000,1230072000
2013,7,WA29,Organische chemische Erzeugnisse,2160693000,2241976000,4402669000
2013,7,WA30,Pharmazeutische Erzeugnisse,4838209000,3193308000,8031517000
2013,7,WA31,Düngemittel,185870000,95601000,281471000
2013,7,WA32,"Gerb- und Farbstoffe, Farben, Lacke usw.",912117000,491455000,1403572000
2013,7,WA33,"Etherische Öle, Riech-, Schönheitsmittel",733204000,462689000,1195893000
2013,7,WA34,"Seifen, Waschmittel usw.",562107000,283138000,845245000
2013,7,WA35,"Eiweißstoffe, Klebstoffe, Enzyme",253399000,162326000,415725000
2013,7,WA36,"Sprengstoffe, pyrotechnische Artikel usw.",18056000,23171000,41227000
2013,7,WA37,Photochemische Erzeugnisse,92026000,62698000,154724000
2013,7,WA38,Verschiedene Erzeugnisse der Chemischen Industrie,1570384000,964402000,2534786000
2013,7,WA39,Kunststoffe und Waren daraus,4522396000,2847680000,7370076000
2013,7,WA40,Kautschuk und Waren daraus,1166749000,1151417000,2318166000
2013,7,WA41,"Häute, Felle, Leder",84753000,77421000,162174000
2013,7,WA42,"Lederwaren, Sattlerwaren",145381000,299585000,444966000
2013,7,WA43,"Pelzfelle, künstliches Pelzwerk",19245000,18657000,37902000
2013,7,WA44,"Holz, Holzwaren, Holzkohle",587697000,558105000,1145802000
2013,7,WA45,"Kork, Korkwaren",2195000,6417000,8612000
2013,7,WA46,"Flechtwaren, Korbmacherwaren",3435000,9428000,12863000
2013,7,WA47,"Halbstoffe aus Holz usw., Papierabfall",94814000,287853000,382667000
2013,7,WA48,"Papier, Pappe und Waren daraus",1427676000,971473000,2399149000
2013,7,WA49,"Bücher, Zeitungen, Bilddrucke usw.",327053000,134789000,461842000
2013,7,WA50,Seide,4678000,5515000,10193000
2013,7,WA51,"Wolle, feine und grobe Tierhaare",46343000,57566000,103909000
2013,7,WA52,Baumwolle,74806000,76779000,151585000
2013,7,WA53,"Andere pflanzliche Spinnstoffe, Papiergarn",2500000,4852000,7352000
2013,7,WA54,Synthetisches oder künstliches Filament,151547000,114813000,266360000
2013,7,WA55,Synthetische oder künstliche Spinnfaser,165332000,134449000,299781000
2013,7,WA56,"Watte, Filz, Vliesstoff usw., Tauwerk",183669000,100958000,284627000
2013,7,WA57,"Teppiche, Fußbodenbelag aus Spinnstoff",42273000,76108000,118381000
2013,7,WA58,"Spezialgewebe, Spitzen, Tapisserien",40453000,24338000,64791000
2013,7,WA59,"Getränkte, bestrichene usw. Gewebe",168110000,91180000,259290000
2013,7,WA60,Gewirke und Gestricke,65324000,36641000,101965000
2013,7,WA61,"Bekleidung usw. aus Gewirken, Gestricken",583973000,1336122000,1920095000
2013,7,WA62,"Andere Bekleidung, Bekleidungszubehör",611503000,1291366000,1902869000
2013,7,WA63,"Andere Konfektion, Spinnstoffwaren usw.",187410000,273236000,460646000
2013,7,WA64,"Schuhe, Gamaschen, ähnliche Waren",360820000,792259000,1153079000
2013,7,WA65,Kopfbedeckungen und Teile davon,22008000,37915000,59923000
2013,7,WA66,"Schirme, Gehstöcke usw., Peitschen",4442000,10530000,14972000
2013,7,WA67,"Zugerichtete Federn, Daunen, künstliche Blumen",6797000,14094000,20891000
2013,7,WA68,"Waren aus Steinen, Gips, Zement usw.",342901000,231284000,574185000
2013,7,WA69,Keramische Waren,247481000,188962000,436443000
2013,7,WA70,Glas und Glaswaren,452962000,348726000,801688000
2013,7,WA71,"Perlen, Edelsteine, Edelmetalle",1062990000,1361067000,2424057000
2013,7,WA72,Eisen und Stahl,1790543000,1943599000,3734142000
2013,7,WA73,Waren aus Eisen oder Stahl,2153530000,1530779000,3684309000
2013,7,WA74,Kupfer und Waren daraus,859442000,863568000,1723010000
2013,7,WA75,Nickel und Waren daraus,92173000,101035000,193208000
2013,7,WA76,Aluminium und Waren daraus,1079117000,1100577000,2179694000
2013,7,WA78,Blei und Waren daraus,35948000,28537000,64485000
2013,7,WA79,Zink und Waren daraus,49734000,90540000,140274000
2013,7,WA80,Zinn und Waren daraus,9249000,25291000,34540000
2013,7,WA81,"Andere unedle Metalle, Cermets usw.",106883000,124046000,230929000
2013,7,WA82,"Werkzeuge, Schneidwaren, Essbestecke",583552000,353294000,936846000
2013,7,WA83,Verschiedene Waren aus unedlen Metallen,559285000,322980000,882265000
2013,7,WA84,"Maschinen, Apparate, mechanische Geräte",16636230000,9137962000,25774192000
2013,7,WA85,Elektrotechnische Erzeugnisse,9040489000,8009932000,17050421000
2013,7,WA86,Schienenfahrzeuge,331673000,153760000,485433000
2013,7,WA87,"Kraftfahrzeuge, Landfahrzeuge",15784312000,6032551000,21816863000
2013,7,WA88,"Luftfahrzeuge, Raumfahrzeuge",2265728000,1471281000,3737009000
2013,7,WA89,Wasserfahrzeuge,45809000,444531000,490340000
2013,7,WA90,"Optische, photografische usw. Erzeugnisse",4299959000,2367550000,6667509000
2013,7,WA91,Uhrmacherwaren,155488000,187431000,342919000
2013,7,WA92,Musikinstrumente,39588000,34748000,74336000
2013,7,WA93,Waffen und Munition,48055000,20035000,68090000
2013,7,WA94,"Möbel, Beleuchtungskörper usw.",1100093000,1108913000,2209006000
2013,7,WA95,"Spielzeug, Spiele usw., Sportgeräte",236308000,316111000,552419000
2013,7,WA96,Verschiedene Waren,286731000,198914000,485645000
2013,7,WA97,"Kunstgegenstände, Sammlungsstücke",49340000,51801000,101141000
2013,7,WA98,Vollständige Fabrikationsanlagen,253928000,1734000,255662000
2013,7,WA99,Zusammenstellungen verschiedener Waren,1514224000,814495000,2328719000
2013,8,WA01,Lebende Tiere,122865000,171814000,294679000
2013,8,WA02,Fleisch,686232000,482045000,1168277000
2013,8,WA03,"Fische, Krebs- und Weichtiere",102105000,244874000,346979000
2013,8,WA04,"Milch, Milcherzeugnisse, Eier, Honig",755711000,571916000,1327627000
2013,8,WA05,Andere Waren tierischen Ursprungs,59077000,69165000,128242000
2013,8,WA06,"Pflanzen, Waren des Blumenhandels",53569000,158164000,211733000
2013,8,WA07,"Gemüse, Pflanzen für Ernährung",88031000,353835000,441866000
2013,8,WA08,Genießbare Früchte und Nüsse,111382000,688247000,799629000
2013,8,WA09,"Kaffee, Tee, Mate, Gewürze",171770000,261103000,432873000
2013,8,WA10,Getreide,293880000,173995000,467875000
2013,8,WA11,"Müllereierzeugnisse, Malz usw.",98984000,45833000,144817000
2013,8,WA12,"Ölsamen usw., Heilpflanzen usw.",75481000,420002000,495483000
2013,8,WA13,"Schellack, Gummen, Harz, Pflanzensaft",38750000,37069000,75819000
2013,8,WA14,Flechtstoffe usw. pflanzlichen Ursprungs,686000,2570000,3256000
2013,8,WA15,"Tierische und pflanzliche Fette, Öle, Wachs",229043000,325981000,555024000
2013,8,WA16,"Zubereitungen von Fleisch, Fisch usw.",209162000,186942000,396104000
2013,8,WA17,Zucker und Zuckerwaren,144476000,143109000,287585000
2013,8,WA18,Kakao und Zubereitungen aus Kakao,318371000,277047000,595418000
2013,8,WA19,"Zubereitungen aus Getreide usw., Backwaren",422733000,237112000,659845000
2013,8,WA20,"Zubereitungen von Gemüse, Früchten usw.",185452000,327544000,512996000
2013,8,WA21,Verschiedene Lebensmittelzubereitungen,363221000,205568000,568789000
2013,8,WA22,"Getränke, alkoholhaltige Flüssigkeiten, Essig",423788000,507442000,931230000
2013,8,WA23,"Rückstände der Lebensmittelindustrie, Futter",304179000,278776000,582955000
2013,8,WA24,Tabak,306261000,148856000,455117000
2013,8,WA25,"Salz, Schwefel, Steine, Erden usw.",160276000,140110000,300386000
2013,8,WA26,"Erze, Schlacken, Aschen",25389000,461902000,487291000
2013,8,WA27,Mineralische Brennstoffe usw.,2226490000,11566905000,13793395000
2013,8,WA28,Anorganische chemische Erzeugnisse,620837000,374542000,995379000
2013,8,WA29,Organische chemische Erzeugnisse,1983495000,2109347000,4092842000
2013,8,WA30,Pharmazeutische Erzeugnisse,4414639000,2651365000,7066004000
2013,8,WA31,Düngemittel,166271000,90224000,256495000
2013,8,WA32,"Gerb- und Farbstoffe, Farben, Lacke usw.",833306000,434984000,1268290000
2013,8,WA33,"Etherische Öle, Riech-, Schönheitsmittel",698337000,456116000,1154453000
2013,8,WA34,"Seifen, Waschmittel usw.",512518000,270614000,783132000
2013,8,WA35,"Eiweißstoffe, Klebstoffe, Enzyme",230432000,151977000,382409000
2013,8,WA36,"Sprengstoffe, pyrotechnische Artikel usw.",14452000,19527000,33979000
2013,8,WA37,Photochemische Erzeugnisse,80009000,56984000,136993000
2013,8,WA38,Verschiedene Erzeugnisse der Chemischen Industrie,1431155000,889119000,2320274000
2013,8,WA39,Kunststoffe und Waren daraus,4023998000,2631102000,6655100000
2013,8,WA40,Kautschuk und Waren daraus,1108653000,1106279000,2214932000
2013,8,WA41,"Häute, Felle, Leder",75549000,66980000,142529000
2013,8,WA42,"Lederwaren, Sattlerwaren",151096000,272539000,423635000
2013,8,WA43,"Pelzfelle, künstliches Pelzwerk",21216000,15757000,36973000
2013,8,WA44,"Holz, Holzwaren, Holzkohle",514511000,527293000,1041804000
2013,8,WA45,"Kork, Korkwaren",1864000,6157000,8021000
2013,8,WA46,"Flechtwaren, Korbmacherwaren",2833000,9196000,12029000
2013,8,WA47,"Halbstoffe aus Holz usw., Papierabfall",95452000,290498000,385950000
2013,8,WA48,"Papier, Pappe und Waren daraus",1368058000,926042000,2294100000
2013,8,WA49,"Bücher, Zeitungen, Bilddrucke usw.",357271000,137371000,494642000
2013,8,WA50,Seide,3217000,3826000,7043000
2013,8,WA51,"Wolle, feine und grobe Tierhaare",33629000,41803000,75432000
2013,8,WA52,Baumwolle,60111000,66479000,126590000
2013,8,WA53,"Andere pflanzliche Spinnstoffe, Papiergarn",2123000,4446000,6569000
2013,8,WA54,Synthetisches oder künstliches Filament,128981000,99958000,228939000
2013,8,WA55,Synthetische oder künstliche Spinnfaser,145802000,112439000,258241000
2013,8,WA56,"Watte, Filz, Vliesstoff usw., Tauwerk",174265000,93703000,267968000
2013,8,WA57,"Teppiche, Fußbodenbelag aus Spinnstoff",34085000,72316000,106401000
2013,8,WA58,"Spezialgewebe, Spitzen, Tapisserien",32483000,18827000,51310000
2013,8,WA59,"Getränkte, bestrichene usw. Gewebe",151782000,79210000,230992000
2013,8,WA60,Gewirke und Gestricke,50893000,25569000,76462000
2013,8,WA61,"Bekleidung usw. aus Gewirken, Gestricken",649086000,1354096000,2003182000
2013,8,WA62,"Andere Bekleidung, Bekleidungszubehör",726953000,1400445000,2127398000
2013,8,WA63,"Andere Konfektion, Spinnstoffwaren usw.",167870000,264577000,432447000
2013,8,WA64,"Schuhe, Gamaschen, ähnliche Waren",396007000,769437000,1165444000
2013,8,WA65,Kopfbedeckungen und Teile davon,30221000,48094000,78315000
2013,8,WA66,"Schirme, Gehstöcke usw., Peitschen",7517000,9964000,17481000
2013,8,WA67,"Zugerichtete Federn, Daunen, künstliche Blumen",7064000,14653000,21717000
2013,8,WA68,"Waren aus Steinen, Gips, Zement usw.",292483000,213525000,506008000
2013,8,WA69,Keramische Waren,224749000,184360000,409109000
2013,8,WA70,Glas und Glaswaren,409419000,326040000,735459000
2013,8,WA71,"Perlen, Edelsteine, Edelmetalle",973808000,1199569000,2173377000
2013,8,WA72,Eisen und Stahl,1577157000,1681998000,3259155000
2013,8,WA73,Waren aus Eisen oder Stahl,1922224000,1350693000,3272917000
2013,8,WA74,Kupfer und Waren daraus,838661000,788046000,1626707000
2013,8,WA75,Nickel und Waren daraus,64608000,86521000,151129000
2013,8,WA76,Aluminium und Waren daraus,951032000,1028569000,1979601000
2013,8,WA78,Blei und Waren daraus,26426000,23819000,50245000
2013,8,WA79,Zink und Waren daraus,44687000,93902000,138589000
2013,8,WA80,Zinn und Waren daraus,9469000,40401000,49870000
2013,8,WA81,"Andere unedle Metalle, Cermets usw.",99125000,117894000,217019000
2013,8,WA82,"Werkzeuge, Schneidwaren, Essbestecke",525194000,306966000,832160000
2013,8,WA83,Verschiedene Waren aus unedlen Metallen,528501000,292626000,821127000
2013,8,WA84,"Maschinen, Apparate, mechanische Geräte",14481744000,8129387000,22611131000
2013,8,WA85,Elektrotechnische Erzeugnisse,8474317000,7430234000,15904551000
2013,8,WA86,Schienenfahrzeuge,251574000,186437000,438011000
2013,8,WA87,"Kraftfahrzeuge, Landfahrzeuge",13346267000,4802393000,18148660000
2013,8,WA88,"Luftfahrzeuge, Raumfahrzeuge",2352835000,1457804000,3810639000
2013,8,WA89,Wasserfahrzeuge,161840000,253507000,415347000
2013,8,WA90,"Optische, photografische usw. Erzeugnisse",3954186000,2074094000,6028280000
2013,8,WA91,Uhrmacherwaren,138469000,170239000,308708000
2013,8,WA92,Musikinstrumente,34811000,34229000,69040000
2013,8,WA93,Waffen und Munition,40118000,17255000,57373000
2013,8,WA94,"Möbel, Beleuchtungskörper usw.",988864000,1107701000,2096565000
2013,8,WA95,"Spielzeug, Spiele usw., Sportgeräte",255307000,355066000,610373000
2013,8,WA96,Verschiedene Waren,268817000,184692000,453509000
2013,8,WA97,"Kunstgegenstände, Sammlungsstücke",48623000,17675000,66298000
2013,8,WA98,Vollständige Fabrikationsanlagen,250896000,6481000,257377000
2013,8,WA99,Zusammenstellungen verschiedener Waren,1415000000,742676000,2157676000
2013,9,WA01,Lebende Tiere,146996000,179226000,326222000
2013,9,WA02,Fleisch,656187000,506651000,1162838000
2013,9,WA03,"Fische, Krebs- und Weichtiere",121055000,255465000,376520000
2013,9,WA04,"Milch, Milcherzeugnisse, Eier, Honig",781292000,563266000,1344558000
2013,9,WA05,Andere Waren tierischen Ursprungs,65621000,73178000,138799000
2013,9,WA06,"Pflanzen, Waren des Blumenhandels",75613000,170011000,245624000
2013,9,WA07,"Gemüse, Pflanzen für Ernährung",92048000,287748000,379796000
2013,9,WA08,Genießbare Früchte und Nüsse,109806000,586287000,696093000
2013,9,WA09,"Kaffee, Tee, Mate, Gewürze",181420000,271989000,453409000
2013,9,WA10,Getreide,245958000,188380000,434338000
2013,9,WA11,"Müllereierzeugnisse, Malz usw.",103868000,42738000,146606000
2013,9,WA12,"Ölsamen usw., Heilpflanzen usw.",54946000,492678000,547624000
2013,9,WA13,"Schellack, Gummen, Harz, Pflanzensaft",36926000,31855000,68781000
2013,9,WA14,Flechtstoffe usw. pflanzlichen Ursprungs,622000,2107000,2729000
2013,9,WA15,"Tierische und pflanzliche Fette, Öle, Wachs",252010000,330988000,582998000
2013,9,WA16,"Zubereitungen von Fleisch, Fisch usw.",228667000,201545000,430212000
2013,9,WA17,Zucker und Zuckerwaren,156247000,141793000,298040000
2013,9,WA18,Kakao und Zubereitungen aus Kakao,387216000,280861000,668077000
2013,9,WA19,"Zubereitungen aus Getreide usw., Backwaren",443076000,254602000,697678000
2013,9,WA20,"Zubereitungen von Gemüse, Früchten usw.",189568000,327608000,517176000
2013,9,WA21,Verschiedene Lebensmittelzubereitungen,378959000,203355000,582314000
2013,9,WA22,"Getränke, alkoholhaltige Flüssigkeiten, Essig",441275000,560280000,1001555000
2013,9,WA23,"Rückstände der Lebensmittelindustrie, Futter",286744000,336351000,623095000
2013,9,WA24,Tabak,317580000,159172000,476752000
2013,9,WA25,"Salz, Schwefel, Steine, Erden usw.",170621000,158959000,329580000
2013,9,WA26,"Erze, Schlacken, Aschen",25852000,523159000,549011000
2013,9,WA27,Mineralische Brennstoffe usw.,2236121000,9717936000,11954057000
2013,9,WA28,Anorganische chemische Erzeugnisse,585068000,603618000,1188686000
2013,9,WA29,Organische chemische Erzeugnisse,1949016000,2081010000,4030026000
2013,9,WA30,Pharmazeutische Erzeugnisse,4784321000,2890660000,7674981000
2013,9,WA31,Düngemittel,213544000,86289000,299833000
2013,9,WA32,"Gerb- und Farbstoffe, Farben, Lacke usw.",870079000,495447000,1365526000
2013,9,WA33,"Etherische Öle, Riech-, Schönheitsmittel",726478000,466193000,1192671000
2013,9,WA34,"Seifen, Waschmittel usw.",526292000,283772000,810064000
2013,9,WA35,"Eiweißstoffe, Klebstoffe, Enzyme",232903000,165045000,397948000
2013,9,WA36,"Sprengstoffe, pyrotechnische Artikel usw.",17769000,21157000,38926000
2013,9,WA37,Photochemische Erzeugnisse,93597000,64973000,158570000
2013,9,WA38,Verschiedene Erzeugnisse der Chemischen Industrie,1502939000,897980000,2400919000
2013,9,WA39,Kunststoffe und Waren daraus,4341253000,2785720000,7126973000
2013,9,WA40,Kautschuk und Waren daraus,1188205000,1155936000,2344141000
2013,9,WA41,"Häute, Felle, Leder",89138000,73976000,163114000
2013,9,WA42,"Lederwaren, Sattlerwaren",139215000,262785000,402000000
2013,9,WA43,"Pelzfelle, künstliches Pelzwerk",20486000,16637000,37123000
2013,9,WA44,"Holz, Holzwaren, Holzkohle",590563000,557037000,1147600000
2013,9,WA45,"Kork, Korkwaren",2228000,7756000,9984000
2013,9,WA46,"Flechtwaren, Korbmacherwaren",3464000,8948000,12412000
2013,9,WA47,"Halbstoffe aus Holz usw., Papierabfall",92981000,283958000,376939000
2013,9,WA48,"Papier, Pappe und Waren daraus",1397905000,974412000,2372317000
2013,9,WA49,"Bücher, Zeitungen, Bilddrucke usw.",365639000,162537000,528176000
2013,9,WA50,Seide,4945000,6021000,10966000
2013,9,WA51,"Wolle, feine und grobe Tierhaare",43347000,48428000,91775000
2013,9,WA52,Baumwolle,78423000,76078000,154501000
2013,9,WA53,"Andere pflanzliche Spinnstoffe, Papiergarn",2786000,4542000,7328000
2013,9,WA54,Synthetisches oder künstliches Filament,147295000,111755000,259050000
2013,9,WA55,Synthetische oder künstliche Spinnfaser,167603000,128879000,296482000
2013,9,WA56,"Watte, Filz, Vliesstoff usw., Tauwerk",186382000,97185000,283567000
2013,9,WA57,"Teppiche, Fußbodenbelag aus Spinnstoff",42283000,77389000,119672000
2013,9,WA58,"Spezialgewebe, Spitzen, Tapisserien",38229000,22318000,60547000
2013,9,WA59,"Getränkte, bestrichene usw. Gewebe",170842000,87411000,258253000
2013,9,WA60,Gewirke und Gestricke,61965000,31778000,93743000
2013,9,WA61,"Bekleidung usw. aus Gewirken, Gestricken",657479000,1293793000,1951272000
2013,9,WA62,"Andere Bekleidung, Bekleidungszubehör",796810000,1365302000,2162112000
2013,9,WA63,"Andere Konfektion, Spinnstoffwaren usw.",191298000,272968000,464266000
2013,9,WA64,"Schuhe, Gamaschen, ähnliche Waren",383953000,700879000,1084832000
2013,9,WA65,Kopfbedeckungen und Teile davon,39812000,49857000,89669000
2013,9,WA66,"Schirme, Gehstöcke usw., Peitschen",6128000,9456000,15584000
2013,9,WA67,"Zugerichtete Federn, Daunen, künstliche Blumen",9782000,15042000,24824000
2013,9,WA68,"Waren aus Steinen, Gips, Zement usw.",317948000,225439000,543387000
2013,9,WA69,Keramische Waren,240570000,195477000,436047000
2013,9,WA70,Glas und Glaswaren,466038000,362211000,828249000
2013,9,WA71,"Perlen, Edelsteine, Edelmetalle",968953000,1323574000,2292527000
2013,9,WA72,Eisen und Stahl,1816417000,1719317000,3535734000
2013,9,WA73,Waren aus Eisen oder Stahl,2134469000,1468709000,3603178000
2013,9,WA74,Kupfer und Waren daraus,834745000,864867000,1699612000
2013,9,WA75,Nickel und Waren daraus,86435000,102416000,188851000
2013,9,WA76,Aluminium und Waren daraus,1054816000,1075025000,2129841000
2013,9,WA78,Blei und Waren daraus,36454000,25251000,61705000
2013,9,WA79,Zink und Waren daraus,48332000,89727000,138059000
2013,9,WA80,Zinn und Waren daraus,9118000,30332000,39450000
2013,9,WA81,"Andere unedle Metalle, Cermets usw.",103031000,108455000,211486000
2013,9,WA82,"Werkzeuge, Schneidwaren, Essbestecke",571469000,339434000,910903000
2013,9,WA83,Verschiedene Waren aus unedlen Metallen,531840000,325666000,857506000
2013,9,WA84,"Maschinen, Apparate, mechanische Geräte",15889843000,8906978000,24796821000
2013,9,WA85,Elektrotechnische Erzeugnisse,9276597000,8576696000,17853293000
2013,9,WA86,Schienenfahrzeuge,382518000,177306000,559824000
2013,9,WA87,"Kraftfahrzeuge, Landfahrzeuge",16738753000,6094715000,22833468000
2013,9,WA88,"Luftfahrzeuge, Raumfahrzeuge",3381897000,738120000,4120017000
2013,9,WA89,Wasserfahrzeuge,138770000,179429000,318199000
2013,9,WA90,"Optische, photografische usw. Erzeugnisse",4395368000,2266539000,6661907000
2013,9,WA91,Uhrmacherwaren,169018000,187044000,356062000
2013,9,WA92,Musikinstrumente,55171000,44834000,100005000
2013,9,WA93,Waffen und Munition,52746000,14062000,66808000
2013,9,WA94,"Möbel, Beleuchtungskörper usw.",1102165000,1242677000,2344842000
2013,9,WA95,"Spielzeug, Spiele usw., Sportgeräte",313245000,459965000,773210000
2013,9,WA96,Verschiedene Waren,289705000,188855000,478560000
2013,9,WA97,"Kunstgegenstände, Sammlungsstücke",61623000,18894000,80517000
2013,9,WA98,Vollständige Fabrikationsanlagen,218214000,2392000,220606000
2013,9,WA99,Zusammenstellungen verschiedener Waren,1385897000,791594000,2177491000
2013,10,WA01,Lebende Tiere,137047000,180977000,318024000
2013,10,WA02,Fleisch,716159000,559567000,1275726000
2013,10,WA03,"Fische, Krebs- und Weichtiere",116311000,306434000,422745000
2013,10,WA04,"Milch, Milcherzeugnisse, Eier, Honig",800331000,658166000,1458497000
2013,10,WA05,Andere Waren tierischen Ursprungs,70032000,75075000,145107000
2013,10,WA06,"Pflanzen, Waren des Blumenhandels",73634000,174855000,248489000
2013,10,WA07,"Gemüse, Pflanzen für Ernährung",70573000,329450000,400023000
2013,10,WA08,Genießbare Früchte und Nüsse,115346000,722670000,838016000
2013,10,WA09,"Kaffee, Tee, Mate, Gewürze",217962000,297838000,515800000
2013,10,WA10,Getreide,307327000,229258000,536585000
2013,10,WA11,"Müllereierzeugnisse, Malz usw.",112009000,45286000,157295000
2013,10,WA12,"Ölsamen usw., Heilpflanzen usw.",63044000,455279000,518323000
2013,10,WA13,"Schellack, Gummen, Harz, Pflanzensaft",39917000,33565000,73482000
2013,10,WA14,Flechtstoffe usw. pflanzlichen Ursprungs,672000,2781000,3453000
2013,10,WA15,"Tierische und pflanzliche Fette, Öle, Wachs",266656000,318529000,585185000
2013,10,WA16,"Zubereitungen von Fleisch, Fisch usw.",242498000,202440000,444938000
2013,10,WA17,Zucker und Zuckerwaren,174077000,140903000,314980000
2013,10,WA18,Kakao und Zubereitungen aus Kakao,480976000,328663000,809639000
2013,10,WA19,"Zubereitungen aus Getreide usw., Backwaren",486510000,276765000,763275000
2013,10,WA20,"Zubereitungen von Gemüse, Früchten usw.",208089000,378227000,586316000
2013,10,WA21,Verschiedene Lebensmittelzubereitungen,389259000,214155000,603414000
2013,10,WA22,"Getränke, alkoholhaltige Flüssigkeiten, Essig",450066000,609410000,1059476000
2013,10,WA23,"Rückstände der Lebensmittelindustrie, Futter",319582000,320089000,639671000
2013,10,WA24,Tabak,279258000,163545000,442803000
2013,10,WA25,"Salz, Schwefel, Steine, Erden usw.",192498000,159571000,352069000
2013,10,WA26,"Erze, Schlacken, Aschen",32222000,697015000,729237000
2013,10,WA27,Mineralische Brennstoffe usw.,2357544000,10747911000,13105455000
2013,10,WA28,Anorganische chemische Erzeugnisse,723799000,507800000,1231599000
2013,10,WA29,Organische chemische Erzeugnisse,2162429000,2051117000,4213546000
2013,10,WA30,Pharmazeutische Erzeugnisse,5387787000,3065386000,8453173000
2013,10,WA31,Düngemittel,186622000,100718000,287340000
2013,10,WA32,"Gerb- und Farbstoffe, Farben, Lacke usw.",926516000,515302000,1441818000
2013,10,WA33,"Etherische Öle, Riech-, Schönheitsmittel",748792000,505237000,1254029000
2013,10,WA34,"Seifen, Waschmittel usw.",579682000,307321000,887003000
2013,10,WA35,"Eiweißstoffe, Klebstoffe, Enzyme",256439000,167558000,423997000
2013,10,WA36,"Sprengstoffe, pyrotechnische Artikel usw.",17272000,29068000,46340000
2013,10,WA37,Photochemische Erzeugnisse,97791000,62223000,160014000
2013,10,WA38,Verschiedene Erzeugnisse der Chemischen Industrie,1595957000,914871000,2510828000
2013,10,WA39,Kunststoffe und Waren daraus,4657566000,2810531000,7468097000
2013,10,WA40,Kautschuk und Waren daraus,1350310000,1268635000,2618945000
2013,10,WA41,"Häute, Felle, Leder",99372000,88192000,187564000
2013,10,WA42,"Lederwaren, Sattlerwaren",140905000,269499000,410404000
2013,10,WA43,"Pelzfelle, künstliches Pelzwerk",15044000,11931000,26975000
2013,10,WA44,"Holz, Holzwaren, Holzkohle",616488000,597543000,1214031000
2013,10,WA45,"Kork, Korkwaren",2404000,8356000,10760000
2013,10,WA46,"Flechtwaren, Korbmacherwaren",3776000,9087000,12863000
2013,10,WA47,"Halbstoffe aus Holz usw., Papierabfall",93821000,279494000,373315000
2013,10,WA48,"Papier, Pappe und Waren daraus",1538674000,993747000,2532421000
2013,10,WA49,"Bücher, Zeitungen, Bilddrucke usw.",393326000,171570000,564896000
2013,10,WA50,Seide,6623000,6434000,13057000
2013,10,WA51,"Wolle, feine und grobe Tierhaare",47971000,55473000,103444000
2013,10,WA52,Baumwolle,98004000,100790000,198794000
2013,10,WA53,"Andere pflanzliche Spinnstoffe, Papiergarn",3830000,6356000,10186000
2013,10,WA54,Synthetisches oder künstliches Filament,176817000,130907000,307724000
2013,10,WA55,Synthetische oder künstliche Spinnfaser,170963000,139830000,310793000
2013,10,WA56,"Watte, Filz, Vliesstoff usw., Tauwerk",206211000,96885000,303096000
2013,10,WA57,"Teppiche, Fußbodenbelag aus Spinnstoff",45652000,89207000,134859000
2013,10,WA58,"Spezialgewebe, Spitzen, Tapisserien",43358000,25135000,68493000
2013,10,WA59,"Getränkte, bestrichene usw. Gewebe",182480000,96711000,279191000
2013,10,WA60,Gewirke und Gestricke,71313000,39259000,110572000
2013,10,WA61,"Bekleidung usw. aus Gewirken, Gestricken",584151000,1218288000,1802439000
2013,10,WA62,"Andere Bekleidung, Bekleidungszubehör",622213000,1134063000,1756276000
2013,10,WA63,"Andere Konfektion, Spinnstoffwaren usw.",208127000,276810000,484937000
2013,10,WA64,"Schuhe, Gamaschen, ähnliche Waren",300176000,545858000,846034000
2013,10,WA65,Kopfbedeckungen und Teile davon,32735000,41514000,74249000
2013,10,WA66,"Schirme, Gehstöcke usw., Peitschen",6247000,8419000,14666000
2013,10,WA67,"Zugerichtete Federn, Daunen, künstliche Blumen",9499000,11505000,21004000
2013,10,WA68,"Waren aus Steinen, Gips, Zement usw.",354583000,221881000,576464000
2013,10,WA69,Keramische Waren,267000000,207189000,474189000
2013,10,WA70,Glas und Glaswaren,491654000,365991000,857645000
2013,10,WA71,"Perlen, Edelsteine, Edelmetalle",1112722000,1496499000,2609221000
2013,10,WA72,Eisen und Stahl,1928579000,2017332000,3945911000
2013,10,WA73,Waren aus Eisen oder Stahl,2306587000,1585265000,3891852000
2013,10,WA74,Kupfer und Waren daraus,940164000,941675000,1881839000
2013,10,WA75,Nickel und Waren daraus,79920000,102112000,182032000
2013,10,WA76,Aluminium und Waren daraus,1056998000,1122600000,2179598000
2013,10,WA78,Blei und Waren daraus,41932000,36781000,78713000
2013,10,WA79,Zink und Waren daraus,51368000,95775000,147143000
2013,10,WA80,Zinn und Waren daraus,9933000,31789000,41722000
2013,10,WA81,"Andere unedle Metalle, Cermets usw.",111892000,125113000,237005000
2013,10,WA82,"Werkzeuge, Schneidwaren, Essbestecke",644594000,351222000,995816000
2013,10,WA83,Verschiedene Waren aus unedlen Metallen,603000000,343817000,946817000
2013,10,WA84,"Maschinen, Apparate, mechanische Geräte",16474349000,9714883000,26189232000
2013,10,WA85,Elektrotechnische Erzeugnisse,9835363000,9074620000,18909983000
2013,10,WA86,Schienenfahrzeuge,304018000,232903000,536921000
2013,10,WA87,"Kraftfahrzeuge, Landfahrzeuge",16941051000,7029773000,23970824000
2013,10,WA88,"Luftfahrzeuge, Raumfahrzeuge",3253679000,2098982000,5352661000
2013,10,WA89,Wasserfahrzeuge,157290000,366551000,523841000
2013,10,WA90,"Optische, photografische usw. Erzeugnisse",4467048000,2428077000,6895125000
2013,10,WA91,Uhrmacherwaren,164374000,221514000,385888000
2013,10,WA92,Musikinstrumente,52562000,45124000,97686000
2013,10,WA93,Waffen und Munition,34783000,14925000,49708000
2013,10,WA94,"Möbel, Beleuchtungskörper usw.",1223580000,1351263000,2574843000
2013,10,WA95,"Spielzeug, Spiele usw., Sportgeräte",390733000,513315000,904048000
2013,10,WA96,Verschiedene Waren,303162000,199384000,502546000
2013,10,WA97,"Kunstgegenstände, Sammlungsstücke",47771000,25002000,72773000
2013,10,WA98,Vollständige Fabrikationsanlagen,191114000,2392000,193506000
2013,10,WA99,Zusammenstellungen verschiedener Waren,1553700000,821067000,2374767000
2013,11,WA01,Lebende Tiere,126008000,166924000,292932000
2013,11,WA02,Fleisch,661732000,517347000,1179079000
2013,11,WA03,"Fische, Krebs- und Weichtiere",109210000,293144000,402354000
2013,11,WA04,"Milch, Milcherzeugnisse, Eier, Honig",752984000,566760000,1319744000
2013,11,WA05,Andere Waren tierischen Ursprungs,65741000,71663000,137404000
2013,11,WA06,"Pflanzen, Waren des Blumenhandels",61229000,170049000,231278000
2013,11,WA07,"Gemüse, Pflanzen für Ernährung",81188000,318425000,399613000
2013,11,WA08,Genießbare Früchte und Nüsse,113751000,563139000,676890000
2013,11,WA09,"Kaffee, Tee, Mate, Gewürze",186836000,271845000,458681000
2013,11,WA10,Getreide,221849000,231282000,453131000
2013,11,WA11,"Müllereierzeugnisse, Malz usw.",113462000,42765000,156227000
2013,11,WA12,"Ölsamen usw., Heilpflanzen usw.",64528000,391480000,456008000
2013,11,WA13,"Schellack, Gummen, Harz, Pflanzensaft",37745000,28357000,66102000
2013,11,WA14,Flechtstoffe usw. pflanzlichen Ursprungs,515000,1680000,2195000
2013,11,WA15,"Tierische und pflanzliche Fette, Öle, Wachs",230330000,289401000,519731000
2013,11,WA16,"Zubereitungen von Fleisch, Fisch usw.",219117000,195548000,414665000
2013,11,WA17,Zucker und Zuckerwaren,174529000,132935000,307464000
2013,11,WA18,Kakao und Zubereitungen aus Kakao,393688000,306520000,700208000
2013,11,WA19,"Zubereitungen aus Getreide usw., Backwaren",434735000,258847000,693582000
2013,11,WA20,"Zubereitungen von Gemüse, Früchten usw.",184788000,337462000,522250000
2013,11,WA21,Verschiedene Lebensmittelzubereitungen,380083000,208040000,588123000
2013,11,WA22,"Getränke, alkoholhaltige Flüssigkeiten, Essig",407448000,595884000,1003332000
2013,11,WA23,"Rückstände der Lebensmittelindustrie, Futter",308435000,251403000,559838000
2013,11,WA24,Tabak,292946000,171032000,463978000
2013,11,WA25,"Salz, Schwefel, Steine, Erden usw.",151371000,155332000,306703000
2013,11,WA26,"Erze, Schlacken, Aschen",26208000,650154000,676362000
2013,11,WA27,Mineralische Brennstoffe usw.,2313573000,11004025000,13317598000
2013,11,WA28,Anorganische chemische Erzeugnisse,627295000,517124000,1144419000
2013,11,WA29,Organische chemische Erzeugnisse,2139157000,2166463000,4305620000
2013,11,WA30,Pharmazeutische Erzeugnisse,5062143000,2913073000,7975216000
2013,11,WA31,Düngemittel,173093000,122964000,296057000
2013,11,WA32,"Gerb- und Farbstoffe, Farben, Lacke usw.",838886000,460256000,1299142000
2013,11,WA33,"Etherische Öle, Riech-, Schönheitsmittel",704082000,429156000,1133238000
2013,11,WA34,"Seifen, Waschmittel usw.",526451000,273086000,799537000
2013,11,WA35,"Eiweißstoffe, Klebstoffe, Enzyme",233656000,156431000,390087000
2013,11,WA36,"Sprengstoffe, pyrotechnische Artikel usw.",25622000,29534000,55156000
2013,11,WA37,Photochemische Erzeugnisse,94134000,67076000,161210000
2013,11,WA38,Verschiedene Erzeugnisse der Chemischen Industrie,1605565000,894557000,2500122000
2013,11,WA39,Kunststoffe und Waren daraus,4190696000,2584809000,6775505000
2013,11,WA40,Kautschuk und Waren daraus,1178234000,1086595000,2264829000
2013,11,WA41,"Häute, Felle, Leder",99673000,72340000,172013000
2013,11,WA42,"Lederwaren, Sattlerwaren",130298000,269363000,399661000
2013,11,WA43,"Pelzfelle, künstliches Pelzwerk",13411000,11664000,25075000
2013,11,WA44,"Holz, Holzwaren, Holzkohle",568736000,553174000,1121910000
2013,11,WA45,"Kork, Korkwaren",1958000,5628000,7586000
2013,11,WA46,"Flechtwaren, Korbmacherwaren",2908000,8225000,11133000
2013,11,WA47,"Halbstoffe aus Holz usw., Papierabfall",95168000,305443000,400611000
2013,11,WA48,"Papier, Pappe und Waren daraus",1382024000,932047000,2314071000
2013,11,WA49,"Bücher, Zeitungen, Bilddrucke usw.",374571000,158539000,533110000
2013,11,WA50,Seide,5949000,5739000,11688000
2013,11,WA51,"Wolle, feine und grobe Tierhaare",36760000,52456000,89216000
2013,11,WA52,Baumwolle,93869000,95835000,189704000
2013,11,WA53,"Andere pflanzliche Spinnstoffe, Papiergarn",4256000,7624000,11880000
2013,11,WA54,Synthetisches oder künstliches Filament,156904000,121211000,278115000
2013,11,WA55,Synthetische oder künstliche Spinnfaser,162088000,124866000,286954000
2013,11,WA56,"Watte, Filz, Vliesstoff usw., Tauwerk",176972000,92064000,269036000
2013,11,WA57,"Teppiche, Fußbodenbelag aus Spinnstoff",39916000,80071000,119987000
2013,11,WA58,"Spezialgewebe, Spitzen, Tapisserien",39567000,23965000,63532000
2013,11,WA59,"Getränkte, bestrichene usw. Gewebe",169376000,88240000,257616000
2013,11,WA60,Gewirke und Gestricke,65641000,34798000,100439000
2013,11,WA61,"Bekleidung usw. aus Gewirken, Gestricken",490172000,1067558000,1557730000
2013,11,WA62,"Andere Bekleidung, Bekleidungszubehör",476470000,941792000,1418262000
2013,11,WA63,"Andere Konfektion, Spinnstoffwaren usw.",173895000,244729000,418624000
2013,11,WA64,"Schuhe, Gamaschen, ähnliche Waren",203798000,491730000,695528000
2013,11,WA65,Kopfbedeckungen und Teile davon,24494000,34049000,58543000
2013,11,WA66,"Schirme, Gehstöcke usw., Peitschen",4527000,7355000,11882000
2013,11,WA67,"Zugerichtete Federn, Daunen, künstliche Blumen",6314000,10696000,17010000
2013,11,WA68,"Waren aus Steinen, Gips, Zement usw.",304692000,211438000,516130000
2013,11,WA69,Keramische Waren,242294000,186881000,429175000
2013,11,WA70,Glas und Glaswaren,450636000,366351000,816987000
2013,11,WA71,"Perlen, Edelsteine, Edelmetalle",876250000,1383246000,2259496000
2013,11,WA72,Eisen und Stahl,1737440000,1785641000,3523081000
2013,11,WA73,Waren aus Eisen oder Stahl,2048045000,1440181000,3488226000
2013,11,WA74,Kupfer und Waren daraus,873318000,807932000,1681250000
2013,11,WA75,Nickel und Waren daraus,76957000,112038000,188995000
2013,11,WA76,Aluminium und Waren daraus,1001718000,1042358000,2044076000
2013,11,WA78,Blei und Waren daraus,40224000,21893000,62117000
2013,11,WA79,Zink und Waren daraus,48745000,86339000,135084000
2013,11,WA80,Zinn und Waren daraus,9946000,27113000,37059000
2013,11,WA81,"Andere unedle Metalle, Cermets usw.",107049000,97145000,204194000
2013,11,WA82,"Werkzeuge, Schneidwaren, Essbestecke",586063000,335259000,921322000
2013,11,WA83,Verschiedene Waren aus unedlen Metallen,527094000,302248000,829342000
2013,11,WA84,"Maschinen, Apparate, mechanische Geräte",15908411000,9263818000,25172229000
2013,11,WA85,Elektrotechnische Erzeugnisse,9355936000,8529496000,17885432000
2013,11,WA86,Schienenfahrzeuge,253655000,139780000,393435000
2013,11,WA87,"Kraftfahrzeuge, Landfahrzeuge",16505580000,6457839000,22963419000
2013,11,WA88,"Luftfahrzeuge, Raumfahrzeuge",3460862000,1894031000,5354893000
2013,11,WA89,Wasserfahrzeuge,660552000,485926000,1146478000
2013,11,WA90,"Optische, photografische usw. Erzeugnisse",4354247000,2345537000,6699784000
2013,11,WA91,Uhrmacherwaren,171980000,218465000,390445000
2013,11,WA92,Musikinstrumente,52645000,46330000,98975000
2013,11,WA93,Waffen und Munition,41379000,18065000,59444000
2013,11,WA94,"Möbel, Beleuchtungskörper usw.",1138213000,1222239000,2360452000
2013,11,WA95,"Spielzeug, Spiele usw., Sportgeräte",413404000,450133000,863537000
2013,11,WA96,Verschiedene Waren,269264000,183647000,452911000
2013,11,WA97,"Kunstgegenstände, Sammlungsstücke",79233000,40440000,119673000
2013,11,WA98,Vollständige Fabrikationsanlagen,253763000,606000,254369000
2013,11,WA99,Zusammenstellungen verschiedener Waren,1615555000,778102000,2393657000
2013,12,WA01,Lebende Tiere,135315000,164623000,299938000
2013,12,WA02,Fleisch,617568000,546787000,1164355000
2013,12,WA03,"Fische, Krebs- und Weichtiere",107832000,293774000,401606000
2013,12,WA04,"Milch, Milcherzeugnisse, Eier, Honig",743655000,624071000,1367726000
2013,12,WA05,Andere Waren tierischen Ursprungs,62585000,79012000,141597000
2013,12,WA06,"Pflanzen, Waren des Blumenhandels",54220000,191701000,245921000
2013,12,WA07,"Gemüse, Pflanzen für Ernährung",81768000,489089000,570857000
2013,12,WA08,Genießbare Früchte und Nüsse,128406000,707001000,835407000
2013,12,WA09,"Kaffee, Tee, Mate, Gewürze",150973000,234117000,385090000
2013,12,WA10,Getreide,269625000,235161000,504786000
2013,12,WA11,"Müllereierzeugnisse, Malz usw.",94911000,37133000,132044000
2013,12,WA12,"Ölsamen usw., Heilpflanzen usw.",89622000,421320000,510942000
2013,12,WA13,"Schellack, Gummen, Harz, Pflanzensaft",34220000,28923000,63143000
2013,12,WA14,Flechtstoffe usw. pflanzlichen Ursprungs,559000,2660000,3219000
2013,12,WA15,"Tierische und pflanzliche Fette, Öle, Wachs",182329000,289077000,471406000
2013,12,WA16,"Zubereitungen von Fleisch, Fisch usw.",223669000,209715000,433384000
2013,12,WA17,Zucker und Zuckerwaren,149917000,112369000,262286000
2013,12,WA18,Kakao und Zubereitungen aus Kakao,341976000,255356000,597332000
2013,12,WA19,"Zubereitungen aus Getreide usw., Backwaren",391923000,257786000,649709000
2013,12,WA20,"Zubereitungen von Gemüse, Früchten usw.",192921000,377836000,570757000
2013,12,WA21,Verschiedene Lebensmittelzubereitungen,340528000,192790000,533318000
2013,12,WA22,"Getränke, alkoholhaltige Flüssigkeiten, Essig",389569000,542108000,931677000
2013,12,WA23,"Rückstände der Lebensmittelindustrie, Futter",304891000,344405000,649296000
2013,12,WA24,Tabak,255602000,134610000,390212000
2013,12,WA25,"Salz, Schwefel, Steine, Erden usw.",133889000,124168000,258057000
2013,12,WA26,"Erze, Schlacken, Aschen",24253000,549612000,573865000
2013,12,WA27,Mineralische Brennstoffe usw.,2430526000,10344682000,12775208000
2013,12,WA28,Anorganische chemische Erzeugnisse,568031000,431541000,999572000
2013,12,WA29,Organische chemische Erzeugnisse,1857135000,1711050000,3568185000
2013,12,WA30,Pharmazeutische Erzeugnisse,4174574000,2501051000,6675625000
2013,12,WA31,Düngemittel,149221000,115908000,265129000
2013,12,WA32,"Gerb- und Farbstoffe, Farben, Lacke usw.",655403000,414331000,1069734000
2013,12,WA33,"Etherische Öle, Riech-, Schönheitsmittel",611927000,422625000,1034552000
2013,12,WA34,"Seifen, Waschmittel usw.",428746000,248406000,677152000
2013,12,WA35,"Eiweißstoffe, Klebstoffe, Enzyme",199857000,133456000,333313000
2013,12,WA36,"Sprengstoffe, pyrotechnische Artikel usw.",27126000,26396000,53522000
2013,12,WA37,Photochemische Erzeugnisse,71687000,63709000,135396000
2013,12,WA38,Verschiedene Erzeugnisse der Chemischen Industrie,1296465000,868037000,2164502000
2013,12,WA39,Kunststoffe und Waren daraus,3351618000,2257512000,5609130000
2013,12,WA40,Kautschuk und Waren daraus,883147000,796965000,1680112000
2013,12,WA41,"Häute, Felle, Leder",79660000,76735000,156395000
2013,12,WA42,"Lederwaren, Sattlerwaren",118739000,261138000,379877000
2013,12,WA43,"Pelzfelle, künstliches Pelzwerk",11080000,12879000,23959000
2013,12,WA44,"Holz, Holzwaren, Holzkohle",442510000,445971000,888481000
2013,12,WA45,"Kork, Korkwaren",1501000,8544000,10045000
2013,12,WA46,"Flechtwaren, Korbmacherwaren",2406000,8066000,10472000
2013,12,WA47,"Halbstoffe aus Holz usw., Papierabfall",79637000,299900000,379537000
2013,12,WA48,"Papier, Pappe und Waren daraus",1173194000,830551000,2003745000
2013,12,WA49,"Bücher, Zeitungen, Bilddrucke usw.",356834000,161158000,517992000
2013,12,WA50,Seide,3636000,4960000,8596000
2013,12,WA51,"Wolle, feine und grobe Tierhaare",27496000,44697000,72193000
2013,12,WA52,Baumwolle,77760000,78475000,156235000
2013,12,WA53,"Andere pflanzliche Spinnstoffe, Papiergarn",3745000,5481000,9226000
2013,12,WA54,Synthetisches oder künstliches Filament,113971000,84266000,198237000
2013,12,WA55,Synthetische oder künstliche Spinnfaser,135291000,98569000,233860000
2013,12,WA56,"Watte, Filz, Vliesstoff usw., Tauwerk",139996000,72588000,212584000
2013,12,WA57,"Teppiche, Fußbodenbelag aus Spinnstoff",35547000,76175000,111722000
2013,12,WA58,"Spezialgewebe, Spitzen, Tapisserien",28697000,18561000,47258000
2013,12,WA59,"Getränkte, bestrichene usw. Gewebe",136712000,76900000,213612000
2013,12,WA60,Gewirke und Gestricke,48341000,25272000,73613000
2013,12,WA61,"Bekleidung usw. aus Gewirken, Gestricken",405395000,945120000,1350515000
2013,12,WA62,"Andere Bekleidung, Bekleidungszubehör",397106000,911857000,1308963000
2013,12,WA63,"Andere Konfektion, Spinnstoffwaren usw.",165610000,230476000,396086000
2013,12,WA64,"Schuhe, Gamaschen, ähnliche Waren",224358000,515976000,740334000
2013,12,WA65,Kopfbedeckungen und Teile davon,19997000,32406000,52403000
2013,12,WA66,"Schirme, Gehstöcke usw., Peitschen",6366000,9421000,15787000
2013,12,WA67,"Zugerichtete Federn, Daunen, künstliche Blumen",6096000,12697000,18793000
2013,12,WA68,"Waren aus Steinen, Gips, Zement usw.",254834000,168803000,423637000
2013,12,WA69,Keramische Waren,227723000,161293000,389016000
2013,12,WA70,Glas und Glaswaren,365678000,277255000,642933000
2013,12,WA71,"Perlen, Edelsteine, Edelmetalle",1032050000,1093836000,2125886000
2013,12,WA72,Eisen und Stahl,1423736000,1383124000,2806860000
2013,12,WA73,Waren aus Eisen oder Stahl,1736187000,1212044000,2948231000
2013,12,WA74,Kupfer und Waren daraus,672075000,684986000,1357061000
2013,12,WA75,Nickel und Waren daraus,70081000,87025000,157106000
2013,12,WA76,Aluminium und Waren daraus,809101000,826437000,1635538000
2013,12,WA78,Blei und Waren daraus,26186000,18064000,44250000
2013,12,WA79,Zink und Waren daraus,37709000,69146000,106855000
2013,12,WA80,Zinn und Waren daraus,7431000,23525000,30956000
2013,12,WA81,"Andere unedle Metalle, Cermets usw.",89978000,102488000,192466000
2013,12,WA82,"Werkzeuge, Schneidwaren, Essbestecke",493155000,289676000,782831000
2013,12,WA83,Verschiedene Waren aus unedlen Metallen,418325000,256272000,674597000
2013,12,WA84,"Maschinen, Apparate, mechanische Geräte",15494580000,8314665000,23809245000
2013,12,WA85,Elektrotechnische Erzeugnisse,7892985000,7224624000,15117609000
2013,12,WA86,Schienenfahrzeuge,300395000,301596000,601991000
2013,12,WA87,"Kraftfahrzeuge, Landfahrzeuge",12623030000,5497304000,18120334000
2013,12,WA88,"Luftfahrzeuge, Raumfahrzeuge",3168487000,1456999000,4625486000
2013,12,WA89,Wasserfahrzeuge,249455000,32749000,282204000
2013,12,WA90,"Optische, photografische usw. Erzeugnisse",4129667000,2188120000,6317787000
2013,12,WA91,Uhrmacherwaren,150636000,162474000,313110000
2013,12,WA92,Musikinstrumente,47600000,46165000,93765000
2013,12,WA93,Waffen und Munition,35573000,12049000,47622000
2013,12,WA94,"Möbel, Beleuchtungskörper usw.",985798000,1142075000,2127873000
2013,12,WA95,"Spielzeug, Spiele usw., Sportgeräte",311960000,505594000,817554000
2013,12,WA96,Verschiedene Waren,254084000,168717000,422801000
2013,12,WA97,"Kunstgegenstände, Sammlungsstücke",52970000,30372000,83342000
2013,12,WA98,Vollständige Fabrikationsanlagen,207675000,1627000,209302000
2013,12,WA99,Zusammenstellungen verschiedener Waren,1358981000,699351000,2058332000
2014,1,WA01,Lebende Tiere,130150000,199487000,329637000
2014,1,WA02,Fleisch,626049000,496031000,1122080000
2014,1,WA03,"Fische, Krebs- und Weichtiere",109905000,304103000,414008000
2014,1,WA04,"Milch, Milcherzeugnisse, Eier, Honig",881405000,592498000,1473903000
2014,1,WA05,Andere Waren tierischen Ursprungs,70884000,73776000,144660000
2014,1,WA06,"Pflanzen, Waren des Blumenhandels",48781000,185179000,233960000
2014,1,WA07,"Gemüse, Pflanzen für Ernährung",75547000,487169000,562716000
2014,1,WA08,Genießbare Früchte und Nüsse,115406000,637725000,753131000
2014,1,WA09,"Kaffee, Tee, Mate, Gewürze",186574000,276368000,462942000
2014,1,WA10,Getreide,262488000,259237000,521725000
2014,1,WA11,"Müllereierzeugnisse, Malz usw.",104073000,42256000,146329000
2014,1,WA12,"Ölsamen usw., Heilpflanzen usw.",125926000,379919000,505845000
2014,1,WA13,"Schellack, Gummen, Harz, Pflanzensaft",41445000,32735000,74180000
2014,1,WA14,Flechtstoffe usw. pflanzlichen Ursprungs,790000,2160000,2950000
2014,1,WA15,"Tierische und pflanzliche Fette, Öle, Wachs",244017000,305024000,549041000
2014,1,WA16,"Zubereitungen von Fleisch, Fisch usw.",231975000,200292000,432267000
2014,1,WA17,Zucker und Zuckerwaren,150184000,138770000,288954000
2014,1,WA18,Kakao und Zubereitungen aus Kakao,359242000,312921000,672163000
2014,1,WA19,"Zubereitungen aus Getreide usw., Backwaren",414490000,267516000,682006000
2014,1,WA20,"Zubereitungen von Gemüse, Früchten usw.",205525000,354857000,560382000
2014,1,WA21,Verschiedene Lebensmittelzubereitungen,368891000,205585000,574476000
2014,1,WA22,"Getränke, alkoholhaltige Flüssigkeiten, Essig",369686000,484640000,854326000
2014,1,WA23,"Rückstände der Lebensmittelindustrie, Futter",325729000,338361000,664090000
2014,1,WA24,Tabak,254047000,121035000,375082000
2014,1,WA25,"Salz, Schwefel, Steine, Erden usw.",146988000,136130000,283118000
2014,1,WA26,"Erze, Schlacken, Aschen",24975000,794905000,819880000
2014,1,WA27,Mineralische Brennstoffe usw.,2408748000,10104815000,12513563000
2014,1,WA28,Anorganische chemische Erzeugnisse,711748000,524705000,1236453000
2014,1,WA29,Organische chemische Erzeugnisse,2362687000,2198535000,4561222000
2014,1,WA30,Pharmazeutische Erzeugnisse,5260170000,2898892000,8159062000
2014,1,WA31,Düngemittel,185283000,148610000,333893000
2014,1,WA32,"Gerb- und Farbstoffe, Farben, Lacke usw.",883777000,487387000,1371164000
2014,1,WA33,"Etherische Öle, Riech-, Schönheitsmittel",627754000,396830000,1024584000
2014,1,WA34,"Seifen, Waschmittel usw.",562075000,240806000,802881000
2014,1,WA35,"Eiweißstoffe, Klebstoffe, Enzyme",240581000,170788000,411369000
2014,1,WA36,"Sprengstoffe, pyrotechnische Artikel usw.",16647000,18437000,35084000
2014,1,WA37,Photochemische Erzeugnisse,103901000,52707000,156608000
2014,1,WA38,Verschiedene Erzeugnisse der Chemischen Industrie,1701622000,942784000,2644406000
2014,1,WA39,Kunststoffe und Waren daraus,4531654000,2768322000,7299976000
2014,1,WA40,Kautschuk und Waren daraus,1139283000,1077896000,2217179000
2014,1,WA41,"Häute, Felle, Leder",98434000,74572000,173006000
2014,1,WA42,"Lederwaren, Sattlerwaren",143508000,303811000,447319000
2014,1,WA43,"Pelzfelle, künstliches Pelzwerk",14758000,10629000,25387000
2014,1,WA44,"Holz, Holzwaren, Holzkohle",569173000,579604000,1148777000
2014,1,WA45,"Kork, Korkwaren",2267000,8371000,10638000
2014,1,WA46,"Flechtwaren, Korbmacherwaren",3731000,9794000,13525000
2014,1,WA47,"Halbstoffe aus Holz usw., Papierabfall",101874000,288965000,390839000
2014,1,WA48,"Papier, Pappe und Waren daraus",1452915000,1019729000,2472644000
2014,1,WA49,"Bücher, Zeitungen, Bilddrucke usw.",333631000,143774000,477405000
2014,1,WA50,Seide,5855000,6889000,12744000
2014,1,WA51,"Wolle, feine und grobe Tierhaare",43739000,48840000,92579000
2014,1,WA52,Baumwolle,86643000,92560000,179203000
2014,1,WA53,"Andere pflanzliche Spinnstoffe, Papiergarn",4203000,6330000,10533000
2014,1,WA54,Synthetisches oder künstliches Filament,163313000,118318000,281631000
2014,1,WA55,Synthetische oder künstliche Spinnfaser,167794000,138849000,306643000
2014,1,WA56,"Watte, Filz, Vliesstoff usw., Tauwerk",182646000,99472000,282118000
2014,1,WA57,"Teppiche, Fußbodenbelag aus Spinnstoff",41333000,98000000,139333000
2014,1,WA58,"Spezialgewebe, Spitzen, Tapisserien",38844000,24660000,63504000
2014,1,WA59,"Getränkte, bestrichene usw. Gewebe",173166000,88130000,261296000
2014,1,WA60,Gewirke und Gestricke,62602000,34038000,96640000
2014,1,WA61,"Bekleidung usw. aus Gewirken, Gestricken",604380000,1239850000,1844230000
2014,1,WA62,"Andere Bekleidung, Bekleidungszubehör",692362000,1319013000,2011375000
2014,1,WA63,"Andere Konfektion, Spinnstoffwaren usw.",178705000,293102000,471807000
2014,1,WA64,"Schuhe, Gamaschen, ähnliche Waren",421373000,822439000,1243812000
2014,1,WA65,Kopfbedeckungen und Teile davon,27508000,35149000,62657000
2014,1,WA66,"Schirme, Gehstöcke usw., Peitschen",6204000,17688000,23892000
2014,1,WA67,"Zugerichtete Federn, Daunen, künstliche Blumen",9083000,14948000,24031000
2014,1,WA68,"Waren aus Steinen, Gips, Zement usw.",300352000,195360000,495712000
2014,1,WA69,Keramische Waren,229082000,189297000,418379000
2014,1,WA70,Glas und Glaswaren,453648000,346934000,800582000
2014,1,WA71,"Perlen, Edelsteine, Edelmetalle",874238000,1087275000,1961513000
2014,1,WA72,Eisen und Stahl,1834314000,1985348000,3819662000
2014,1,WA73,Waren aus Eisen oder Stahl,2048198000,1389428000,3437626000
2014,1,WA74,Kupfer und Waren daraus,950215000,768706000,1718921000
2014,1,WA75,Nickel und Waren daraus,78530000,88813000,167343000
2014,1,WA76,Aluminium und Waren daraus,994658000,1082556000,2077214000
2014,1,WA78,Blei und Waren daraus,40673000,20225000,60898000
2014,1,WA79,Zink und Waren daraus,50491000,82989000,133480000
2014,1,WA80,Zinn und Waren daraus,11559000,33739000,45298000
2014,1,WA81,"Andere unedle Metalle, Cermets usw.",112549000,109696000,222245000
2014,1,WA82,"Werkzeuge, Schneidwaren, Essbestecke",579412000,352532000,931944000
2014,1,WA83,Verschiedene Waren aus unedlen Metallen,552375000,339204000,891579000
2014,1,WA84,"Maschinen, Apparate, mechanische Geräte",14804202000,9463544000,24267746000
2014,1,WA85,Elektrotechnische Erzeugnisse,8843030000,8281104000,17124134000
2014,1,WA86,Schienenfahrzeuge,253516000,160113000,413629000
2014,1,WA87,"Kraftfahrzeuge, Landfahrzeuge",15121324000,5708284000,20829608000
2014,1,WA88,"Luftfahrzeuge, Raumfahrzeuge",1734456000,1433519000,3167975000
2014,1,WA89,Wasserfahrzeuge,99535000,73495000,173030000
2014,1,WA90,"Optische, photografische usw. Erzeugnisse",3946293000,2258052000,6204345000
2014,1,WA91,Uhrmacherwaren,133845000,164095000,297940000
2014,1,WA92,Musikinstrumente,37034000,37625000,74659000
2014,1,WA93,Waffen und Munition,28966000,13215000,42181000
2014,1,WA94,"Möbel, Beleuchtungskörper usw.",1027300000,1276121000,2303421000
2014,1,WA95,"Spielzeug, Spiele usw., Sportgeräte",217521000,341690000,559211000
2014,1,WA96,Verschiedene Waren,407686000,280132000,687818000
2014,1,WA97,"Kunstgegenstände, Sammlungsstücke",61204000,24373000,85577000
2014,1,WA98,Vollständige Fabrikationsanlagen,217432000,935000,218367000
2014,1,WA99,Zusammenstellungen verschiedener Waren,1403822000,812955000,2216777000
2014,2,WA01,Lebende Tiere,124806000,164519000,289325000
2014,2,WA02,Fleisch,564500000,461879000,1026379000
2014,2,WA03,"Fische, Krebs- und Weichtiere",93481000,263873000,357354000
2014,2,WA04,"Milch, Milcherzeugnisse, Eier, Honig",780286000,541698000,1321984000
2014,2,WA05,Andere Waren tierischen Ursprungs,64151000,73138000,137289000
2014,2,WA06,"Pflanzen, Waren des Blumenhandels",66754000,257973000,324727000
2014,2,WA07,"Gemüse, Pflanzen für Ernährung",79539000,491022000,570561000
2014,2,WA08,Genießbare Früchte und Nüsse,108915000,554989000,663904000
2014,2,WA09,"Kaffee, Tee, Mate, Gewürze",184952000,246554000,431506000
2014,2,WA10,Getreide,312868000,263509000,576377000
2014,2,WA11,"Müllereierzeugnisse, Malz usw.",116141000,39509000,155650000
2014,2,WA12,"Ölsamen usw., Heilpflanzen usw.",153208000,349161000,502369000
2014,2,WA13,"Schellack, Gummen, Harz, Pflanzensaft",43329000,43442000,86771000
2014,2,WA14,Flechtstoffe usw. pflanzlichen Ursprungs,895000,3085000,3980000
2014,2,WA15,"Tierische und pflanzliche Fette, Öle, Wachs",208142000,284628000,492770000
2014,2,WA16,"Zubereitungen von Fleisch, Fisch usw.",221989000,171746000,393735000
2014,2,WA17,Zucker und Zuckerwaren,139406000,141152000,280558000
2014,2,WA18,Kakao und Zubereitungen aus Kakao,340776000,290762000,631538000
2014,2,WA19,"Zubereitungen aus Getreide usw., Backwaren",394966000,263213000,658179000
2014,2,WA20,"Zubereitungen von Gemüse, Früchten usw.",178608000,332856000,511464000
2014,2,WA21,Verschiedene Lebensmittelzubereitungen,376408000,221977000,598385000
2014,2,WA22,"Getränke, alkoholhaltige Flüssigkeiten, Essig",396444000,472015000,868459000
2014,2,WA23,"Rückstände der Lebensmittelindustrie, Futter",292216000,277949000,570165000
2014,2,WA24,Tabak,268385000,133159000,401544000
2014,2,WA25,"Salz, Schwefel, Steine, Erden usw.",151369000,149981000,301350000
2014,2,WA26,"Erze, Schlacken, Aschen",21059000,678261000,699320000
2014,2,WA27,Mineralische Brennstoffe usw.,2347728000,10203464000,12551192000
2014,2,WA28,Anorganische chemische Erzeugnisse,609012000,570298000,1179310000
2014,2,WA29,Organische chemische Erzeugnisse,2068560000,2088604000,4157164000
2014,2,WA30,Pharmazeutische Erzeugnisse,4619301000,3111291000,7730592000
2014,2,WA31,Düngemittel,196274000,123197000,319471000
2014,2,WA32,"Gerb- und Farbstoffe, Farben, Lacke usw.",867739000,496106000,1363845000
2014,2,WA33,"Etherische Öle, Riech-, Schönheitsmittel",677351000,433466000,1110817000
2014,2,WA34,"Seifen, Waschmittel usw.",545385000,285986000,831371000
2014,2,WA35,"Eiweißstoffe, Klebstoffe, Enzyme",251068000,161069000,412137000
2014,2,WA36,"Sprengstoffe, pyrotechnische Artikel usw.",13867000,12862000,26729000
2014,2,WA37,Photochemische Erzeugnisse,90736000,66142000,156878000
2014,2,WA38,Verschiedene Erzeugnisse der Chemischen Industrie,1674194000,976523000,2650717000
2014,2,WA39,Kunststoffe und Waren daraus,4320715000,2795778000,7116493000
2014,2,WA40,Kautschuk und Waren daraus,1119854000,1123102000,2242956000
2014,2,WA41,"Häute, Felle, Leder",93953000,93683000,187636000
2014,2,WA42,"Lederwaren, Sattlerwaren",145854000,277026000,422880000
2014,2,WA43,"Pelzfelle, künstliches Pelzwerk",12261000,8775000,21036000
2014,2,WA44,"Holz, Holzwaren, Holzkohle",548431000,564262000,1112693000
2014,2,WA45,"Kork, Korkwaren",2070000,8852000,10922000
2014,2,WA46,"Flechtwaren, Korbmacherwaren",2912000,9138000,12050000
2014,2,WA47,"Halbstoffe aus Holz usw., Papierabfall",98573000,287388000,385961000
2014,2,WA48,"Papier, Pappe und Waren daraus",1407568000,971352000,2378920000
2014,2,WA49,"Bücher, Zeitungen, Bilddrucke usw.",316840000,153605000,470445000
2014,2,WA50,Seide,4958000,4844000,9802000
2014,2,WA51,"Wolle, feine und grobe Tierhaare",41989000,46563000,88552000
2014,2,WA52,Baumwolle,82584000,78616000,161200000
2014,2,WA53,"Andere pflanzliche Spinnstoffe, Papiergarn",3715000,5397000,9112000
2014,2,WA54,Synthetisches oder künstliches Filament,156783000,126487000,283270000
2014,2,WA55,Synthetische oder künstliche Spinnfaser,164106000,125175000,289281000
2014,2,WA56,"Watte, Filz, Vliesstoff usw., Tauwerk",187117000,96041000,283158000
2014,2,WA57,"Teppiche, Fußbodenbelag aus Spinnstoff",40623000,87685000,128308000
2014,2,WA58,"Spezialgewebe, Spitzen, Tapisserien",37237000,22969000,60206000
2014,2,WA59,"Getränkte, bestrichene usw. Gewebe",167267000,87498000,254765000
2014,2,WA60,Gewirke und Gestricke,63283000,33840000,97123000
2014,2,WA61,"Bekleidung usw. aus Gewirken, Gestricken",589115000,1113798000,1702913000
2014,2,WA62,"Andere Bekleidung, Bekleidungszubehör",722678000,1217585000,1940263000
2014,2,WA63,"Andere Konfektion, Spinnstoffwaren usw.",176418000,258727000,435145000
2014,2,WA64,"Schuhe, Gamaschen, ähnliche Waren",396588000,751929000,1148517000
2014,2,WA65,Kopfbedeckungen und Teile davon,27580000,39398000,66978000
2014,2,WA66,"Schirme, Gehstöcke usw., Peitschen",9986000,28325000,38311000
2014,2,WA67,"Zugerichtete Federn, Daunen, künstliche Blumen",8632000,10770000,19402000
2014,2,WA68,"Waren aus Steinen, Gips, Zement usw.",305875000,198958000,504833000
2014,2,WA69,Keramische Waren,237938000,199118000,437056000
2014,2,WA70,Glas und Glaswaren,439108000,356751000,795859000
2014,2,WA71,"Perlen, Edelsteine, Edelmetalle",996210000,1310261000,2306471000
2014,2,WA72,Eisen und Stahl,1822860000,1970042000,3792902000
2014,2,WA73,Waren aus Eisen oder Stahl,2082508000,1508169000,3590677000
2014,2,WA74,Kupfer und Waren daraus,881645000,804667000,1686312000
2014,2,WA75,Nickel und Waren daraus,84742000,109310000,194052000
2014,2,WA76,Aluminium und Waren daraus,1033369000,1036837000,2070206000
2014,2,WA78,Blei und Waren daraus,37545000,26608000,64153000
2014,2,WA79,Zink und Waren daraus,49753000,87977000,137730000
2014,2,WA80,Zinn und Waren daraus,10642000,38582000,49224000
2014,2,WA81,"Andere unedle Metalle, Cermets usw.",108409000,125179000,233588000
2014,2,WA82,"Werkzeuge, Schneidwaren, Essbestecke",602557000,357234000,959791000
2014,2,WA83,Verschiedene Waren aus unedlen Metallen,553688000,333839000,887527000
2014,2,WA84,"Maschinen, Apparate, mechanische Geräte",15306065000,9059091000,24365156000
2014,2,WA85,Elektrotechnische Erzeugnisse,8658614000,7667108000,16325722000
2014,2,WA86,Schienenfahrzeuge,254415000,152010000,406425000
2014,2,WA87,"Kraftfahrzeuge, Landfahrzeuge",16569271000,6491954000,23061225000
2014,2,WA88,"Luftfahrzeuge, Raumfahrzeuge",2836660000,2091678000,4928338000
2014,2,WA89,Wasserfahrzeuge,178254000,62182000,240436000
2014,2,WA90,"Optische, photografische usw. Erzeugnisse",4176620000,2301615000,6478235000
2014,2,WA91,Uhrmacherwaren,134178000,146878000,281056000
2014,2,WA92,Musikinstrumente,37594000,37794000,75388000
2014,2,WA93,Waffen und Munition,37052000,14884000,51936000
2014,2,WA94,"Möbel, Beleuchtungskörper usw.",1137365000,1365901000,2503266000
2014,2,WA95,"Spielzeug, Spiele usw., Sportgeräte",230892000,358736000,589628000
2014,2,WA96,Verschiedene Waren,278783000,183982000,462765000
2014,2,WA97,"Kunstgegenstände, Sammlungsstücke",35860000,16498000,52358000
2014,2,WA98,Vollständige Fabrikationsanlagen,201002000,2164000,203166000
2014,2,WA99,Zusammenstellungen verschiedener Waren,1384776000,752096000,2136872000
2014,3,WA01,Lebende Tiere,114119000,147948000,262067000
2014,3,WA02,Fleisch,562613000,489911000,1052524000
2014,3,WA03,"Fische, Krebs- und Weichtiere",118780000,301793000,420573000
2014,3,WA04,"Milch, Milcherzeugnisse, Eier, Honig",800027000,587752000,1387779000
2014,3,WA05,Andere Waren tierischen Ursprungs,70964000,75846000,146810000
2014,3,WA06,"Pflanzen, Waren des Blumenhandels",104127000,279659000,383786000
2014,3,WA07,"Gemüse, Pflanzen für Ernährung",90907000,487708000,578615000
2014,3,WA08,Genießbare Früchte und Nüsse,121438000,593507000,714945000
2014,3,WA09,"Kaffee, Tee, Mate, Gewürze",188559000,305099000,493658000
2014,3,WA10,Getreide,297922000,247644000,545566000
2014,3,WA11,"Müllereierzeugnisse, Malz usw.",105434000,38078000,143512000
2014,3,WA12,"Ölsamen usw., Heilpflanzen usw.",150150000,342967000,493117000
2014,3,WA13,"Schellack, Gummen, Harz, Pflanzensaft",44215000,35179000,79394000
2014,3,WA14,Flechtstoffe usw. pflanzlichen Ursprungs,983000,2636000,3619000
2014,3,WA15,"Tierische und pflanzliche Fette, Öle, Wachs",208325000,272464000,480789000
2014,3,WA16,"Zubereitungen von Fleisch, Fisch usw.",217456000,170496000,387952000
2014,3,WA17,Zucker und Zuckerwaren,135145000,137299000,272444000
2014,3,WA18,Kakao und Zubereitungen aus Kakao,343741000,299113000,642854000
2014,3,WA19,"Zubereitungen aus Getreide usw., Backwaren",420908000,264465000,685373000
2014,3,WA20,"Zubereitungen von Gemüse, Früchten usw.",196790000,361863000,558653000
2014,3,WA21,Verschiedene Lebensmittelzubereitungen,394773000,241582000,636355000
2014,3,WA22,"Getränke, alkoholhaltige Flüssigkeiten, Essig",402851000,481305000,884156000
2014,3,WA23,"Rückstände der Lebensmittelindustrie, Futter",284230000,255952000,540182000
2014,3,WA24,Tabak,279794000,145717000,425511000
2014,3,WA25,"Salz, Schwefel, Steine, Erden usw.",161953000,148796000,310749000
2014,3,WA26,"Erze, Schlacken, Aschen",30761000,675959000,706720000
2014,3,WA27,Mineralische Brennstoffe usw.,2424234000,9665275000,12089509000
2014,3,WA28,Anorganische chemische Erzeugnisse,729241000,460886000,1190127000
2014,3,WA29,Organische chemische Erzeugnisse,2137175000,2322495000,4459670000
2014,3,WA30,Pharmazeutische Erzeugnisse,4943253000,3199208000,8142461000
2014,3,WA31,Düngemittel,214782000,174890000,389672000
2014,3,WA32,"Gerb- und Farbstoffe, Farben, Lacke usw.",889395000,499301000,1388696000
2014,3,WA33,"Etherische Öle, Riech-, Schönheitsmittel",694885000,456480000,1151365000
2014,3,WA34,"Seifen, Waschmittel usw.",548941000,258701000,807642000
2014,3,WA35,"Eiweißstoffe, Klebstoffe, Enzyme",236414000,159074000,395488000
2014,3,WA36,"Sprengstoffe, pyrotechnische Artikel usw.",15852000,14716000,30568000
2014,3,WA37,Photochemische Erzeugnisse,90769000,57989000,148758000
2014,3,WA38,Verschiedene Erzeugnisse der Chemischen Industrie,1739407000,1067016000,2806423000
2014,3,WA39,Kunststoffe und Waren daraus,4503900000,2880837000,7384737000
2014,3,WA40,Kautschuk und Waren daraus,1204446000,1221845000,2426291000
2014,3,WA41,"Häute, Felle, Leder",92148000,83687000,175835000
2014,3,WA42,"Lederwaren, Sattlerwaren",135821000,250812000,386633000
2014,3,WA43,"Pelzfelle, künstliches Pelzwerk",12620000,9958000,22578000
2014,3,WA44,"Holz, Holzwaren, Holzkohle",595389000,606987000,1202376000
2014,3,WA45,"Kork, Korkwaren",2301000,7467000,9768000
2014,3,WA46,"Flechtwaren, Korbmacherwaren",3173000,8162000,11335000
2014,3,WA47,"Halbstoffe aus Holz usw., Papierabfall",109456000,289685000,399141000
2014,3,WA48,"Papier, Pappe und Waren daraus",1414683000,976521000,2391204000
2014,3,WA49,"Bücher, Zeitungen, Bilddrucke usw.",338795000,142284000,481079000
2014,3,WA50,Seide,5479000,5390000,10869000
2014,3,WA51,"Wolle, feine und grobe Tierhaare",42221000,59599000,101820000
2014,3,WA52,Baumwolle,78480000,84875000,163355000
2014,3,WA53,"Andere pflanzliche Spinnstoffe, Papiergarn",3184000,4900000,8084000
2014,3,WA54,Synthetisches oder künstliches Filament,163052000,126825000,289877000
2014,3,WA55,Synthetische oder künstliche Spinnfaser,168625000,139249000,307874000
2014,3,WA56,"Watte, Filz, Vliesstoff usw., Tauwerk",192178000,108958000,301136000
2014,3,WA57,"Teppiche, Fußbodenbelag aus Spinnstoff",39185000,88450000,127635000
2014,3,WA58,"Spezialgewebe, Spitzen, Tapisserien",37247000,24482000,61729000
2014,3,WA59,"Getränkte, bestrichene usw. Gewebe",176997000,91049000,268046000
2014,3,WA60,Gewirke und Gestricke,66973000,37950000,104923000
2014,3,WA61,"Bekleidung usw. aus Gewirken, Gestricken",577559000,1081040000,1658599000
2014,3,WA62,"Andere Bekleidung, Bekleidungszubehör",698954000,1199864000,1898818000
2014,3,WA63,"Andere Konfektion, Spinnstoffwaren usw.",180885000,265531000,446416000
2014,3,WA64,"Schuhe, Gamaschen, ähnliche Waren",403320000,718603000,1121923000
2014,3,WA65,Kopfbedeckungen und Teile davon,28409000,35064000,63473000
2014,3,WA66,"Schirme, Gehstöcke usw., Peitschen",7004000,21617000,28621000
2014,3,WA67,"Zugerichtete Federn, Daunen, künstliche Blumen",9434000,9607000,19041000
2014,3,WA68,"Waren aus Steinen, Gips, Zement usw.",329506000,233179000,562685000
2014,3,WA69,Keramische Waren,247689000,198292000,445981000
2014,3,WA70,Glas und Glaswaren,453472000,367924000,821396000
2014,3,WA71,"Perlen, Edelsteine, Edelmetalle",852006000,984877000,1836883000
2014,3,WA72,Eisen und Stahl,1856219000,1954881000,3811100000
2014,3,WA73,Waren aus Eisen oder Stahl,2151136000,1465611000,3616747000
2014,3,WA74,Kupfer und Waren daraus,850681000,679669000,1530350000
2014,3,WA75,Nickel und Waren daraus,74816000,106297000,181113000
2014,3,WA76,Aluminium und Waren daraus,1036692000,1095781000,2132473000
2014,3,WA78,Blei und Waren daraus,34330000,25519000,59849000
2014,3,WA79,Zink und Waren daraus,53758000,90624000,144382000
2014,3,WA80,Zinn und Waren daraus,10323000,34651000,44974000
2014,3,WA81,"Andere unedle Metalle, Cermets usw.",130933000,130846000,261779000
2014,3,WA82,"Werkzeuge, Schneidwaren, Essbestecke",624985000,378124000,1003109000
2014,3,WA83,Verschiedene Waren aus unedlen Metallen,547545000,323156000,870701000
2014,3,WA84,"Maschinen, Apparate, mechanische Geräte",16322807000,9669067000,25991874000
2014,3,WA85,Elektrotechnische Erzeugnisse,9221837000,8168240000,17390077000
2014,3,WA86,Schienenfahrzeuge,322854000,173331000,496185000
2014,3,WA87,"Kraftfahrzeuge, Landfahrzeuge",16808069000,7004527000,23812596000
2014,3,WA88,"Luftfahrzeuge, Raumfahrzeuge",2693682000,3289819000,5983501000
2014,3,WA89,Wasserfahrzeuge,254337000,255203000,509540000
2014,3,WA90,"Optische, photografische usw. Erzeugnisse",4456481000,2454877000,6911358000
2014,3,WA91,Uhrmacherwaren,133313000,149420000,282733000
2014,3,WA92,Musikinstrumente,40250000,39386000,79636000
2014,3,WA93,Waffen und Munition,39985000,15232000,55217000
2014,3,WA94,"Möbel, Beleuchtungskörper usw.",1134659000,1340961000,2475620000
2014,3,WA95,"Spielzeug, Spiele usw., Sportgeräte",236030000,334929000,570959000
2014,3,WA96,Verschiedene Waren,275339000,174568000,449907000
2014,3,WA97,"Kunstgegenstände, Sammlungsstücke",43179000,31988000,75167000
2014,3,WA98,Vollständige Fabrikationsanlagen,318474000,1258000,319732000
2014,3,WA99,Zusammenstellungen verschiedener Waren,1481977000,813385000,2295362000
2014,4,WA01,Lebende Tiere,125787000,179974000,305761000
2014,4,WA02,Fleisch,630962000,528993000,1159955000
2014,4,WA03,"Fische, Krebs- und Weichtiere",90931000,290362000,381293000
2014,4,WA04,"Milch, Milcherzeugnisse, Eier, Honig",829192000,594413000,1423605000
2014,4,WA05,Andere Waren tierischen Ursprungs,72079000,67104000,139183000
2014,4,WA06,"Pflanzen, Waren des Blumenhandels",122097000,344209000,466306000
2014,4,WA07,"Gemüse, Pflanzen für Ernährung",82624000,552267000,634891000
2014,4,WA08,Genießbare Früchte und Nüsse,116576000,621984000,738560000
2014,4,WA09,"Kaffee, Tee, Mate, Gewürze",165910000,336912000,502822000
2014,4,WA10,Getreide,303289000,243569000,546858000
2014,4,WA11,"Müllereierzeugnisse, Malz usw.",105834000,43922000,149756000
2014,4,WA12,"Ölsamen usw., Heilpflanzen usw.",76888000,369691000,446579000
2014,4,WA13,"Schellack, Gummen, Harz, Pflanzensaft",44032000,35011000,79043000
2014,4,WA14,Flechtstoffe usw. pflanzlichen Ursprungs,930000,4460000,5390000
2014,4,WA15,"Tierische und pflanzliche Fette, Öle, Wachs",196214000,275190000,471404000
2014,4,WA16,"Zubereitungen von Fleisch, Fisch usw.",227971000,192959000,420930000
2014,4,WA17,Zucker und Zuckerwaren,150368000,124205000,274573000
2014,4,WA18,Kakao und Zubereitungen aus Kakao,289739000,250907000,540646000
2014,4,WA19,"Zubereitungen aus Getreide usw., Backwaren",422238000,276209000,698447000
2014,4,WA20,"Zubereitungen von Gemüse, Früchten usw.",212106000,351693000,563799000
2014,4,WA21,Verschiedene Lebensmittelzubereitungen,435955000,240888000,676843000
2014,4,WA22,"Getränke, alkoholhaltige Flüssigkeiten, Essig",438801000,527391000,966192000
2014,4,WA23,"Rückstände der Lebensmittelindustrie, Futter",320997000,274752000,595749000
2014,4,WA24,Tabak,290345000,141992000,432337000
2014,4,WA25,"Salz, Schwefel, Steine, Erden usw.",171038000,151709000,322747000
2014,4,WA26,"Erze, Schlacken, Aschen",23904000,621393000,645297000
2014,4,WA27,Mineralische Brennstoffe usw.,2161758000,9248133000,11409891000
2014,4,WA28,Anorganische chemische Erzeugnisse,730226000,531389000,1261615000
2014,4,WA29,Organische chemische Erzeugnisse,2060417000,2188193000,4248610000
2014,4,WA30,Pharmazeutische Erzeugnisse,4646663000,2980656000,7627319000
2014,4,WA31,Düngemittel,192661000,141916000,334577000
2014,4,WA32,"Gerb- und Farbstoffe, Farben, Lacke usw.",904192000,488648000,1392840000
2014,4,WA33,"Etherische Öle, Riech-, Schönheitsmittel",675705000,432285000,1107990000
2014,4,WA34,"Seifen, Waschmittel usw.",539923000,274747000,814670000
2014,4,WA35,"Eiweißstoffe, Klebstoffe, Enzyme",259937000,168048000,427985000
2014,4,WA36,"Sprengstoffe, pyrotechnische Artikel usw.",14102000,11642000,25744000
2014,4,WA37,Photochemische Erzeugnisse,91945000,62347000,154292000
2014,4,WA38,Verschiedene Erzeugnisse der Chemischen Industrie,1643628000,1015897000,2659525000
2014,4,WA39,Kunststoffe und Waren daraus,4601865000,2890228000,7492093000
2014,4,WA40,Kautschuk und Waren daraus,1191300000,1132457000,2323757000
2014,4,WA41,"Häute, Felle, Leder",91671000,79619000,171290000
2014,4,WA42,"Lederwaren, Sattlerwaren",121441000,229053000,350494000
2014,4,WA43,"Pelzfelle, künstliches Pelzwerk",17206000,13199000,30405000
2014,4,WA44,"Holz, Holzwaren, Holzkohle",597238000,604950000,1202188000
2014,4,WA45,"Kork, Korkwaren",2865000,9874000,12739000
2014,4,WA46,"Flechtwaren, Korbmacherwaren",4030000,8487000,12517000
2014,4,WA47,"Halbstoffe aus Holz usw., Papierabfall",94494000,271707000,366201000
2014,4,WA48,"Papier, Pappe und Waren daraus",1422060000,974276000,2396336000
2014,4,WA49,"Bücher, Zeitungen, Bilddrucke usw.",321046000,158759000,479805000
2014,4,WA50,Seide,5738000,7414000,13152000
2014,4,WA51,"Wolle, feine und grobe Tierhaare",50710000,57683000,108393000
2014,4,WA52,Baumwolle,85943000,84358000,170301000
2014,4,WA53,"Andere pflanzliche Spinnstoffe, Papiergarn",2969000,5582000,8551000
2014,4,WA54,Synthetisches oder künstliches Filament,165664000,130635000,296299000
2014,4,WA55,Synthetische oder künstliche Spinnfaser,165899000,135245000,301144000
2014,4,WA56,"Watte, Filz, Vliesstoff usw., Tauwerk",202695000,112102000,314797000
2014,4,WA57,"Teppiche, Fußbodenbelag aus Spinnstoff",42071000,73578000,115649000
2014,4,WA58,"Spezialgewebe, Spitzen, Tapisserien",43229000,24719000,67948000
2014,4,WA59,"Getränkte, bestrichene usw. Gewebe",173852000,92408000,266260000
2014,4,WA60,Gewirke und Gestricke,76561000,44680000,121241000
2014,4,WA61,"Bekleidung usw. aus Gewirken, Gestricken",461492000,949332000,1410824000
2014,4,WA62,"Andere Bekleidung, Bekleidungszubehör",526483000,989470000,1515953000
2014,4,WA63,"Andere Konfektion, Spinnstoffwaren usw.",194068000,273676000,467744000
2014,4,WA64,"Schuhe, Gamaschen, ähnliche Waren",301714000,546289000,848003000
2014,4,WA65,Kopfbedeckungen und Teile davon,27305000,33549000,60854000
2014,4,WA66,"Schirme, Gehstöcke usw., Peitschen",7330000,15437000,22767000
2014,4,WA67,"Zugerichtete Federn, Daunen, künstliche Blumen",7159000,8274000,15433000
2014,4,WA68,"Waren aus Steinen, Gips, Zement usw.",339569000,236742000,576311000
2014,4,WA69,Keramische Waren,243734000,193795000,437529000
2014,4,WA70,Glas und Glaswaren,481577000,364102000,845679000
2014,4,WA71,"Perlen, Edelsteine, Edelmetalle",860735000,1140761000,2001496000
2014,4,WA72,Eisen und Stahl,1902086000,1913142000,3815228000
2014,4,WA73,Waren aus Eisen oder Stahl,2153103000,1492693000,3645796000
2014,4,WA74,Kupfer und Waren daraus,869058000,831998000,1701056000
2014,4,WA75,Nickel und Waren daraus,87369000,109190000,196559000
2014,4,WA76,Aluminium und Waren daraus,1074120000,1101434000,2175554000
2014,4,WA78,Blei und Waren daraus,37652000,28867000,66519000
2014,4,WA79,Zink und Waren daraus,51268000,97050000,148318000
2014,4,WA80,Zinn und Waren daraus,11517000,36790000,48307000
2014,4,WA81,"Andere unedle Metalle, Cermets usw.",112433000,123628000,236061000
2014,4,WA82,"Werkzeuge, Schneidwaren, Essbestecke",624977000,344644000,969621000
2014,4,WA83,Verschiedene Waren aus unedlen Metallen,574832000,333922000,908754000
2014,4,WA84,"Maschinen, Apparate, mechanische Geräte",16114248000,9178190000,25292438000
2014,4,WA85,Elektrotechnische Erzeugnisse,8961372000,8190885000,17152257000
2014,4,WA86,Schienenfahrzeuge,320302000,175215000,495517000
2014,4,WA87,"Kraftfahrzeuge, Landfahrzeuge",16868634000,6805238000,23673872000
2014,4,WA88,"Luftfahrzeuge, Raumfahrzeuge",2347341000,1923789000,4271130000
2014,4,WA89,Wasserfahrzeuge,93800000,159949000,253749000
2014,4,WA90,"Optische, photografische usw. Erzeugnisse",4195211000,2361447000,6556658000
2014,4,WA91,Uhrmacherwaren,141397000,165672000,307069000
2014,4,WA92,Musikinstrumente,42359000,36896000,79255000
2014,4,WA93,Waffen und Munition,38711000,16632000,55343000
2014,4,WA94,"Möbel, Beleuchtungskörper usw.",1133500000,1330096000,2463596000
2014,4,WA95,"Spielzeug, Spiele usw., Sportgeräte",228949000,292883000,521832000
2014,4,WA96,Verschiedene Waren,301687000,192437000,494124000
2014,4,WA97,"Kunstgegenstände, Sammlungsstücke",56758000,51234000,107992000
2014,4,WA98,Vollständige Fabrikationsanlagen,250990000,4346000,255336000
2014,4,WA99,Zusammenstellungen verschiedener Waren,1458870000,1136180000,2595050000
2014,5,WA01,Lebende Tiere,135084000,160977000,296061000
2014,5,WA02,Fleisch,601481000,484040000,1085521000
2014,5,WA03,"Fische, Krebs- und Weichtiere",108604000,228222000,336826000
2014,5,WA04,"Milch, Milcherzeugnisse, Eier, Honig",796435000,565029000,1361464000
2014,5,WA05,Andere Waren tierischen Ursprungs,65653000,76828000,142481000
2014,5,WA06,"Pflanzen, Waren des Blumenhandels",85563000,299927000,385490000
2014,5,WA07,"Gemüse, Pflanzen für Ernährung",96082000,441618000,537700000
2014,5,WA08,Genießbare Früchte und Nüsse,116650000,619555000,736205000
2014,5,WA09,"Kaffee, Tee, Mate, Gewürze",201495000,322433000,523928000
2014,5,WA10,Getreide,258394000,183079000,441473000
2014,5,WA11,"Müllereierzeugnisse, Malz usw.",109611000,42947000,152558000
2014,5,WA12,"Ölsamen usw., Heilpflanzen usw.",64725000,297053000,361778000
2014,5,WA13,"Schellack, Gummen, Harz, Pflanzensaft",41650000,34858000,76508000
2014,5,WA14,Flechtstoffe usw. pflanzlichen Ursprungs,630000,3336000,3966000
2014,5,WA15,"Tierische und pflanzliche Fette, Öle, Wachs",180531000,315768000,496299000
2014,5,WA16,"Zubereitungen von Fleisch, Fisch usw.",231707000,169509000,401216000
2014,5,WA17,Zucker und Zuckerwaren,144966000,143604000,288570000
2014,5,WA18,Kakao und Zubereitungen aus Kakao,272379000,251505000,523884000
2014,5,WA19,"Zubereitungen aus Getreide usw., Backwaren",416838000,275990000,692828000
2014,5,WA20,"Zubereitungen von Gemüse, Früchten usw.",208777000,341519000,550296000
2014,5,WA21,Verschiedene Lebensmittelzubereitungen,415325000,228029000,643354000
2014,5,WA22,"Getränke, alkoholhaltige Flüssigkeiten, Essig",447084000,528279000,975363000
2014,5,WA23,"Rückstände der Lebensmittelindustrie, Futter",289853000,306520000,596373000
2014,5,WA24,Tabak,286210000,138602000,424812000
2014,5,WA25,"Salz, Schwefel, Steine, Erden usw.",175576000,156071000,331647000
2014,5,WA26,"Erze, Schlacken, Aschen",29452000,550078000,579530000
2014,5,WA27,Mineralische Brennstoffe usw.,1956428000,9832578000,11789006000
2014,5,WA28,Anorganische chemische Erzeugnisse,759308000,483046000,1242354000
2014,5,WA29,Organische chemische Erzeugnisse,2103403000,2104379000,4207782000
2014,5,WA30,Pharmazeutische Erzeugnisse,5058362000,3052373000,8110735000
2014,5,WA31,Düngemittel,185774000,117127000,302901000
2014,5,WA32,"Gerb- und Farbstoffe, Farben, Lacke usw.",903624000,484266000,1387890000
2014,5,WA33,"Etherische Öle, Riech-, Schönheitsmittel",688401000,419506000,1107907000
2014,5,WA34,"Seifen, Waschmittel usw.",529890000,268852000,798742000
2014,5,WA35,"Eiweißstoffe, Klebstoffe, Enzyme",248518000,157606000,406124000
2014,5,WA36,"Sprengstoffe, pyrotechnische Artikel usw.",15790000,11697000,27487000
2014,5,WA37,Photochemische Erzeugnisse,88468000,56083000,144551000
2014,5,WA38,Verschiedene Erzeugnisse der Chemischen Industrie,1505203000,997898000,2503101000
2014,5,WA39,Kunststoffe und Waren daraus,4469329000,2856039000,7325368000
2014,5,WA40,Kautschuk und Waren daraus,1121232000,1002063000,2123295000
2014,5,WA41,"Häute, Felle, Leder",106575000,86288000,192863000
2014,5,WA42,"Lederwaren, Sattlerwaren",123107000,250088000,373195000
2014,5,WA43,"Pelzfelle, künstliches Pelzwerk",14834000,14128000,28962000
2014,5,WA44,"Holz, Holzwaren, Holzkohle",596584000,594863000,1191447000
2014,5,WA45,"Kork, Korkwaren",2433000,6010000,8443000
2014,5,WA46,"Flechtwaren, Korbmacherwaren",3322000,8249000,11571000
2014,5,WA47,"Halbstoffe aus Holz usw., Papierabfall",89166000,273616000,362782000
2014,5,WA48,"Papier, Pappe und Waren daraus",1352328000,970816000,2323144000
2014,5,WA49,"Bücher, Zeitungen, Bilddrucke usw.",298591000,171089000,469680000
2014,5,WA50,Seide,6663000,6085000,12748000
2014,5,WA51,"Wolle, feine und grobe Tierhaare",46496000,53511000,100007000
2014,5,WA52,Baumwolle,82312000,79019000,161331000
2014,5,WA53,"Andere pflanzliche Spinnstoffe, Papiergarn",2723000,4436000,7159000
2014,5,WA54,Synthetisches oder künstliches Filament,166259000,122763000,289022000
2014,5,WA55,Synthetische oder künstliche Spinnfaser,160370000,137859000,298229000
2014,5,WA56,"Watte, Filz, Vliesstoff usw., Tauwerk",191186000,102960000,294146000
2014,5,WA57,"Teppiche, Fußbodenbelag aus Spinnstoff",35940000,72499000,108439000
2014,5,WA58,"Spezialgewebe, Spitzen, Tapisserien",38485000,21552000,60037000
2014,5,WA59,"Getränkte, bestrichene usw. Gewebe",167976000,85573000,253549000
2014,5,WA60,Gewirke und Gestricke,73583000,41504000,115087000
2014,5,WA61,"Bekleidung usw. aus Gewirken, Gestricken",439184000,937609000,1376793000
2014,5,WA62,"Andere Bekleidung, Bekleidungszubehör",438129000,905041000,1343170000
2014,5,WA63,"Andere Konfektion, Spinnstoffwaren usw.",184397000,275897000,460294000
2014,5,WA64,"Schuhe, Gamaschen, ähnliche Waren",250486000,517661000,768147000
2014,5,WA65,Kopfbedeckungen und Teile davon,22305000,31995000,54300000
2014,5,WA66,"Schirme, Gehstöcke usw., Peitschen",8622000,18665000,27287000
2014,5,WA67,"Zugerichtete Federn, Daunen, künstliche Blumen",6723000,8132000,14855000
2014,5,WA68,"Waren aus Steinen, Gips, Zement usw.",337347000,230078000,567425000
2014,5,WA69,Keramische Waren,243057000,185629000,428686000
2014,5,WA70,Glas und Glaswaren,465999000,371089000,837088000
2014,5,WA71,"Perlen, Edelsteine, Edelmetalle",900586000,885914000,1786500000
2014,5,WA72,Eisen und Stahl,1876808000,1984779000,3861587000
2014,5,WA73,Waren aus Eisen oder Stahl,2114637000,1475442000,3590079000
2014,5,WA74,Kupfer und Waren daraus,836934000,699118000,1536052000
2014,5,WA75,Nickel und Waren daraus,88123000,122830000,210953000
2014,5,WA76,Aluminium und Waren daraus,1055048000,1106749000,2161797000
2014,5,WA78,Blei und Waren daraus,39133000,23414000,62547000
2014,5,WA79,Zink und Waren daraus,49193000,93159000,142352000
2014,5,WA80,Zinn und Waren daraus,10129000,31081000,41210000
2014,5,WA81,"Andere unedle Metalle, Cermets usw.",114751000,128457000,243208000
2014,5,WA82,"Werkzeuge, Schneidwaren, Essbestecke",583463000,339419000,922882000
2014,5,WA83,Verschiedene Waren aus unedlen Metallen,547863000,330889000,878752000
2014,5,WA84,"Maschinen, Apparate, mechanische Geräte",15742819000,9113519000,24856338000
2014,5,WA85,Elektrotechnische Erzeugnisse,8684341000,7969082000,16653423000
2014,5,WA86,Schienenfahrzeuge,338750000,183747000,522497000
2014,5,WA87,"Kraftfahrzeuge, Landfahrzeuge",16106815000,6858670000,22965485000
2014,5,WA88,"Luftfahrzeuge, Raumfahrzeuge",2624446000,1107631000,3732077000
2014,5,WA89,Wasserfahrzeuge,152554000,372167000,524721000
2014,5,WA90,"Optische, photografische usw. Erzeugnisse",4101583000,2297957000,6399540000
2014,5,WA91,Uhrmacherwaren,143421000,174195000,317616000
2014,5,WA92,Musikinstrumente,39135000,36789000,75924000
2014,5,WA93,Waffen und Munition,35026000,12701000,47727000
2014,5,WA94,"Möbel, Beleuchtungskörper usw.",1075068000,1260006000,2335074000
2014,5,WA95,"Spielzeug, Spiele usw., Sportgeräte",243848000,367003000,610851000
2014,5,WA96,Verschiedene Waren,284978000,185846000,470824000
2014,5,WA97,"Kunstgegenstände, Sammlungsstücke",55073000,25086000,80159000
2014,5,WA98,Vollständige Fabrikationsanlagen,243703000,3531000,247234000
2014,5,WA99,Zusammenstellungen verschiedener Waren,1606463000,843328000,2449791000
2014,6,WA01,Lebende Tiere,133679000,167058000,300737000
2014,6,WA02,Fleisch,628119000,519025000,1147144000
2014,6,WA03,"Fische, Krebs- und Weichtiere",100897000,278288000,379185000
2014,6,WA04,"Milch, Milcherzeugnisse, Eier, Honig",801613000,584775000,1386388000
2014,6,WA05,Andere Waren tierischen Ursprungs,70974000,77844000,148818000
2014,6,WA06,"Pflanzen, Waren des Blumenhandels",49156000,207103000,256259000
2014,6,WA07,"Gemüse, Pflanzen für Ernährung",81077000,411282000,492359000
2014,6,WA08,Genießbare Früchte und Nüsse,138652000,693033000,831685000
2014,6,WA09,"Kaffee, Tee, Mate, Gewürze",167509000,350833000,518342000
2014,6,WA10,Getreide,204465000,180113000,384578000
2014,6,WA11,"Müllereierzeugnisse, Malz usw.",115606000,38212000,153818000
2014,6,WA12,"Ölsamen usw., Heilpflanzen usw.",65077000,361656000,426733000
2014,6,WA13,"Schellack, Gummen, Harz, Pflanzensaft",40833000,39643000,80476000
2014,6,WA14,Flechtstoffe usw. pflanzlichen Ursprungs,1036000,3281000,4317000
2014,6,WA15,"Tierische und pflanzliche Fette, Öle, Wachs",201081000,287237000,488318000
2014,6,WA16,"Zubereitungen von Fleisch, Fisch usw.",235434000,190620000,426054000
2014,6,WA17,Zucker und Zuckerwaren,148176000,144770000,292946000
2014,6,WA18,Kakao und Zubereitungen aus Kakao,291582000,258973000,550555000
2014,6,WA19,"Zubereitungen aus Getreide usw., Backwaren",403199000,263165000,666364000
2014,6,WA20,"Zubereitungen von Gemüse, Früchten usw.",198013000,343673000,541686000
2014,6,WA21,Verschiedene Lebensmittelzubereitungen,440146000,250622000,690768000
2014,6,WA22,"Getränke, alkoholhaltige Flüssigkeiten, Essig",469981000,544849000,1014830000
2014,6,WA23,"Rückstände der Lebensmittelindustrie, Futter",308486000,319839000,628325000
2014,6,WA24,Tabak,299390000,144123000,443513000
2014,6,WA25,"Salz, Schwefel, Steine, Erden usw.",163161000,147852000,311013000
2014,6,WA26,"Erze, Schlacken, Aschen",28651000,623067000,651718000
2014,6,WA27,Mineralische Brennstoffe usw.,2033612000,9141159000,11174771000
2014,6,WA28,Anorganische chemische Erzeugnisse,672666000,578328000,1250994000
2014,6,WA29,Organische chemische Erzeugnisse,2012137000,2080756000,4092893000
2014,6,WA30,Pharmazeutische Erzeugnisse,4540840000,2844499000,7385339000
2014,6,WA31,Düngemittel,162021000,73437000,235458000
2014,6,WA32,"Gerb- und Farbstoffe, Farben, Lacke usw.",888350000,457013000,1345363000
2014,6,WA33,"Etherische Öle, Riech-, Schönheitsmittel",675770000,449448000,1125218000
2014,6,WA34,"Seifen, Waschmittel usw.",539651000,274874000,814525000
2014,6,WA35,"Eiweißstoffe, Klebstoffe, Enzyme",263673000,166978000,430651000
2014,6,WA36,"Sprengstoffe, pyrotechnische Artikel usw.",16979000,19104000,36083000
2014,6,WA37,Photochemische Erzeugnisse,89883000,59282000,149165000
2014,6,WA38,Verschiedene Erzeugnisse der Chemischen Industrie,1604831000,1022647000,2627478000
2014,6,WA39,Kunststoffe und Waren daraus,4594419000,2903216000,7497635000
2014,6,WA40,Kautschuk und Waren daraus,1175373000,1152554000,2327927000
2014,6,WA41,"Häute, Felle, Leder",95900000,82932000,178832000
2014,6,WA42,"Lederwaren, Sattlerwaren",139371000,304511000,443882000
2014,6,WA43,"Pelzfelle, künstliches Pelzwerk",14623000,14851000,29474000
2014,6,WA44,"Holz, Holzwaren, Holzkohle",594477000,601986000,1196463000
2014,6,WA45,"Kork, Korkwaren",2816000,7849000,10665000
2014,6,WA46,"Flechtwaren, Korbmacherwaren",3152000,8642000,11794000
2014,6,WA47,"Halbstoffe aus Holz usw., Papierabfall",90651000,296365000,387016000
2014,6,WA48,"Papier, Pappe und Waren daraus",1475836000,980996000,2456832000
2014,6,WA49,"Bücher, Zeitungen, Bilddrucke usw.",313873000,153270000,467143000
2014,6,WA50,Seide,5857000,6373000,12230000
2014,6,WA51,"Wolle, feine und grobe Tierhaare",51234000,59497000,110731000
2014,6,WA52,Baumwolle,80688000,83526000,164214000
2014,6,WA53,"Andere pflanzliche Spinnstoffe, Papiergarn",2702000,4812000,7514000
2014,6,WA54,Synthetisches oder künstliches Filament,162772000,125851000,288623000
2014,6,WA55,Synthetische oder künstliche Spinnfaser,168375000,136141000,304516000
2014,6,WA56,"Watte, Filz, Vliesstoff usw., Tauwerk",194815000,114820000,309635000
2014,6,WA57,"Teppiche, Fußbodenbelag aus Spinnstoff",40275000,77614000,117889000
2014,6,WA58,"Spezialgewebe, Spitzen, Tapisserien",40338000,22617000,62955000
2014,6,WA59,"Getränkte, bestrichene usw. Gewebe",169156000,91596000,260752000
2014,6,WA60,Gewirke und Gestricke,64253000,39216000,103469000
2014,6,WA61,"Bekleidung usw. aus Gewirken, Gestricken",497517000,1115312000,1612829000
2014,6,WA62,"Andere Bekleidung, Bekleidungszubehör",481310000,1051580000,1532890000
2014,6,WA63,"Andere Konfektion, Spinnstoffwaren usw.",197644000,288455000,486099000
2014,6,WA64,"Schuhe, Gamaschen, ähnliche Waren",315288000,643006000,958294000
2014,6,WA65,Kopfbedeckungen und Teile davon,20895000,35488000,56383000
2014,6,WA66,"Schirme, Gehstöcke usw., Peitschen",6624000,13592000,20216000
2014,6,WA67,"Zugerichtete Federn, Daunen, künstliche Blumen",7311000,11528000,18839000
2014,6,WA68,"Waren aus Steinen, Gips, Zement usw.",336666000,241976000,578642000
2014,6,WA69,Keramische Waren,253389000,213596000,466985000
2014,6,WA70,Glas und Glaswaren,468269000,363418000,831687000
2014,6,WA71,"Perlen, Edelsteine, Edelmetalle",936944000,1183762000,2120706000
2014,6,WA72,Eisen und Stahl,1923624000,1954817000,3878441000
2014,6,WA73,Waren aus Eisen oder Stahl,2132598000,1581474000,3714072000
2014,6,WA74,Kupfer und Waren daraus,821182000,846272000,1667454000
2014,6,WA75,Nickel und Waren daraus,88199000,118377000,206576000
2014,6,WA76,Aluminium und Waren daraus,1056866000,1127302000,2184168000
2014,6,WA78,Blei und Waren daraus,34109000,31425000,65534000
2014,6,WA79,Zink und Waren daraus,51533000,101028000,152561000
2014,6,WA80,Zinn und Waren daraus,11262000,36670000,47932000
2014,6,WA81,"Andere unedle Metalle, Cermets usw.",113892000,132662000,246554000
2014,6,WA82,"Werkzeuge, Schneidwaren, Essbestecke",596166000,357374000,953540000
2014,6,WA83,Verschiedene Waren aus unedlen Metallen,586721000,335297000,922018000
2014,6,WA84,"Maschinen, Apparate, mechanische Geräte",16280103000,9313678000,25593781000
2014,6,WA85,Elektrotechnische Erzeugnisse,9105553000,8126427000,17231980000
2014,6,WA86,Schienenfahrzeuge,279423000,164438000,443861000
2014,6,WA87,"Kraftfahrzeuge, Landfahrzeuge",15856074000,6862434000,22718508000
2014,6,WA88,"Luftfahrzeuge, Raumfahrzeuge",2628932000,2891782000,5520714000
2014,6,WA89,Wasserfahrzeuge,409666000,202999000,612665000
2014,6,WA90,"Optische, photografische usw. Erzeugnisse",4334716000,2423091000,6757807000
2014,6,WA91,Uhrmacherwaren,162692000,171447000,334139000
2014,6,WA92,Musikinstrumente,43208000,36362000,79570000
2014,6,WA93,Waffen und Munition,38987000,15421000,54408000
2014,6,WA94,"Möbel, Beleuchtungskörper usw.",1146584000,1298451000,2445035000
2014,6,WA95,"Spielzeug, Spiele usw., Sportgeräte",240755000,378787000,619542000
2014,6,WA96,Verschiedene Waren,298198000,197364000,495562000
2014,6,WA97,"Kunstgegenstände, Sammlungsstücke",77528000,32340000,109868000
2014,6,WA98,Vollständige Fabrikationsanlagen,252922000,4073000,256995000
2014,6,WA99,Zusammenstellungen verschiedener Waren,1779525000,802037000,2581562000
2014,7,WA01,Lebende Tiere,131455000,168000000,299455000
2014,7,WA02,Fleisch,670134000,494139000,1164273000
2014,7,WA03,"Fische, Krebs- und Weichtiere",105478000,253523000,359001000
2014,7,WA04,"Milch, Milcherzeugnisse, Eier, Honig",804569000,550102000,1354671000
2014,7,WA05,Andere Waren tierischen Ursprungs,66964000,77575000,144539000
2014,7,WA06,"Pflanzen, Waren des Blumenhandels",47497000,155456000,202953000
2014,7,WA07,"Gemüse, Pflanzen für Ernährung",77906000,367612000,445518000
2014,7,WA08,Genießbare Früchte und Nüsse,137831000,697808000,835639000
2014,7,WA09,"Kaffee, Tee, Mate, Gewürze",208063000,340993000,549056000
2014,7,WA10,Getreide,176164000,178263000,354427000
2014,7,WA11,"Müllereierzeugnisse, Malz usw.",113828000,42173000,156001000
2014,7,WA12,"Ölsamen usw., Heilpflanzen usw.",105186000,464849000,570035000
2014,7,WA13,"Schellack, Gummen, Harz, Pflanzensaft",44964000,39905000,84869000
2014,7,WA14,Flechtstoffe usw. pflanzlichen Ursprungs,541000,3448000,3989000
2014,7,WA15,"Tierische und pflanzliche Fette, Öle, Wachs",186724000,314744000,501468000
2014,7,WA16,"Zubereitungen von Fleisch, Fisch usw.",250416000,205480000,455896000
2014,7,WA17,Zucker und Zuckerwaren,164192000,142435000,306627000
2014,7,WA18,Kakao und Zubereitungen aus Kakao,333843000,280897000,614740000
2014,7,WA19,"Zubereitungen aus Getreide usw., Backwaren",439751000,271249000,711000000
2014,7,WA20,"Zubereitungen von Gemüse, Früchten usw.",208482000,365927000,574409000
2014,7,WA21,Verschiedene Lebensmittelzubereitungen,437573000,240826000,678399000
2014,7,WA22,"Getränke, alkoholhaltige Flüssigkeiten, Essig",494574000,559845000,1054419000
2014,7,WA23,"Rückstände der Lebensmittelindustrie, Futter",331601000,289337000,620938000
2014,7,WA24,Tabak,344044000,164362000,508406000
2014,7,WA25,"Salz, Schwefel, Steine, Erden usw.",171953000,163215000,335168000
2014,7,WA26,"Erze, Schlacken, Aschen",33018000,581357000,614375000
2014,7,WA27,Mineralische Brennstoffe usw.,2125706000,8951658000,11077364000
2014,7,WA28,Anorganische chemische Erzeugnisse,706822000,542628000,1249450000
2014,7,WA29,Organische chemische Erzeugnisse,2222096000,1928734000,4150830000
2014,7,WA30,Pharmazeutische Erzeugnisse,5009193000,2979051000,7988244000
2014,7,WA31,Düngemittel,194127000,98671000,292798000
2014,7,WA32,"Gerb- und Farbstoffe, Farben, Lacke usw.",955291000,501533000,1456824000
2014,7,WA33,"Etherische Öle, Riech-, Schönheitsmittel",698632000,500918000,1199550000
2014,7,WA34,"Seifen, Waschmittel usw.",582226000,297299000,879525000
2014,7,WA35,"Eiweißstoffe, Klebstoffe, Enzyme",277310000,180827000,458137000
2014,7,WA36,"Sprengstoffe, pyrotechnische Artikel usw.",19284000,21632000,40916000
2014,7,WA37,Photochemische Erzeugnisse,91128000,58474000,149602000
2014,7,WA38,Verschiedene Erzeugnisse der Chemischen Industrie,1638182000,1029992000,2668174000
2014,7,WA39,Kunststoffe und Waren daraus,4713991000,3055476000,7769467000
2014,7,WA40,Kautschuk und Waren daraus,1196188000,1248308000,2444496000
2014,7,WA41,"Häute, Felle, Leder",98023000,76976000,174999000
2014,7,WA42,"Lederwaren, Sattlerwaren",173133000,333594000,506727000
2014,7,WA43,"Pelzfelle, künstliches Pelzwerk",17718000,18356000,36074000
2014,7,WA44,"Holz, Holzwaren, Holzkohle",628683000,601057000,1229740000
2014,7,WA45,"Kork, Korkwaren",2334000,6923000,9257000
2014,7,WA46,"Flechtwaren, Korbmacherwaren",3243000,10109000,13352000
2014,7,WA47,"Halbstoffe aus Holz usw., Papierabfall",103017000,299744000,402761000
2014,7,WA48,"Papier, Pappe und Waren daraus",1496245000,995965000,2492210000
2014,7,WA49,"Bücher, Zeitungen, Bilddrucke usw.",345677000,153196000,498873000
2014,7,WA50,Seide,4932000,5991000,10923000
2014,7,WA51,"Wolle, feine und grobe Tierhaare",46942000,53731000,100673000
2014,7,WA52,Baumwolle,72305000,79555000,151860000
2014,7,WA53,"Andere pflanzliche Spinnstoffe, Papiergarn",2461000,5085000,7546000
2014,7,WA54,Synthetisches oder künstliches Filament,157190000,126280000,283470000
2014,7,WA55,Synthetische oder künstliche Spinnfaser,158053000,126898000,284951000
2014,7,WA56,"Watte, Filz, Vliesstoff usw., Tauwerk",202573000,109360000,311933000
2014,7,WA57,"Teppiche, Fußbodenbelag aus Spinnstoff",44423000,77118000,121541000
2014,7,WA58,"Spezialgewebe, Spitzen, Tapisserien",40354000,22848000,63202000
2014,7,WA59,"Getränkte, bestrichene usw. Gewebe",172389000,83932000,256321000
2014,7,WA60,Gewirke und Gestricke,65804000,37620000,103424000
2014,7,WA61,"Bekleidung usw. aus Gewirken, Gestricken",631034000,1439312000,2070346000
2014,7,WA62,"Andere Bekleidung, Bekleidungszubehör",668332000,1427197000,2095529000
2014,7,WA63,"Andere Konfektion, Spinnstoffwaren usw.",205725000,307304000,513029000
2014,7,WA64,"Schuhe, Gamaschen, ähnliche Waren",417424000,852956000,1270380000
2014,7,WA65,Kopfbedeckungen und Teile davon,25155000,44751000,69906000
2014,7,WA66,"Schirme, Gehstöcke usw., Peitschen",8257000,14297000,22554000
2014,7,WA67,"Zugerichtete Federn, Daunen, künstliche Blumen",7621000,15542000,23163000
2014,7,WA68,"Waren aus Steinen, Gips, Zement usw.",371314000,251278000,622592000
2014,7,WA69,Keramische Waren,264925000,210780000,475705000
2014,7,WA70,Glas und Glaswaren,489067000,389583000,878650000
2014,7,WA71,"Perlen, Edelsteine, Edelmetalle",925671000,1087825000,2013496000
2014,7,WA72,Eisen und Stahl,1940554000,2130497000,4071051000
2014,7,WA73,Waren aus Eisen oder Stahl,2198328000,1627005000,3825333000
2014,7,WA74,Kupfer und Waren daraus,900430000,869582000,1770012000
2014,7,WA75,Nickel und Waren daraus,93841000,105542000,199383000
2014,7,WA76,Aluminium und Waren daraus,1145315000,1174401000,2319716000
2014,7,WA78,Blei und Waren daraus,43433000,26883000,70316000
2014,7,WA79,Zink und Waren daraus,58652000,113253000,171905000
2014,7,WA80,Zinn und Waren daraus,12243000,41614000,53857000
2014,7,WA81,"Andere unedle Metalle, Cermets usw.",126743000,133727000,260470000
2014,7,WA82,"Werkzeuge, Schneidwaren, Essbestecke",632392000,394740000,1027132000
2014,7,WA83,Verschiedene Waren aus unedlen Metallen,585997000,369170000,955167000
2014,7,WA84,"Maschinen, Apparate, mechanische Geräte",17358975000,9690854000,27049829000
2014,7,WA85,Elektrotechnische Erzeugnisse,9436659000,8383574000,17820233000
2014,7,WA86,Schienenfahrzeuge,336809000,206854000,543663000
2014,7,WA87,"Kraftfahrzeuge, Landfahrzeuge",18149256000,6860504000,25009760000
2014,7,WA88,"Luftfahrzeuge, Raumfahrzeuge",3207010000,1093535000,4300545000
2014,7,WA89,Wasserfahrzeuge,169166000,124988000,294154000
2014,7,WA90,"Optische, photografische usw. Erzeugnisse",4412089000,2545974000,6958063000
2014,7,WA91,Uhrmacherwaren,150998000,198099000,349097000
2014,7,WA92,Musikinstrumente,45243000,41474000,86717000
2014,7,WA93,Waffen und Munition,33288000,16012000,49300000
2014,7,WA94,"Möbel, Beleuchtungskörper usw.",1167454000,1287788000,2455242000
2014,7,WA95,"Spielzeug, Spiele usw., Sportgeräte",396967000,333077000,730044000
2014,7,WA96,Verschiedene Waren,317767000,212742000,530509000
2014,7,WA97,"Kunstgegenstände, Sammlungsstücke",39676000,53418000,93094000
2014,7,WA98,Vollständige Fabrikationsanlagen,264357000,636000,264993000
2014,7,WA99,Zusammenstellungen verschiedener Waren,2383655000,804852000,3188507000
2014,8,WA01,Lebende Tiere,116245000,146110000,262355000
2014,8,WA02,Fleisch,612719000,460638000,1073357000
2014,8,WA03,"Fische, Krebs- und Weichtiere",103857000,242008000,345865000
2014,8,WA04,"Milch, Milcherzeugnisse, Eier, Honig",756395000,590286000,1346681000
2014,8,WA05,Andere Waren tierischen Ursprungs,52477000,62872000,115349000
2014,8,WA06,"Pflanzen, Waren des Blumenhandels",53074000,172306000,225380000
2014,8,WA07,"Gemüse, Pflanzen für Ernährung",71976000,298243000,370219000
2014,8,WA08,Genießbare Früchte und Nüsse,114123000,623781000,737904000
2014,8,WA09,"Kaffee, Tee, Mate, Gewürze",168458000,323477000,491935000
2014,8,WA10,Getreide,209950000,189191000,399141000
2014,8,WA11,"Müllereierzeugnisse, Malz usw.",104350000,38545000,142895000
2014,8,WA12,"Ölsamen usw., Heilpflanzen usw.",70343000,444676000,515019000
2014,8,WA13,"Schellack, Gummen, Harz, Pflanzensaft",36101000,33770000,69871000
2014,8,WA14,Flechtstoffe usw. pflanzlichen Ursprungs,1177000,3252000,4429000
2014,8,WA15,"Tierische und pflanzliche Fette, Öle, Wachs",217176000,334112000,551288000
2014,8,WA16,"Zubereitungen von Fleisch, Fisch usw.",211802000,174911000,386713000
2014,8,WA17,Zucker und Zuckerwaren,154655000,132783000,287438000
2014,8,WA18,Kakao und Zubereitungen aus Kakao,355776000,296190000,651966000
2014,8,WA19,"Zubereitungen aus Getreide usw., Backwaren",428621000,257381000,686002000
2014,8,WA20,"Zubereitungen von Gemüse, Früchten usw.",184752000,313598000,498350000
2014,8,WA21,Verschiedene Lebensmittelzubereitungen,366255000,217668000,583923000
2014,8,WA22,"Getränke, alkoholhaltige Flüssigkeiten, Essig",444572000,525433000,970005000
2014,8,WA23,"Rückstände der Lebensmittelindustrie, Futter",333550000,284344000,617894000
2014,8,WA24,Tabak,306115000,142434000,448549000
2014,8,WA25,"Salz, Schwefel, Steine, Erden usw.",149793000,142906000,292699000
2014,8,WA26,"Erze, Schlacken, Aschen",20483000,629715000,650198000
2014,8,WA27,Mineralische Brennstoffe usw.,1992313000,9299170000,11291483000
2014,8,WA28,Anorganische chemische Erzeugnisse,655695000,554142000,1209837000
2014,8,WA29,Organische chemische Erzeugnisse,2001284000,2337189000,4338473000
2014,8,WA30,Pharmazeutische Erzeugnisse,5276206000,2963945000,8240151000
2014,8,WA31,Düngemittel,152268000,97986000,250254000
2014,8,WA32,"Gerb- und Farbstoffe, Farben, Lacke usw.",775445000,425933000,1201378000
2014,8,WA33,"Etherische Öle, Riech-, Schönheitsmittel",699849000,465359000,1165208000
2014,8,WA34,"Seifen, Waschmittel usw.",521258000,278015000,799273000
2014,8,WA35,"Eiweißstoffe, Klebstoffe, Enzyme",232959000,151504000,384463000
2014,8,WA36,"Sprengstoffe, pyrotechnische Artikel usw.",16461000,20068000,36529000
2014,8,WA37,Photochemische Erzeugnisse,81673000,55692000,137365000
2014,8,WA38,Verschiedene Erzeugnisse der Chemischen Industrie,1426078000,919329000,2345407000
2014,8,WA39,Kunststoffe und Waren daraus,4068076000,2617228000,6685304000
2014,8,WA40,Kautschuk und Waren daraus,1041842000,1012403000,2054245000
2014,8,WA41,"Häute, Felle, Leder",74773000,70711000,145484000
2014,8,WA42,"Lederwaren, Sattlerwaren",155589000,293555000,449144000
2014,8,WA43,"Pelzfelle, künstliches Pelzwerk",19022000,15564000,34586000
2014,8,WA44,"Holz, Holzwaren, Holzkohle",514092000,529622000,1043714000
2014,8,WA45,"Kork, Korkwaren",2380000,9272000,11652000
2014,8,WA46,"Flechtwaren, Korbmacherwaren",3687000,10154000,13841000
2014,8,WA47,"Halbstoffe aus Holz usw., Papierabfall",87592000,273640000,361232000
2014,8,WA48,"Papier, Pappe und Waren daraus",1300879000,898299000,2199178000
2014,8,WA49,"Bücher, Zeitungen, Bilddrucke usw.",339294000,142371000,481665000
2014,8,WA50,Seide,3149000,4434000,7583000
2014,8,WA51,"Wolle, feine und grobe Tierhaare",30410000,38647000,69057000
2014,8,WA52,Baumwolle,53616000,55447000,109063000
2014,8,WA53,"Andere pflanzliche Spinnstoffe, Papiergarn",2055000,3861000,5916000
2014,8,WA54,Synthetisches oder künstliches Filament,127234000,103516000,230750000
2014,8,WA55,Synthetische oder künstliche Spinnfaser,127435000,104278000,231713000
2014,8,WA56,"Watte, Filz, Vliesstoff usw., Tauwerk",170985000,93011000,263996000
2014,8,WA57,"Teppiche, Fußbodenbelag aus Spinnstoff",37234000,67532000,104766000
2014,8,WA58,"Spezialgewebe, Spitzen, Tapisserien",30733000,18366000,49099000
2014,8,WA59,"Getränkte, bestrichene usw. Gewebe",150925000,74539000,225464000
2014,8,WA60,Gewirke und Gestricke,45857000,24157000,70014000
2014,8,WA61,"Bekleidung usw. aus Gewirken, Gestricken",681359000,1398869000,2080228000
2014,8,WA62,"Andere Bekleidung, Bekleidungszubehör",764432000,1419751000,2184183000
2014,8,WA63,"Andere Konfektion, Spinnstoffwaren usw.",186334000,276041000,462375000
2014,8,WA64,"Schuhe, Gamaschen, ähnliche Waren",451553000,870166000,1321719000
2014,8,WA65,Kopfbedeckungen und Teile davon,31027000,51280000,82307000
2014,8,WA66,"Schirme, Gehstöcke usw., Peitschen",5869000,12734000,18603000
2014,8,WA67,"Zugerichtete Federn, Daunen, künstliche Blumen",7952000,14225000,22177000
2014,8,WA68,"Waren aus Steinen, Gips, Zement usw.",301736000,214808000,516544000
2014,8,WA69,Keramische Waren,232716000,189727000,422443000
2014,8,WA70,Glas und Glaswaren,420399000,312837000,733236000
2014,8,WA71,"Perlen, Edelsteine, Edelmetalle",849534000,1122105000,1971639000
2014,8,WA72,Eisen und Stahl,1600376000,1644932000,3245308000
2014,8,WA73,Waren aus Eisen oder Stahl,1953178000,1365787000,3318965000
2014,8,WA74,Kupfer und Waren daraus,803689000,749638000,1553327000
2014,8,WA75,Nickel und Waren daraus,77351000,100372000,177723000
2014,8,WA76,Aluminium und Waren daraus,991029000,1046339000,2037368000
2014,8,WA78,Blei und Waren daraus,32900000,24006000,56906000
2014,8,WA79,Zink und Waren daraus,45624000,102148000,147772000
2014,8,WA80,Zinn und Waren daraus,8224000,29566000,37790000
2014,8,WA81,"Andere unedle Metalle, Cermets usw.",101810000,113678000,215488000
2014,8,WA82,"Werkzeuge, Schneidwaren, Essbestecke",550327000,325270000,875597000
2014,8,WA83,Verschiedene Waren aus unedlen Metallen,507621000,284080000,791701000
2014,8,WA84,"Maschinen, Apparate, mechanische Geräte",14535623000,7935415000,22471038000
2014,8,WA85,Elektrotechnische Erzeugnisse,8431886000,7517378000,15949264000
2014,8,WA86,Schienenfahrzeuge,241615000,140401000,382016000
2014,8,WA87,"Kraftfahrzeuge, Landfahrzeuge",11515782000,4909986000,16425768000
2014,8,WA88,"Luftfahrzeuge, Raumfahrzeuge",2077260000,1429666000,3506926000
2014,8,WA89,Wasserfahrzeuge,277128000,30984000,308112000
2014,8,WA90,"Optische, photografische usw. Erzeugnisse",3889523000,2134546000,6024069000
2014,8,WA91,Uhrmacherwaren,153458000,157036000,310494000
2014,8,WA92,Musikinstrumente,32216000,39256000,71472000
2014,8,WA93,Waffen und Munition,29580000,14123000,43703000
2014,8,WA94,"Möbel, Beleuchtungskörper usw.",999096000,1151865000,2150961000
2014,8,WA95,"Spielzeug, Spiele usw., Sportgeräte",245320000,372946000,618266000
2014,8,WA96,Verschiedene Waren,287398000,183020000,470418000
2014,8,WA97,"Kunstgegenstände, Sammlungsstücke",31829000,18039000,49868000
2014,8,WA98,Vollständige Fabrikationsanlagen,179167000,4787000,183954000
2014,8,WA99,Zusammenstellungen verschiedener Waren,1714234000,752895000,2467129000
2014,9,WA01,Lebende Tiere,128608000,163185000,291793000
2014,9,WA02,Fleisch,679331000,532554000,1211885000
2014,9,WA03,"Fische, Krebs- und Weichtiere",117175000,310660000,427835000
2014,9,WA04,"Milch, Milcherzeugnisse, Eier, Honig",739723000,579668000,1319391000
2014,9,WA05,Andere Waren tierischen Ursprungs,74115000,77942000,152057000
2014,9,WA06,"Pflanzen, Waren des Blumenhandels",76660000,188009000,264669000
2014,9,WA07,"Gemüse, Pflanzen für Ernährung",71268000,325107000,396375000
2014,9,WA08,Genießbare Früchte und Nüsse,133991000,595816000,729807000
2014,9,WA09,"Kaffee, Tee, Mate, Gewürze",190840000,360364000,551204000
2014,9,WA10,Getreide,207785000,203546000,411331000
2014,9,WA11,"Müllereierzeugnisse, Malz usw.",110230000,39288000,149518000
2014,9,WA12,"Ölsamen usw., Heilpflanzen usw.",59820000,386431000,446251000
2014,9,WA13,"Schellack, Gummen, Harz, Pflanzensaft",40713000,35692000,76405000
2014,9,WA14,Flechtstoffe usw. pflanzlichen Ursprungs,556000,3207000,3763000
2014,9,WA15,"Tierische und pflanzliche Fette, Öle, Wachs",221348000,296002000,517350000
2014,9,WA16,"Zubereitungen von Fleisch, Fisch usw.",245992000,197662000,443654000
2014,9,WA17,Zucker und Zuckerwaren,168047000,127749000,295796000
2014,9,WA18,Kakao und Zubereitungen aus Kakao,486190000,369742000,855932000
2014,9,WA19,"Zubereitungen aus Getreide usw., Backwaren",487501000,282724000,770225000
2014,9,WA20,"Zubereitungen von Gemüse, Früchten usw.",199677000,336007000,535684000
2014,9,WA21,Verschiedene Lebensmittelzubereitungen,388240000,224200000,612440000
2014,9,WA22,"Getränke, alkoholhaltige Flüssigkeiten, Essig",452129000,554065000,1006194000
2014,9,WA23,"Rückstände der Lebensmittelindustrie, Futter",336544000,311549000,648093000
2014,9,WA24,Tabak,336996000,171586000,508582000
2014,9,WA25,"Salz, Schwefel, Steine, Erden usw.",178457000,156493000,334950000
2014,9,WA26,"Erze, Schlacken, Aschen",25221000,640814000,666035000
2014,9,WA27,Mineralische Brennstoffe usw.,2411587000,9553026000,11964613000
2014,9,WA28,Anorganische chemische Erzeugnisse,758944000,547361000,1306305000
2014,9,WA29,Organische chemische Erzeugnisse,2152762000,2097119000,4249881000
2014,9,WA30,Pharmazeutische Erzeugnisse,5021520000,3281325000,8302845000
2014,9,WA31,Düngemittel,173989000,119506000,293495000
2014,9,WA32,"Gerb- und Farbstoffe, Farben, Lacke usw.",909620000,496516000,1406136000
2014,9,WA33,"Etherische Öle, Riech-, Schönheitsmittel",758196000,494768000,1252964000
2014,9,WA34,"Seifen, Waschmittel usw.",571857000,317974000,889831000
2014,9,WA35,"Eiweißstoffe, Klebstoffe, Enzyme",253312000,159370000,412682000
2014,9,WA36,"Sprengstoffe, pyrotechnische Artikel usw.",18656000,28818000,47474000
2014,9,WA37,Photochemische Erzeugnisse,95960000,62311000,158271000
2014,9,WA38,Verschiedene Erzeugnisse der Chemischen Industrie,1589098000,971780000,2560878000
2014,9,WA39,Kunststoffe und Waren daraus,4701332000,2939837000,7641169000
2014,9,WA40,Kautschuk und Waren daraus,1243915000,1163555000,2407470000
2014,9,WA41,"Häute, Felle, Leder",101801000,76287000,178088000
2014,9,WA42,"Lederwaren, Sattlerwaren",157602000,295947000,453549000
2014,9,WA43,"Pelzfelle, künstliches Pelzwerk",17362000,15744000,33106000
2014,9,WA44,"Holz, Holzwaren, Holzkohle",609434000,599806000,1209240000
2014,9,WA45,"Kork, Korkwaren",1982000,5889000,7871000
2014,9,WA46,"Flechtwaren, Korbmacherwaren",3685000,9899000,13584000
2014,9,WA47,"Halbstoffe aus Holz usw., Papierabfall",98425000,302169000,400594000
2014,9,WA48,"Papier, Pappe und Waren daraus",1463151000,1045567000,2508718000
2014,9,WA49,"Bücher, Zeitungen, Bilddrucke usw.",375647000,169181000,544828000
2014,9,WA50,Seide,4328000,5241000,9569000
2014,9,WA51,"Wolle, feine und grobe Tierhaare",39363000,50880000,90243000
2014,9,WA52,Baumwolle,76940000,74691000,151631000
2014,9,WA53,"Andere pflanzliche Spinnstoffe, Papiergarn",2443000,5539000,7982000
2014,9,WA54,Synthetisches oder künstliches Filament,168739000,120796000,289535000
2014,9,WA55,Synthetische oder künstliche Spinnfaser,162919000,136381000,299300000
2014,9,WA56,"Watte, Filz, Vliesstoff usw., Tauwerk",210377000,106653000,317030000
2014,9,WA57,"Teppiche, Fußbodenbelag aus Spinnstoff",42931000,83720000,126651000
2014,9,WA58,"Spezialgewebe, Spitzen, Tapisserien",38177000,22756000,60933000
2014,9,WA59,"Getränkte, bestrichene usw. Gewebe",182563000,93604000,276167000
2014,9,WA60,Gewirke und Gestricke,60188000,34707000,94895000
2014,9,WA61,"Bekleidung usw. aus Gewirken, Gestricken",704951000,1381795000,2086746000
2014,9,WA62,"Andere Bekleidung, Bekleidungszubehör",812296000,1433679000,2245975000
2014,9,WA63,"Andere Konfektion, Spinnstoffwaren usw.",205041000,293025000,498066000
2014,9,WA64,"Schuhe, Gamaschen, ähnliche Waren",427919000,818589000,1246508000
2014,9,WA65,Kopfbedeckungen und Teile davon,38218000,55550000,93768000
2014,9,WA66,"Schirme, Gehstöcke usw., Peitschen",6381000,9201000,15582000
2014,9,WA67,"Zugerichtete Federn, Daunen, künstliche Blumen",11250000,16561000,27811000
2014,9,WA68,"Waren aus Steinen, Gips, Zement usw.",329643000,236903000,566546000
2014,9,WA69,Keramische Waren,264889000,208672000,473561000
2014,9,WA70,Glas und Glaswaren,484463000,381364000,865827000
2014,9,WA71,"Perlen, Edelsteine, Edelmetalle",962954000,1066844000,2029798000
2014,9,WA72,Eisen und Stahl,1997810000,2005726000,4003536000
2014,9,WA73,Waren aus Eisen oder Stahl,2283531000,1601547000,3885078000
2014,9,WA74,Kupfer und Waren daraus,946172000,718067000,1664239000
2014,9,WA75,Nickel und Waren daraus,99478000,145321000,244799000
2014,9,WA76,Aluminium und Waren daraus,1145855000,1195472000,2341327000
2014,9,WA78,Blei und Waren daraus,52444000,22350000,74794000
2014,9,WA79,Zink und Waren daraus,62861000,105776000,168637000
2014,9,WA80,Zinn und Waren daraus,11053000,27444000,38497000
2014,9,WA81,"Andere unedle Metalle, Cermets usw.",134038000,132217000,266255000
2014,9,WA82,"Werkzeuge, Schneidwaren, Essbestecke",636959000,360095000,997054000
2014,9,WA83,Verschiedene Waren aus unedlen Metallen,586280000,356491000,942771000
2014,9,WA84,"Maschinen, Apparate, mechanische Geräte",17010734000,10162218000,27172952000
2014,9,WA85,Elektrotechnische Erzeugnisse,9990899000,9280589000,19271488000
2014,9,WA86,Schienenfahrzeuge,284654000,194074000,478728000
2014,9,WA87,"Kraftfahrzeuge, Landfahrzeuge",17992550000,6911078000,24903628000
2014,9,WA88,"Luftfahrzeuge, Raumfahrzeuge",3105770000,1634887000,4740657000
2014,9,WA89,Wasserfahrzeuge,1008958000,249117000,1258075000
2014,9,WA90,"Optische, photografische usw. Erzeugnisse",4562017000,2568626000,7130643000
2014,9,WA91,Uhrmacherwaren,192357000,194038000,386395000
2014,9,WA92,Musikinstrumente,51114000,46784000,97898000
2014,9,WA93,Waffen und Munition,37354000,15868000,53222000
2014,9,WA94,"Möbel, Beleuchtungskörper usw.",1250869000,1467461000,2718330000
2014,9,WA95,"Spielzeug, Spiele usw., Sportgeräte",357744000,513145000,870889000
2014,9,WA96,Verschiedene Waren,308601000,210504000,519105000
2014,9,WA97,"Kunstgegenstände, Sammlungsstücke",59104000,33337000,92441000
2014,9,WA98,Vollständige Fabrikationsanlagen,156733000,7395000,164128000
2014,9,WA99,Zusammenstellungen verschiedener Waren,2241426000,840871000,3082297000
2014,10,WA01,Lebende Tiere,140236000,161538000,301774000
2014,10,WA02,Fleisch,686440000,522725000,1209165000
2014,10,WA03,"Fische, Krebs- und Weichtiere",138148000,353451000,491599000
2014,10,WA04,"Milch, Milcherzeugnisse, Eier, Honig",760825000,614749000,1375574000
2014,10,WA05,Andere Waren tierischen Ursprungs,57838000,69038000,126876000
2014,10,WA06,"Pflanzen, Waren des Blumenhandels",71880000,175484000,247364000
2014,10,WA07,"Gemüse, Pflanzen für Ernährung",80105000,355984000,436089000
2014,10,WA08,Genießbare Früchte und Nüsse,132140000,680237000,812377000
2014,10,WA09,"Kaffee, Tee, Mate, Gewürze",222589000,375136000,597725000
2014,10,WA10,Getreide,247558000,204291000,451849000
2014,10,WA11,"Müllereierzeugnisse, Malz usw.",131006000,40923000,171929000
2014,10,WA12,"Ölsamen usw., Heilpflanzen usw.",71280000,414918000,486198000
2014,10,WA13,"Schellack, Gummen, Harz, Pflanzensaft",40410000,41349000,81759000
2014,10,WA14,Flechtstoffe usw. pflanzlichen Ursprungs,926000,3156000,4082000
2014,10,WA15,"Tierische und pflanzliche Fette, Öle, Wachs",229262000,322633000,551895000
2014,10,WA16,"Zubereitungen von Fleisch, Fisch usw.",242881000,201136000,444017000
2014,10,WA17,Zucker und Zuckerwaren,198683000,130620000,329303000
2014,10,WA18,Kakao und Zubereitungen aus Kakao,504882000,388083000,892965000
2014,10,WA19,"Zubereitungen aus Getreide usw., Backwaren",481569000,291267000,772836000
2014,10,WA20,"Zubereitungen von Gemüse, Früchten usw.",203368000,378049000,581417000
2014,10,WA21,Verschiedene Lebensmittelzubereitungen,423315000,231929000,655244000
2014,10,WA22,"Getränke, alkoholhaltige Flüssigkeiten, Essig",432141000,567419000,999560000
2014,10,WA23,"Rückstände der Lebensmittelindustrie, Futter",335391000,333798000,669189000
2014,10,WA24,Tabak,331859000,179128000,510987000
2014,10,WA25,"Salz, Schwefel, Steine, Erden usw.",186517000,152643000,339160000
2014,10,WA26,"Erze, Schlacken, Aschen",26168000,647731000,673899000
2014,10,WA27,Mineralische Brennstoffe usw.,2405375000,9490998000,11896373000
2014,10,WA28,Anorganische chemische Erzeugnisse,704598000,541791000,1246389000
2014,10,WA29,Organische chemische Erzeugnisse,2108857000,2419716000,4528573000
2014,10,WA30,Pharmazeutische Erzeugnisse,5095452000,3436398000,8531850000
2014,10,WA31,Düngemittel,208345000,122615000,330960000
2014,10,WA32,"Gerb- und Farbstoffe, Farben, Lacke usw.",936061000,492929000,1428990000
2014,10,WA33,"Etherische Öle, Riech-, Schönheitsmittel",804253000,492570000,1296823000
2014,10,WA34,"Seifen, Waschmittel usw.",599743000,318378000,918121000
2014,10,WA35,"Eiweißstoffe, Klebstoffe, Enzyme",289882000,190997000,480879000
2014,10,WA36,"Sprengstoffe, pyrotechnische Artikel usw.",19082000,29831000,48913000
2014,10,WA37,Photochemische Erzeugnisse,94802000,63730000,158532000
2014,10,WA38,Verschiedene Erzeugnisse der Chemischen Industrie,1672575000,970874000,2643449000
2014,10,WA39,Kunststoffe und Waren daraus,4778600000,2933756000,7712356000
2014,10,WA40,Kautschuk und Waren daraus,1274654000,1146980000,2421634000
2014,10,WA41,"Häute, Felle, Leder",108324000,95333000,203657000
2014,10,WA42,"Lederwaren, Sattlerwaren",160914000,296059000,456973000
2014,10,WA43,"Pelzfelle, künstliches Pelzwerk",15665000,14893000,30558000
2014,10,WA44,"Holz, Holzwaren, Holzkohle",637820000,612819000,1250639000
2014,10,WA45,"Kork, Korkwaren",2462000,9660000,12122000
2014,10,WA46,"Flechtwaren, Korbmacherwaren",3598000,8809000,12407000
2014,10,WA47,"Halbstoffe aus Holz usw., Papierabfall",96156000,294036000,390192000
2014,10,WA48,"Papier, Pappe und Waren daraus",1542134000,1053873000,2596007000
2014,10,WA49,"Bücher, Zeitungen, Bilddrucke usw.",408771000,182782000,591553000
2014,10,WA50,Seide,6915000,7103000,14018000
2014,10,WA51,"Wolle, feine und grobe Tierhaare",48826000,56348000,105174000
2014,10,WA52,Baumwolle,90478000,87477000,177955000
2014,10,WA53,"Andere pflanzliche Spinnstoffe, Papiergarn",5071000,7053000,12124000
2014,10,WA54,Synthetisches oder künstliches Filament,171100000,136393000,307493000
2014,10,WA55,Synthetische oder künstliche Spinnfaser,172163000,134868000,307031000
2014,10,WA56,"Watte, Filz, Vliesstoff usw., Tauwerk",206087000,104689000,310776000
2014,10,WA57,"Teppiche, Fußbodenbelag aus Spinnstoff",53036000,100976000,154012000
2014,10,WA58,"Spezialgewebe, Spitzen, Tapisserien",44087000,23692000,67779000
2014,10,WA59,"Getränkte, bestrichene usw. Gewebe",181596000,93279000,274875000
2014,10,WA60,Gewirke und Gestricke,72832000,40246000,113078000
2014,10,WA61,"Bekleidung usw. aus Gewirken, Gestricken",620216000,1286077000,1906293000
2014,10,WA62,"Andere Bekleidung, Bekleidungszubehör",644715000,1135846000,1780561000
2014,10,WA63,"Andere Konfektion, Spinnstoffwaren usw.",223979000,306818000,530797000
2014,10,WA64,"Schuhe, Gamaschen, ähnliche Waren",338097000,639661000,977758000
2014,10,WA65,Kopfbedeckungen und Teile davon,37570000,46617000,84187000
2014,10,WA66,"Schirme, Gehstöcke usw., Peitschen",7493000,11493000,18986000
2014,10,WA67,"Zugerichtete Federn, Daunen, künstliche Blumen",9489000,13231000,22720000
2014,10,WA68,"Waren aus Steinen, Gips, Zement usw.",370392000,241533000,611925000
2014,10,WA69,Keramische Waren,269922000,221464000,491386000
2014,10,WA70,Glas und Glaswaren,519361000,405338000,924699000
2014,10,WA71,"Perlen, Edelsteine, Edelmetalle",932227000,996661000,1928888000
2014,10,WA72,Eisen und Stahl,1904918000,1981780000,3886698000
2014,10,WA73,Waren aus Eisen oder Stahl,2318993000,1610170000,3929163000
2014,10,WA74,Kupfer und Waren daraus,923304000,873813000,1797117000
2014,10,WA75,Nickel und Waren daraus,95044000,129281000,224325000
2014,10,WA76,Aluminium und Waren daraus,1193057000,1348438000,2541495000
2014,10,WA78,Blei und Waren daraus,39997000,37431000,77428000
2014,10,WA79,Zink und Waren daraus,61955000,113437000,175392000
2014,10,WA80,Zinn und Waren daraus,10657000,32194000,42851000
2014,10,WA81,"Andere unedle Metalle, Cermets usw.",119113000,141276000,260389000
2014,10,WA82,"Werkzeuge, Schneidwaren, Essbestecke",677305000,395272000,1072577000
2014,10,WA83,Verschiedene Waren aus unedlen Metallen,568821000,365717000,934538000
2014,10,WA84,"Maschinen, Apparate, mechanische Geräte",17475019000,10389837000,27864856000
2014,10,WA85,Elektrotechnische Erzeugnisse,10369862000,9747734000,20117596000
2014,10,WA86,Schienenfahrzeuge,323876000,205693000,529569000
2014,10,WA87,"Kraftfahrzeuge, Landfahrzeuge",18418172000,7289056000,25707228000
2014,10,WA88,"Luftfahrzeuge, Raumfahrzeuge",3080572000,1332657000,4413229000
2014,10,WA89,Wasserfahrzeuge,896974000,107836000,1004810000
2014,10,WA90,"Optische, photografische usw. Erzeugnisse",4618140000,2607118000,7225258000
2014,10,WA91,Uhrmacherwaren,193731000,212532000,406263000
2014,10,WA92,Musikinstrumente,53186000,52528000,105714000
2014,10,WA93,Waffen und Munition,38811000,13705000,52516000
2014,10,WA94,"Möbel, Beleuchtungskörper usw.",1285928000,1482048000,2767976000
2014,10,WA95,"Spielzeug, Spiele usw., Sportgeräte",432762000,593732000,1026494000
2014,10,WA96,Verschiedene Waren,314382000,208113000,522495000
2014,10,WA97,"Kunstgegenstände, Sammlungsstücke",39156000,23935000,63091000
2014,10,WA98,Vollständige Fabrikationsanlagen,185878000,2809000,188687000
2014,10,WA99,Zusammenstellungen verschiedener Waren,1852101000,914577000,2766678000
2014,11,WA01,Lebende Tiere,113678000,145369000,259047000
2014,11,WA02,Fleisch,645103000,504422000,1149525000
2014,11,WA03,"Fische, Krebs- und Weichtiere",118969000,316019000,434988000
2014,11,WA04,"Milch, Milcherzeugnisse, Eier, Honig",693204000,554111000,1247315000
2014,11,WA05,Andere Waren tierischen Ursprungs,68003000,68804000,136807000
2014,11,WA06,"Pflanzen, Waren des Blumenhandels",60807000,192088000,252895000
2014,11,WA07,"Gemüse, Pflanzen für Ernährung",62169000,368003000,430172000
2014,11,WA08,Genießbare Früchte und Nüsse,130487000,652308000,782795000
2014,11,WA09,"Kaffee, Tee, Mate, Gewürze",226245000,335953000,562198000
2014,11,WA10,Getreide,198341000,212480000,410821000
2014,11,WA11,"Müllereierzeugnisse, Malz usw.",119880000,41361000,161241000
2014,11,WA12,"Ölsamen usw., Heilpflanzen usw.",74704000,358390000,433094000
2014,11,WA13,"Schellack, Gummen, Harz, Pflanzensaft",39488000,33098000,72586000
2014,11,WA14,Flechtstoffe usw. pflanzlichen Ursprungs,691000,2839000,3530000
2014,11,WA15,"Tierische und pflanzliche Fette, Öle, Wachs",185861000,276437000,462298000
2014,11,WA16,"Zubereitungen von Fleisch, Fisch usw.",217767000,184736000,402503000
2014,11,WA17,Zucker und Zuckerwaren,182716000,132467000,315183000
2014,11,WA18,Kakao und Zubereitungen aus Kakao,465353000,386808000,852161000
2014,11,WA19,"Zubereitungen aus Getreide usw., Backwaren",451177000,287130000,738307000
2014,11,WA20,"Zubereitungen von Gemüse, Früchten usw.",184335000,366110000,550445000
2014,11,WA21,Verschiedene Lebensmittelzubereitungen,380908000,219926000,600834000
2014,11,WA22,"Getränke, alkoholhaltige Flüssigkeiten, Essig",404250000,527788000,932038000
2014,11,WA23,"Rückstände der Lebensmittelindustrie, Futter",306956000,323291000,630247000
2014,11,WA24,Tabak,302854000,173409000,476263000
2014,11,WA25,"Salz, Schwefel, Steine, Erden usw.",154226000,143642000,297868000
2014,11,WA26,"Erze, Schlacken, Aschen",29678000,708287000,737965000
2014,11,WA27,Mineralische Brennstoffe usw.,2293263000,9536368000,11829631000
2014,11,WA28,Anorganische chemische Erzeugnisse,645907000,518431000,1164338000
2014,11,WA29,Organische chemische Erzeugnisse,1967809000,2270907000,4238716000
2014,11,WA30,Pharmazeutische Erzeugnisse,5246312000,3145718000,8392030000
2014,11,WA31,Düngemittel,191555000,121173000,312728000
2014,11,WA32,"Gerb- und Farbstoffe, Farben, Lacke usw.",836475000,455939000,1292414000
2014,11,WA33,"Etherische Öle, Riech-, Schönheitsmittel",718653000,467984000,1186637000
2014,11,WA34,"Seifen, Waschmittel usw.",522548000,276834000,799382000
2014,11,WA35,"Eiweißstoffe, Klebstoffe, Enzyme",242942000,178359000,421301000
2014,11,WA36,"Sprengstoffe, pyrotechnische Artikel usw.",19729000,30106000,49835000
2014,11,WA37,Photochemische Erzeugnisse,90306000,64744000,155050000
2014,11,WA38,Verschiedene Erzeugnisse der Chemischen Industrie,1604424000,942943000,2547367000
2014,11,WA39,Kunststoffe und Waren daraus,4207472000,2617724000,6825196000
2014,11,WA40,Kautschuk und Waren daraus,1096565000,971310000,2067875000
2014,11,WA41,"Häute, Felle, Leder",101903000,80317000,182220000
2014,11,WA42,"Lederwaren, Sattlerwaren",144534000,303475000,448009000
2014,11,WA43,"Pelzfelle, künstliches Pelzwerk",12285000,11552000,23837000
2014,11,WA44,"Holz, Holzwaren, Holzkohle",542060000,546793000,1088853000
2014,11,WA45,"Kork, Korkwaren",1905000,7016000,8921000
2014,11,WA46,"Flechtwaren, Korbmacherwaren",3052000,10114000,13166000
2014,11,WA47,"Halbstoffe aus Holz usw., Papierabfall",85707000,283166000,368873000
2014,11,WA48,"Papier, Pappe und Waren daraus",1350225000,958690000,2308915000
2014,11,WA49,"Bücher, Zeitungen, Bilddrucke usw.",371251000,193152000,564403000
2014,11,WA50,Seide,6331000,6733000,13064000
2014,11,WA51,"Wolle, feine und grobe Tierhaare",35916000,50236000,86152000
2014,11,WA52,Baumwolle,85192000,84322000,169514000
2014,11,WA53,"Andere pflanzliche Spinnstoffe, Papiergarn",4449000,6697000,11146000
2014,11,WA54,Synthetisches oder künstliches Filament,155081000,116852000,271933000
2014,11,WA55,Synthetische oder künstliche Spinnfaser,152065000,123932000,275997000
2014,11,WA56,"Watte, Filz, Vliesstoff usw., Tauwerk",175266000,99130000,274396000
2014,11,WA57,"Teppiche, Fußbodenbelag aus Spinnstoff",39110000,89764000,128874000
2014,11,WA58,"Spezialgewebe, Spitzen, Tapisserien",40097000,23431000,63528000
2014,11,WA59,"Getränkte, bestrichene usw. Gewebe",158081000,86452000,244533000
2014,11,WA60,Gewirke und Gestricke,65602000,34847000,100449000
2014,11,WA61,"Bekleidung usw. aus Gewirken, Gestricken",503013000,1165211000,1668224000
2014,11,WA62,"Andere Bekleidung, Bekleidungszubehör",479695000,1023266000,1502961000
2014,11,WA63,"Andere Konfektion, Spinnstoffwaren usw.",204469000,292256000,496725000
2014,11,WA64,"Schuhe, Gamaschen, ähnliche Waren",239242000,531359000,770601000
2014,11,WA65,Kopfbedeckungen und Teile davon,26706000,36099000,62805000
2014,11,WA66,"Schirme, Gehstöcke usw., Peitschen",5300000,12898000,18198000
2014,11,WA67,"Zugerichtete Federn, Daunen, künstliche Blumen",6420000,12663000,19083000
2014,11,WA68,"Waren aus Steinen, Gips, Zement usw.",313354000,214944000,528298000
2014,11,WA69,Keramische Waren,237532000,194915000,432447000
2014,11,WA70,Glas und Glaswaren,455230000,372753000,827983000
2014,11,WA71,"Perlen, Edelsteine, Edelmetalle",991132000,1342898000,2334030000
2014,11,WA72,Eisen und Stahl,1728960000,1857575000,3586535000
2014,11,WA73,Waren aus Eisen oder Stahl,2048505000,1476966000,3525471000
2014,11,WA74,Kupfer und Waren daraus,861607000,772905000,1634512000
2014,11,WA75,Nickel und Waren daraus,97031000,125323000,222354000
2014,11,WA76,Aluminium und Waren daraus,1100490000,1249628000,2350118000
2014,11,WA78,Blei und Waren daraus,48132000,32963000,81095000
2014,11,WA79,Zink und Waren daraus,54756000,104678000,159434000
2014,11,WA80,Zinn und Waren daraus,7979000,28242000,36221000
2014,11,WA81,"Andere unedle Metalle, Cermets usw.",114494000,139520000,254014000
2014,11,WA82,"Werkzeuge, Schneidwaren, Essbestecke",609013000,354690000,963703000
2014,11,WA83,Verschiedene Waren aus unedlen Metallen,563905000,339397000,903302000
2014,11,WA84,"Maschinen, Apparate, mechanische Geräte",16574376000,9716379000,26290755000
2014,11,WA85,Elektrotechnische Erzeugnisse,9490282000,9200063000,18690345000
2014,11,WA86,Schienenfahrzeuge,331237000,166615000,497852000
2014,11,WA87,"Kraftfahrzeuge, Landfahrzeuge",17215664000,6757772000,23973436000
2014,11,WA88,"Luftfahrzeuge, Raumfahrzeuge",2815822000,1835625000,4651447000
2014,11,WA89,Wasserfahrzeuge,205729000,111840000,317569000
2014,11,WA90,"Optische, photografische usw. Erzeugnisse",4398810000,2550564000,6949374000
2014,11,WA91,Uhrmacherwaren,185453000,207892000,393345000
2014,11,WA92,Musikinstrumente,49481000,48437000,97918000
2014,11,WA93,Waffen und Munition,31770000,12417000,44187000
2014,11,WA94,"Möbel, Beleuchtungskörper usw.",1152383000,1383706000,2536089000
2014,11,WA95,"Spielzeug, Spiele usw., Sportgeräte",393145000,605054000,998199000
2014,11,WA96,Verschiedene Waren,275861000,207570000,483431000
2014,11,WA97,"Kunstgegenstände, Sammlungsstücke",44582000,21127000,65709000
2014,11,WA98,Vollständige Fabrikationsanlagen,227489000,2979000,230468000
2014,11,WA99,Zusammenstellungen verschiedener Waren,1781648000,774509000,2556157000
2014,12,WA01,Lebende Tiere,125194000,139348000,264542000
2014,12,WA02,Fleisch,613631000,543833000,1157464000
2014,12,WA03,"Fische, Krebs- und Weichtiere",141983000,357843000,499826000
2014,12,WA04,"Milch, Milcherzeugnisse, Eier, Honig",679326000,626815000,1306141000
2014,12,WA05,Andere Waren tierischen Ursprungs,58199000,68626000,126825000
2014,12,WA06,"Pflanzen, Waren des Blumenhandels",51848000,185413000,237261000
2014,12,WA07,"Gemüse, Pflanzen für Ernährung",68767000,444296000,513063000
2014,12,WA08,Genießbare Früchte und Nüsse,132357000,690748000,823105000
2014,12,WA09,"Kaffee, Tee, Mate, Gewürze",211594000,355823000,567417000
2014,12,WA10,Getreide,216739000,216730000,433469000
2014,12,WA11,"Müllereierzeugnisse, Malz usw.",104629000,37981000,142610000
2014,12,WA12,"Ölsamen usw., Heilpflanzen usw.",78008000,419140000,497148000
2014,12,WA13,"Schellack, Gummen, Harz, Pflanzensaft",41338000,40273000,81611000
2014,12,WA14,Flechtstoffe usw. pflanzlichen Ursprungs,395000,1999000,2394000
2014,12,WA15,"Tierische und pflanzliche Fette, Öle, Wachs",187419000,278738000,466157000
2014,12,WA16,"Zubereitungen von Fleisch, Fisch usw.",240362000,202812000,443174000
2014,12,WA17,Zucker und Zuckerwaren,176443000,106003000,282446000
2014,12,WA18,Kakao und Zubereitungen aus Kakao,386438000,319361000,705799000
2014,12,WA19,"Zubereitungen aus Getreide usw., Backwaren",406463000,267951000,674414000
2014,12,WA20,"Zubereitungen von Gemüse, Früchten usw.",185882000,370705000,556587000
2014,12,WA21,Verschiedene Lebensmittelzubereitungen,348143000,215346000,563489000
2014,12,WA22,"Getränke, alkoholhaltige Flüssigkeiten, Essig",418847000,535170000,954017000
2014,12,WA23,"Rückstände der Lebensmittelindustrie, Futter",346907000,310774000,657681000
2014,12,WA24,Tabak,286271000,148673000,434944000
2014,12,WA25,"Salz, Schwefel, Steine, Erden usw.",144262000,142230000,286492000
2014,12,WA26,"Erze, Schlacken, Aschen",25831000,521354000,547185000
2014,12,WA27,Mineralische Brennstoffe usw.,2166543000,8667055000,10833598000
2014,12,WA28,Anorganische chemische Erzeugnisse,609930000,443118000,1053048000
2014,12,WA29,Organische chemische Erzeugnisse,1976469000,1670043000,3646512000
2014,12,WA30,Pharmazeutische Erzeugnisse,4888003000,2838503000,7726506000
2014,12,WA31,Düngemittel,165441000,104631000,270072000
2014,12,WA32,"Gerb- und Farbstoffe, Farben, Lacke usw.",670848000,409426000,1080274000
2014,12,WA33,"Etherische Öle, Riech-, Schönheitsmittel",631788000,445775000,1077563000
2014,12,WA34,"Seifen, Waschmittel usw.",462542000,284223000,746765000
2014,12,WA35,"Eiweißstoffe, Klebstoffe, Enzyme",222979000,148237000,371216000
2014,12,WA36,"Sprengstoffe, pyrotechnische Artikel usw.",25556000,27883000,53439000
2014,12,WA37,Photochemische Erzeugnisse,89391000,60531000,149922000
2014,12,WA38,Verschiedene Erzeugnisse der Chemischen Industrie,1454919000,932012000,2386931000
2014,12,WA39,Kunststoffe und Waren daraus,3581966000,2341628000,5923594000
2014,12,WA40,Kautschuk und Waren daraus,902381000,744580000,1646961000
2014,12,WA41,"Häute, Felle, Leder",74685000,68718000,143403000
2014,12,WA42,"Lederwaren, Sattlerwaren",135332000,297148000,432480000
2014,12,WA43,"Pelzfelle, künstliches Pelzwerk",17347000,15576000,32923000
2014,12,WA44,"Holz, Holzwaren, Holzkohle",451813000,458025000,909838000
2014,12,WA45,"Kork, Korkwaren",1562000,4210000,5772000
2014,12,WA46,"Flechtwaren, Korbmacherwaren",3069000,9703000,12772000
2014,12,WA47,"Halbstoffe aus Holz usw., Papierabfall",93867000,286243000,380110000
2014,12,WA48,"Papier, Pappe und Waren daraus",1279822000,935010000,2214832000
2014,12,WA49,"Bücher, Zeitungen, Bilddrucke usw.",383276000,234083000,617359000
2014,12,WA50,Seide,4512000,5386000,9898000
2014,12,WA51,"Wolle, feine und grobe Tierhaare",36797000,42495000,79292000
2014,12,WA52,Baumwolle,67309000,68215000,135524000
2014,12,WA53,"Andere pflanzliche Spinnstoffe, Papiergarn",3868000,5719000,9587000
2014,12,WA54,Synthetisches oder künstliches Filament,128566000,85690000,214256000
2014,12,WA55,Synthetische oder künstliche Spinnfaser,151126000,104337000,255463000
2014,12,WA56,"Watte, Filz, Vliesstoff usw., Tauwerk",160106000,79654000,239760000
2014,12,WA57,"Teppiche, Fußbodenbelag aus Spinnstoff",41451000,82972000,124423000
2014,12,WA58,"Spezialgewebe, Spitzen, Tapisserien",30061000,17515000,47576000
2014,12,WA59,"Getränkte, bestrichene usw. Gewebe",139767000,65576000,205343000
2014,12,WA60,Gewirke und Gestricke,51115000,27246000,78361000
2014,12,WA61,"Bekleidung usw. aus Gewirken, Gestricken",472627000,1059342000,1531969000
2014,12,WA62,"Andere Bekleidung, Bekleidungszubehör",461770000,1063010000,1524780000
2014,12,WA63,"Andere Konfektion, Spinnstoffwaren usw.",176164000,259411000,435575000
2014,12,WA64,"Schuhe, Gamaschen, ähnliche Waren",248551000,604679000,853230000
2014,12,WA65,Kopfbedeckungen und Teile davon,20099000,31653000,51752000
2014,12,WA66,"Schirme, Gehstöcke usw., Peitschen",5325000,14924000,20249000
2014,12,WA67,"Zugerichtete Federn, Daunen, künstliche Blumen",6500000,14035000,20535000
2014,12,WA68,"Waren aus Steinen, Gips, Zement usw.",249015000,191039000,440054000
2014,12,WA69,Keramische Waren,212426000,185503000,397929000
2014,12,WA70,Glas und Glaswaren,390346000,304991000,695337000
2014,12,WA71,"Perlen, Edelsteine, Edelmetalle",892084000,1189352000,2081436000
2014,12,WA72,Eisen und Stahl,1495529000,1503363000,2998892000
2014,12,WA73,Waren aus Eisen oder Stahl,1860090000,1234415000,3094505000
2014,12,WA74,Kupfer und Waren daraus,640035000,587069000,1227104000
2014,12,WA75,Nickel und Waren daraus,85121000,96212000,181333000
2014,12,WA76,Aluminium und Waren daraus,930743000,985860000,1916603000
2014,12,WA78,Blei und Waren daraus,34042000,21282000,55324000
2014,12,WA79,Zink und Waren daraus,38390000,82702000,121092000
2014,12,WA80,Zinn und Waren daraus,8969000,25516000,34485000
2014,12,WA81,"Andere unedle Metalle, Cermets usw.",108519000,110746000,219265000
2014,12,WA82,"Werkzeuge, Schneidwaren, Essbestecke",563944000,363683000,927627000
2014,12,WA83,Verschiedene Waren aus unedlen Metallen,435063000,277480000,712543000
2014,12,WA84,"Maschinen, Apparate, mechanische Geräte",16439127000,9239891000,25679018000
2014,12,WA85,Elektrotechnische Erzeugnisse,9048599000,8211378000,17259977000
2014,12,WA86,Schienenfahrzeuge,316016000,227040000,543056000
2014,12,WA87,"Kraftfahrzeuge, Landfahrzeuge",14436699000,6115043000,20551742000
2014,12,WA88,"Luftfahrzeuge, Raumfahrzeuge",3737870000,1286217000,5024087000
2014,12,WA89,Wasserfahrzeuge,337221000,165608000,502829000
2014,12,WA90,"Optische, photografische usw. Erzeugnisse",4475526000,2472832000,6948358000
2014,12,WA91,Uhrmacherwaren,170754000,175619000,346373000
2014,12,WA92,Musikinstrumente,50597000,47415000,98012000
2014,12,WA93,Waffen und Munition,36424000,9180000,45604000
2014,12,WA94,"Möbel, Beleuchtungskörper usw.",1090255000,1252975000,2343230000
2014,12,WA95,"Spielzeug, Spiele usw., Sportgeräte",317545000,525969000,843514000
2014,12,WA96,Verschiedene Waren,262401000,194666000,457067000
2014,12,WA97,"Kunstgegenstände, Sammlungsstücke",54408000,54928000,109336000
2014,12,WA98,Vollständige Fabrikationsanlagen,245689000,8107000,253796000
2014,12,WA99,Zusammenstellungen verschiedener Waren,1923804000,861336000,2785140000
2015,1,WA01,Lebende Tiere,123534000,139414000,262948000
2015,1,WA02,Fleisch,596092000,453366000,1049458000
2015,1,WA03,"Fische, Krebs- und Weichtiere",102283000,283429000,385712000
2015,1,WA04,"Milch, Milcherzeugnisse, Eier, Honig",700740000,506044000,1206784000
2015,1,WA05,Andere Waren tierischen Ursprungs,65529000,76877000,142406000
2015,1,WA06,"Pflanzen, Waren des Blumenhandels",43095000,194921000,238016000
2015,1,WA07,"Gemüse, Pflanzen für Ernährung",68687000,473467000,542154000
2015,1,WA08,Genießbare Früchte und Nüsse,150847000,699570000,850417000
2015,1,WA09,"Kaffee, Tee, Mate, Gewürze",199356000,362457000,561813000
2015,1,WA10,Getreide,276873000,257369000,534242000
2015,1,WA11,"Müllereierzeugnisse, Malz usw.",106964000,35270000,142234000
2015,1,WA12,"Ölsamen usw., Heilpflanzen usw.",124756000,383948000,508704000
2015,1,WA13,"Schellack, Gummen, Harz, Pflanzensaft",44806000,45279000,90085000
2015,1,WA14,Flechtstoffe usw. pflanzlichen Ursprungs,487000,2952000,3439000
2015,1,WA15,"Tierische und pflanzliche Fette, Öle, Wachs",202132000,282375000,484507000
2015,1,WA16,"Zubereitungen von Fleisch, Fisch usw.",212558000,183581000,396139000
2015,1,WA17,Zucker und Zuckerwaren,139469000,123722000,263191000
2015,1,WA18,Kakao und Zubereitungen aus Kakao,374242000,328006000,702248000
2015,1,WA19,"Zubereitungen aus Getreide usw., Backwaren",418333000,268777000,687110000
2015,1,WA20,"Zubereitungen von Gemüse, Früchten usw.",206864000,362966000,569830000
2015,1,WA21,Verschiedene Lebensmittelzubereitungen,369054000,218454000,587508000
2015,1,WA22,"Getränke, alkoholhaltige Flüssigkeiten, Essig",344544000,456184000,800728000
2015,1,WA23,"Rückstände der Lebensmittelindustrie, Futter",319192000,275049000,594241000
2015,1,WA24,Tabak,303342000,148892000,452234000
2015,1,WA25,"Salz, Schwefel, Steine, Erden usw.",143864000,137743000,281607000
2015,1,WA26,"Erze, Schlacken, Aschen",25172000,480794000,505966000
2015,1,WA27,Mineralische Brennstoffe usw.,2079058000,7702500000,9781558000
2015,1,WA28,Anorganische chemische Erzeugnisse,732890000,517121000,1250011000
2015,1,WA29,Organische chemische Erzeugnisse,2214068000,2192170000,4406238000
2015,1,WA30,Pharmazeutische Erzeugnisse,5131350000,3000199000,8131549000
2015,1,WA31,Düngemittel,231868000,162107000,393975000
2015,1,WA32,"Gerb- und Farbstoffe, Farben, Lacke usw.",879818000,461447000,1341265000
2015,1,WA33,"Etherische Öle, Riech-, Schönheitsmittel",684159000,491662000,1175821000
2015,1,WA34,"Seifen, Waschmittel usw.",563137000,282371000,845508000
2015,1,WA35,"Eiweißstoffe, Klebstoffe, Enzyme",248611000,154474000,403085000
2015,1,WA36,"Sprengstoffe, pyrotechnische Artikel usw.",15966000,15883000,31849000
2015,1,WA37,Photochemische Erzeugnisse,90403000,59766000,150169000
2015,1,WA38,Verschiedene Erzeugnisse der Chemischen Industrie,1803578000,918754000,2722332000
2015,1,WA39,Kunststoffe und Waren daraus,4373234000,2698865000,7072099000
2015,1,WA40,Kautschuk und Waren daraus,1042385000,975455000,2017840000
2015,1,WA41,"Häute, Felle, Leder",96959000,74079000,171038000
2015,1,WA42,"Lederwaren, Sattlerwaren",156216000,322446000,478662000
2015,1,WA43,"Pelzfelle, künstliches Pelzwerk",12149000,7874000,20023000
2015,1,WA44,"Holz, Holzwaren, Holzkohle",524057000,546070000,1070127000
2015,1,WA45,"Kork, Korkwaren",2103000,10222000,12325000
2015,1,WA46,"Flechtwaren, Korbmacherwaren",3749000,13246000,16995000
2015,1,WA47,"Halbstoffe aus Holz usw., Papierabfall",94242000,265771000,360013000
2015,1,WA48,"Papier, Pappe und Waren daraus",1385220000,987389000,2372609000
2015,1,WA49,"Bücher, Zeitungen, Bilddrucke usw.",325441000,192185000,517626000
2015,1,WA50,Seide,4526000,4882000,9408000
2015,1,WA51,"Wolle, feine und grobe Tierhaare",49510000,52715000,102225000
2015,1,WA52,Baumwolle,71375000,80958000,152333000
2015,1,WA53,"Andere pflanzliche Spinnstoffe, Papiergarn",3979000,5551000,9530000
2015,1,WA54,Synthetisches oder künstliches Filament,151285000,123859000,275144000
2015,1,WA55,Synthetische oder künstliche Spinnfaser,158469000,125406000,283875000
2015,1,WA56,"Watte, Filz, Vliesstoff usw., Tauwerk",189528000,106432000,295960000
2015,1,WA57,"Teppiche, Fußbodenbelag aus Spinnstoff",38378000,88993000,127371000
2015,1,WA58,"Spezialgewebe, Spitzen, Tapisserien",36397000,22516000,58913000
2015,1,WA59,"Getränkte, bestrichene usw. Gewebe",169773000,85536000,255309000
2015,1,WA60,Gewirke und Gestricke,58792000,32786000,91578000
2015,1,WA61,"Bekleidung usw. aus Gewirken, Gestricken",591347000,1304541000,1895888000
2015,1,WA62,"Andere Bekleidung, Bekleidungszubehör",660593000,1402512000,2063105000
2015,1,WA63,"Andere Konfektion, Spinnstoffwaren usw.",186555000,294761000,481316000
2015,1,WA64,"Schuhe, Gamaschen, ähnliche Waren",413835000,851411000,1265246000
2015,1,WA65,Kopfbedeckungen und Teile davon,23896000,42214000,66110000
2015,1,WA66,"Schirme, Gehstöcke usw., Peitschen",7791000,26386000,34177000
2015,1,WA67,"Zugerichtete Federn, Daunen, künstliche Blumen",8942000,16703000,25645000
2015,1,WA68,"Waren aus Steinen, Gips, Zement usw.",300359000,207468000,507827000
2015,1,WA69,Keramische Waren,237616000,204417000,442033000
2015,1,WA70,Glas und Glaswaren,458520000,353760000,812280000
2015,1,WA71,"Perlen, Edelsteine, Edelmetalle",841382000,1184933000,2026315000
2015,1,WA72,Eisen und Stahl,1852206000,1854499000,3706705000
2015,1,WA73,Waren aus Eisen oder Stahl,2016451000,1432676000,3449127000
2015,1,WA74,Kupfer und Waren daraus,872798000,645740000,1518538000
2015,1,WA75,Nickel und Waren daraus,98011000,93075000,191086000
2015,1,WA76,Aluminium und Waren daraus,1079477000,1193722000,2273199000
2015,1,WA78,Blei und Waren daraus,34985000,24962000,59947000
2015,1,WA79,Zink und Waren daraus,49086000,90159000,139245000
2015,1,WA80,Zinn und Waren daraus,9282000,33888000,43170000
2015,1,WA81,"Andere unedle Metalle, Cermets usw.",112334000,132204000,244538000
2015,1,WA82,"Werkzeuge, Schneidwaren, Essbestecke",578083000,369472000,947555000
2015,1,WA83,Verschiedene Waren aus unedlen Metallen,549783000,346218000,896001000
2015,1,WA84,"Maschinen, Apparate, mechanische Geräte",14685543000,9351383000,24036926000
2015,1,WA85,Elektrotechnische Erzeugnisse,9027659000,8628566000,17656225000
2015,1,WA86,Schienenfahrzeuge,307751000,246070000,553821000
2015,1,WA87,"Kraftfahrzeuge, Landfahrzeuge",15115426000,6184791000,21300217000
2015,1,WA88,"Luftfahrzeuge, Raumfahrzeuge",2427611000,1938829000,4366440000
2015,1,WA89,Wasserfahrzeuge,98921000,55043000,153964000
2015,1,WA90,"Optische, photografische usw. Erzeugnisse",4084538000,2410471000,6495009000
2015,1,WA91,Uhrmacherwaren,134719000,175870000,310589000
2015,1,WA92,Musikinstrumente,41264000,43209000,84473000
2015,1,WA93,Waffen und Munition,23266000,10955000,34221000
2015,1,WA94,"Möbel, Beleuchtungskörper usw.",1061540000,1435089000,2496629000
2015,1,WA95,"Spielzeug, Spiele usw., Sportgeräte",254643000,420814000,675457000
2015,1,WA96,Verschiedene Waren,291396000,198829000,490225000
2015,1,WA97,"Kunstgegenstände, Sammlungsstücke",46768000,31127000,77895000
2015,1,WA98,Vollständige Fabrikationsanlagen,215500000,4152000,219652000
2015,1,WA99,Zusammenstellungen verschiedener Waren,1615243000,795440000,2410683000
2015,2,WA01,Lebende Tiere,108734000,151109000,259843000
2015,2,WA02,Fleisch,547246000,429551000,976797000
2015,2,WA03,"Fische, Krebs- und Weichtiere",109528000,276125000,385653000
2015,2,WA04,"Milch, Milcherzeugnisse, Eier, Honig",638612000,507844000,1146456000
2015,2,WA05,Andere Waren tierischen Ursprungs,59932000,69786000,129718000
2015,2,WA06,"Pflanzen, Waren des Blumenhandels",63349000,231259000,294608000
2015,2,WA07,"Gemüse, Pflanzen für Ernährung",76741000,460916000,537657000
2015,2,WA08,Genießbare Früchte und Nüsse,143182000,610065000,753247000
2015,2,WA09,"Kaffee, Tee, Mate, Gewürze",207019000,371225000,578244000
2015,2,WA10,Getreide,341522000,266082000,607604000
2015,2,WA11,"Müllereierzeugnisse, Malz usw.",116890000,39924000,156814000
2015,2,WA12,"Ölsamen usw., Heilpflanzen usw.",144196000,341418000,485614000
2015,2,WA13,"Schellack, Gummen, Harz, Pflanzensaft",44925000,37759000,82684000
2015,2,WA14,Flechtstoffe usw. pflanzlichen Ursprungs,755000,2935000,3690000
2015,2,WA15,"Tierische und pflanzliche Fette, Öle, Wachs",221330000,264420000,485750000
2015,2,WA16,"Zubereitungen von Fleisch, Fisch usw.",208259000,169883000,378142000
2015,2,WA17,Zucker und Zuckerwaren,133853000,122874000,256727000
2015,2,WA18,Kakao und Zubereitungen aus Kakao,396072000,345180000,741252000
2015,2,WA19,"Zubereitungen aus Getreide usw., Backwaren",419276000,285378000,704654000
2015,2,WA20,"Zubereitungen von Gemüse, Früchten usw.",182048000,357833000,539881000
2015,2,WA21,Verschiedene Lebensmittelzubereitungen,393927000,217880000,611807000
2015,2,WA22,"Getränke, alkoholhaltige Flüssigkeiten, Essig",358837000,435363000,794200000
2015,2,WA23,"Rückstände der Lebensmittelindustrie, Futter",313969000,262125000,576094000
2015,2,WA24,Tabak,333597000,151833000,485430000
2015,2,WA25,"Salz, Schwefel, Steine, Erden usw.",148542000,139916000,288458000
2015,2,WA26,"Erze, Schlacken, Aschen",21880000,555052000,576932000
2015,2,WA27,Mineralische Brennstoffe usw.,2107521000,7137567000,9245088000
2015,2,WA28,Anorganische chemische Erzeugnisse,651310000,503632000,1154942000
2015,2,WA29,Organische chemische Erzeugnisse,1942872000,2432781000,4375653000
2015,2,WA30,Pharmazeutische Erzeugnisse,4851940000,2906437000,7758377000
2015,2,WA31,Düngemittel,240179000,150529000,390708000
2015,2,WA32,"Gerb- und Farbstoffe, Farben, Lacke usw.",812483000,471624000,1284107000
2015,2,WA33,"Etherische Öle, Riech-, Schönheitsmittel",690951000,482332000,1173283000
2015,2,WA34,"Seifen, Waschmittel usw.",541543000,274440000,815983000
2015,2,WA35,"Eiweißstoffe, Klebstoffe, Enzyme",247177000,166570000,413747000
2015,2,WA36,"Sprengstoffe, pyrotechnische Artikel usw.",18601000,13324000,31925000
2015,2,WA37,Photochemische Erzeugnisse,88597000,57918000,146515000
2015,2,WA38,Verschiedene Erzeugnisse der Chemischen Industrie,1720933000,1027929000,2748862000
2015,2,WA39,Kunststoffe und Waren daraus,4400843000,2813858000,7214701000
2015,2,WA40,Kautschuk und Waren daraus,1144750000,1092387000,2237137000
2015,2,WA41,"Häute, Felle, Leder",94066000,72957000,167023000
2015,2,WA42,"Lederwaren, Sattlerwaren",152261000,335546000,487807000
2015,2,WA43,"Pelzfelle, künstliches Pelzwerk",10035000,9574000,19609000
2015,2,WA44,"Holz, Holzwaren, Holzkohle",554774000,584591000,1139365000
2015,2,WA45,"Kork, Korkwaren",2125000,6763000,8888000
2015,2,WA46,"Flechtwaren, Korbmacherwaren",3672000,11808000,15480000
2015,2,WA47,"Halbstoffe aus Holz usw., Papierabfall",93844000,283719000,377563000
2015,2,WA48,"Papier, Pappe und Waren daraus",1334281000,979980000,2314261000
2015,2,WA49,"Bücher, Zeitungen, Bilddrucke usw.",330765000,171183000,501948000
2015,2,WA50,Seide,4336000,4693000,9029000
2015,2,WA51,"Wolle, feine und grobe Tierhaare",45834000,49062000,94896000
2015,2,WA52,Baumwolle,72751000,74752000,147503000
2015,2,WA53,"Andere pflanzliche Spinnstoffe, Papiergarn",3110000,4879000,7989000
2015,2,WA54,Synthetisches oder künstliches Filament,158111000,120097000,278208000
2015,2,WA55,Synthetische oder künstliche Spinnfaser,154691000,124559000,279250000
2015,2,WA56,"Watte, Filz, Vliesstoff usw., Tauwerk",189893000,101855000,291748000
2015,2,WA57,"Teppiche, Fußbodenbelag aus Spinnstoff",45125000,93347000,138472000
2015,2,WA58,"Spezialgewebe, Spitzen, Tapisserien",37681000,22510000,60191000
2015,2,WA59,"Getränkte, bestrichene usw. Gewebe",173826000,92293000,266119000
2015,2,WA60,Gewirke und Gestricke,62336000,36541000,98877000
2015,2,WA61,"Bekleidung usw. aus Gewirken, Gestricken",592713000,1219423000,1812136000
2015,2,WA62,"Andere Bekleidung, Bekleidungszubehör",725833000,1396729000,2122562000
2015,2,WA63,"Andere Konfektion, Spinnstoffwaren usw.",193512000,294510000,488022000
2015,2,WA64,"Schuhe, Gamaschen, ähnliche Waren",482571000,954977000,1437548000
2015,2,WA65,Kopfbedeckungen und Teile davon,30943000,46016000,76959000
2015,2,WA66,"Schirme, Gehstöcke usw., Peitschen",9449000,29876000,39325000
2015,2,WA67,"Zugerichtete Federn, Daunen, künstliche Blumen",10348000,14604000,24952000
2015,2,WA68,"Waren aus Steinen, Gips, Zement usw.",311997000,237088000,549085000
2015,2,WA69,Keramische Waren,229040000,195952000,424992000
2015,2,WA70,Glas und Glaswaren,451756000,374019000,825775000
2015,2,WA71,"Perlen, Edelsteine, Edelmetalle",1100597000,1475871000,2576468000
2015,2,WA72,Eisen und Stahl,1839505000,1933478000,3772983000
2015,2,WA73,Waren aus Eisen oder Stahl,2135615000,1507471000,3643086000
2015,2,WA74,Kupfer und Waren daraus,808640000,735879000,1544519000
2015,2,WA75,Nickel und Waren daraus,99651000,131698000,231349000
2015,2,WA76,Aluminium und Waren daraus,1152956000,1298234000,2451190000
2015,2,WA78,Blei und Waren daraus,31790000,26703000,58493000
2015,2,WA79,Zink und Waren daraus,48909000,95064000,143973000
2015,2,WA80,Zinn und Waren daraus,9806000,28707000,38513000
2015,2,WA81,"Andere unedle Metalle, Cermets usw.",121046000,142957000,264003000
2015,2,WA82,"Werkzeuge, Schneidwaren, Essbestecke",632411000,390279000,1022690000
2015,2,WA83,Verschiedene Waren aus unedlen Metallen,573771000,354082000,927853000
2015,2,WA84,"Maschinen, Apparate, mechanische Geräte",15626397000,9437080000,25063477000
2015,2,WA85,Elektrotechnische Erzeugnisse,9256904000,8583997000,17840901000
2015,2,WA86,Schienenfahrzeuge,331054000,198359000,529413000
2015,2,WA87,"Kraftfahrzeuge, Landfahrzeuge",17984373000,7016488000,25000861000
2015,2,WA88,"Luftfahrzeuge, Raumfahrzeuge",3430708000,2435065000,5865773000
2015,2,WA89,Wasserfahrzeuge,75297000,41055000,116352000
2015,2,WA90,"Optische, photografische usw. Erzeugnisse",4303720000,2532045000,6835765000
2015,2,WA91,Uhrmacherwaren,164227000,179869000,344096000
2015,2,WA92,Musikinstrumente,41651000,40874000,82525000
2015,2,WA93,Waffen und Munition,30645000,15786000,46431000
2015,2,WA94,"Möbel, Beleuchtungskörper usw.",1187087000,1518040000,2705127000
2015,2,WA95,"Spielzeug, Spiele usw., Sportgeräte",287394000,436646000,724040000
2015,2,WA96,Verschiedene Waren,273953000,202030000,475983000
2015,2,WA97,"Kunstgegenstände, Sammlungsstücke",50637000,41434000,92071000
2015,2,WA98,Vollständige Fabrikationsanlagen,188492000,2238000,190730000
2015,2,WA99,Zusammenstellungen verschiedener Waren,1825433000,791996000,2617429000
2015,3,WA01,Lebende Tiere,115148000,151149000,266297000
2015,3,WA02,Fleisch,653973000,567325000,1221298000
2015,3,WA03,"Fische, Krebs- und Weichtiere",124395000,329829000,454224000
2015,3,WA04,"Milch, Milcherzeugnisse, Eier, Honig",758893000,632676000,1391569000
2015,3,WA05,Andere Waren tierischen Ursprungs,72783000,82128000,154911000
2015,3,WA06,"Pflanzen, Waren des Blumenhandels",110002000,333447000,443449000
2015,3,WA07,"Gemüse, Pflanzen für Ernährung",89030000,599339000,688369000
2015,3,WA08,Genießbare Früchte und Nüsse,141526000,735721000,877247000
2015,3,WA09,"Kaffee, Tee, Mate, Gewürze",242287000,397949000,640236000
2015,3,WA10,Getreide,409191000,286782000,695973000
2015,3,WA11,"Müllereierzeugnisse, Malz usw.",121973000,43672000,165645000
2015,3,WA12,"Ölsamen usw., Heilpflanzen usw.",152367000,377514000,529881000
2015,3,WA13,"Schellack, Gummen, Harz, Pflanzensaft",49881000,46374000,96255000
2015,3,WA14,Flechtstoffe usw. pflanzlichen Ursprungs,639000,3139000,3778000
2015,3,WA15,"Tierische und pflanzliche Fette, Öle, Wachs",218405000,294650000,513055000
2015,3,WA16,"Zubereitungen von Fleisch, Fisch usw.",253561000,202083000,455644000
2015,3,WA17,Zucker und Zuckerwaren,150006000,132226000,282232000
2015,3,WA18,Kakao und Zubereitungen aus Kakao,356989000,320591000,677580000
2015,3,WA19,"Zubereitungen aus Getreide usw., Backwaren",471707000,325776000,797483000
2015,3,WA20,"Zubereitungen von Gemüse, Früchten usw.",214935000,413774000,628709000
2015,3,WA21,Verschiedene Lebensmittelzubereitungen,439046000,256953000,695999000
2015,3,WA22,"Getränke, alkoholhaltige Flüssigkeiten, Essig",449633000,537252000,986885000
2015,3,WA23,"Rückstände der Lebensmittelindustrie, Futter",335714000,320558000,656272000
2015,3,WA24,Tabak,361191000,174668000,535859000
2015,3,WA25,"Salz, Schwefel, Steine, Erden usw.",182598000,154297000,336895000
2015,3,WA26,"Erze, Schlacken, Aschen",27758000,563045000,590803000
2015,3,WA27,Mineralische Brennstoffe usw.,2381329000,7911573000,10292902000
2015,3,WA28,Anorganische chemische Erzeugnisse,792899000,555733000,1348632000
2015,3,WA29,Organische chemische Erzeugnisse,2161201000,2145439000,4306640000
2015,3,WA30,Pharmazeutische Erzeugnisse,5778941000,3545800000,9324741000
2015,3,WA31,Düngemittel,267467000,179104000,446571000
2015,3,WA32,"Gerb- und Farbstoffe, Farben, Lacke usw.",983232000,525795000,1509027000
2015,3,WA33,"Etherische Öle, Riech-, Schönheitsmittel",761746000,518343000,1280089000
2015,3,WA34,"Seifen, Waschmittel usw.",600170000,314482000,914652000
2015,3,WA35,"Eiweißstoffe, Klebstoffe, Enzyme",271487000,175737000,447224000
2015,3,WA36,"Sprengstoffe, pyrotechnische Artikel usw.",25170000,15488000,40658000
2015,3,WA37,Photochemische Erzeugnisse,108166000,70859000,179025000
2015,3,WA38,Verschiedene Erzeugnisse der Chemischen Industrie,1901638000,1143030000,3044668000
2015,3,WA39,Kunststoffe und Waren daraus,4806730000,2988375000,7795105000
2015,3,WA40,Kautschuk und Waren daraus,1269035000,1214161000,2483196000
2015,3,WA41,"Häute, Felle, Leder",99470000,79965000,179435000
2015,3,WA42,"Lederwaren, Sattlerwaren",157128000,357081000,514209000
2015,3,WA43,"Pelzfelle, künstliches Pelzwerk",7993000,9599000,17592000
2015,3,WA44,"Holz, Holzwaren, Holzkohle",606846000,638616000,1245462000
2015,3,WA45,"Kork, Korkwaren",2944000,11365000,14309000
2015,3,WA46,"Flechtwaren, Korbmacherwaren",4257000,13014000,17271000
2015,3,WA47,"Halbstoffe aus Holz usw., Papierabfall",107596000,305094000,412690000
2015,3,WA48,"Papier, Pappe und Waren daraus",1472240000,1005054000,2477294000
2015,3,WA49,"Bücher, Zeitungen, Bilddrucke usw.",370357000,189632000,559989000
2015,3,WA50,Seide,5658000,6458000,12116000
2015,3,WA51,"Wolle, feine und grobe Tierhaare",56229000,60619000,116848000
2015,3,WA52,Baumwolle,76598000,79795000,156393000
2015,3,WA53,"Andere pflanzliche Spinnstoffe, Papiergarn",3288000,6112000,9400000
2015,3,WA54,Synthetisches oder künstliches Filament,171302000,141457000,312759000
2015,3,WA55,Synthetische oder künstliche Spinnfaser,176175000,137721000,313896000
2015,3,WA56,"Watte, Filz, Vliesstoff usw., Tauwerk",205630000,114999000,320629000
2015,3,WA57,"Teppiche, Fußbodenbelag aus Spinnstoff",42121000,89642000,131763000
2015,3,WA58,"Spezialgewebe, Spitzen, Tapisserien",39699000,23973000,63672000
2015,3,WA59,"Getränkte, bestrichene usw. Gewebe",189279000,99428000,288707000
2015,3,WA60,Gewirke und Gestricke,71721000,41639000,113360000
2015,3,WA61,"Bekleidung usw. aus Gewirken, Gestricken",616863000,1245462000,1862325000
2015,3,WA62,"Andere Bekleidung, Bekleidungszubehör",745576000,1372406000,2117982000
2015,3,WA63,"Andere Konfektion, Spinnstoffwaren usw.",221871000,322976000,544847000
2015,3,WA64,"Schuhe, Gamaschen, ähnliche Waren",472664000,918210000,1390874000
2015,3,WA65,Kopfbedeckungen und Teile davon,30466000,45189000,75655000
2015,3,WA66,"Schirme, Gehstöcke usw., Peitschen",8578000,30177000,38755000
2015,3,WA67,"Zugerichtete Federn, Daunen, künstliche Blumen",9765000,12332000,22097000
2015,3,WA68,"Waren aus Steinen, Gips, Zement usw.",365415000,277908000,643323000
2015,3,WA69,Keramische Waren,263804000,229479000,493283000
2015,3,WA70,Glas und Glaswaren,519221000,407480000,926701000
2015,3,WA71,"Perlen, Edelsteine, Edelmetalle",955703000,1234678000,2190381000
2015,3,WA72,Eisen und Stahl,1978170000,2156368000,4134538000
2015,3,WA73,Waren aus Eisen oder Stahl,2370690000,1581630000,3952320000
2015,3,WA74,Kupfer und Waren daraus,905058000,854536000,1759594000
2015,3,WA75,Nickel und Waren daraus,110077000,131604000,241681000
2015,3,WA76,Aluminium und Waren daraus,1275663000,1330141000,2605804000
2015,3,WA78,Blei und Waren daraus,34356000,20745000,55101000
2015,3,WA79,Zink und Waren daraus,51250000,104607000,155857000
2015,3,WA80,Zinn und Waren daraus,9897000,27210000,37107000
2015,3,WA81,"Andere unedle Metalle, Cermets usw.",129722000,148116000,277838000
2015,3,WA82,"Werkzeuge, Schneidwaren, Essbestecke",692558000,420800000,1113358000
2015,3,WA83,Verschiedene Waren aus unedlen Metallen,612335000,373645000,985980000
2015,3,WA84,"Maschinen, Apparate, mechanische Geräte",18364910000,10970800000,29335710000
2015,3,WA85,Elektrotechnische Erzeugnisse,10244157000,9534368000,19778525000
2015,3,WA86,Schienenfahrzeuge,262583000,195712000,458295000
2015,3,WA87,"Kraftfahrzeuge, Landfahrzeuge",20610411000,8053661000,28664072000
2015,3,WA88,"Luftfahrzeuge, Raumfahrzeuge",2835921000,2991950000,5827871000
2015,3,WA89,Wasserfahrzeuge,1195796000,149009000,1344805000
2015,3,WA90,"Optische, photografische usw. Erzeugnisse",5056065000,2932045000,7988110000
2015,3,WA91,Uhrmacherwaren,167055000,193815000,360870000
2015,3,WA92,Musikinstrumente,47443000,51401000,98844000
2015,3,WA93,Waffen und Munition,43019000,17538000,60557000
2015,3,WA94,"Möbel, Beleuchtungskörper usw.",1281200000,1619048000,2900248000
2015,3,WA95,"Spielzeug, Spiele usw., Sportgeräte",305311000,457791000,763102000
2015,3,WA96,Verschiedene Waren,316302000,220440000,536742000
2015,3,WA97,"Kunstgegenstände, Sammlungsstücke",60713000,37546000,98259000
2015,3,WA98,Vollständige Fabrikationsanlagen,233542000,3758000,237300000
2015,3,WA99,Zusammenstellungen verschiedener Waren,1764987000,887951000,2652938000
2015,4,WA01,Lebende Tiere,127945000,148134000,276079000
2015,4,WA02,Fleisch,551649000,472106000,1023755000
2015,4,WA03,"Fische, Krebs- und Weichtiere",109490000,264710000,374200000
2015,4,WA04,"Milch, Milcherzeugnisse, Eier, Honig",679811000,526672000,1206483000
2015,4,WA05,Andere Waren tierischen Ursprungs,59031000,61388000,120419000
2015,4,WA06,"Pflanzen, Waren des Blumenhandels",118110000,318902000,437012000
2015,4,WA07,"Gemüse, Pflanzen für Ernährung",83637000,609501000,693138000
2015,4,WA08,Genießbare Früchte und Nüsse,140605000,761418000,902023000
2015,4,WA09,"Kaffee, Tee, Mate, Gewürze",212178000,400129000,612307000
2015,4,WA10,Getreide,383484000,214367000,597851000
2015,4,WA11,"Müllereierzeugnisse, Malz usw.",118502000,42079000,160581000
2015,4,WA12,"Ölsamen usw., Heilpflanzen usw.",78867000,380723000,459590000
2015,4,WA13,"Schellack, Gummen, Harz, Pflanzensaft",48781000,43466000,92247000
2015,4,WA14,Flechtstoffe usw. pflanzlichen Ursprungs,809000,2995000,3804000
2015,4,WA15,"Tierische und pflanzliche Fette, Öle, Wachs",215534000,273387000,488921000
2015,4,WA16,"Zubereitungen von Fleisch, Fisch usw.",223882000,201273000,425155000
2015,4,WA17,Zucker und Zuckerwaren,134951000,126783000,261734000
2015,4,WA18,Kakao und Zubereitungen aus Kakao,273989000,312804000,586793000
2015,4,WA19,"Zubereitungen aus Getreide usw., Backwaren",426883000,302419000,729302000
2015,4,WA20,"Zubereitungen von Gemüse, Früchten usw.",212508000,373237000,585745000
2015,4,WA21,Verschiedene Lebensmittelzubereitungen,434629000,255077000,689706000
2015,4,WA22,"Getränke, alkoholhaltige Flüssigkeiten, Essig",446549000,557331000,1003880000
2015,4,WA23,"Rückstände der Lebensmittelindustrie, Futter",321088000,282762000,603850000
2015,4,WA24,Tabak,333454000,162324000,495778000
2015,4,WA25,"Salz, Schwefel, Steine, Erden usw.",173889000,166721000,340610000
2015,4,WA26,"Erze, Schlacken, Aschen",32139000,557168000,589307000
2015,4,WA27,Mineralische Brennstoffe usw.,2270499000,7801289000,10071788000
2015,4,WA28,Anorganische chemische Erzeugnisse,666952000,561058000,1228010000
2015,4,WA29,Organische chemische Erzeugnisse,2092272000,2528868000,4621140000
2015,4,WA30,Pharmazeutische Erzeugnisse,5415145000,3411630000,8826775000
2015,4,WA31,Düngemittel,233413000,116341000,349754000
2015,4,WA32,"Gerb- und Farbstoffe, Farben, Lacke usw.",950464000,508354000,1458818000
2015,4,WA33,"Etherische Öle, Riech-, Schönheitsmittel",690725000,489592000,1180317000
2015,4,WA34,"Seifen, Waschmittel usw.",558645000,289795000,848440000
2015,4,WA35,"Eiweißstoffe, Klebstoffe, Enzyme",270749000,179513000,450262000
2015,4,WA36,"Sprengstoffe, pyrotechnische Artikel usw.",13751000,16051000,29802000
2015,4,WA37,Photochemische Erzeugnisse,104756000,71043000,175799000
2015,4,WA38,Verschiedene Erzeugnisse der Chemischen Industrie,1718928000,1007020000,2725948000
2015,4,WA39,Kunststoffe und Waren daraus,4730874000,2967251000,7698125000
2015,4,WA40,Kautschuk und Waren daraus,1207514000,1033647000,2241161000
2015,4,WA41,"Häute, Felle, Leder",98996000,78643000,177639000
2015,4,WA42,"Lederwaren, Sattlerwaren",152628000,243306000,395934000
2015,4,WA43,"Pelzfelle, künstliches Pelzwerk",10231000,8519000,18750000
2015,4,WA44,"Holz, Holzwaren, Holzkohle",621886000,622255000,1244141000
2015,4,WA45,"Kork, Korkwaren",2392000,5365000,7757000
2015,4,WA46,"Flechtwaren, Korbmacherwaren",4324000,10105000,14429000
2015,4,WA47,"Halbstoffe aus Holz usw., Papierabfall",95212000,317296000,412508000
2015,4,WA48,"Papier, Pappe und Waren daraus",1457306000,1010662000,2467968000
2015,4,WA49,"Bücher, Zeitungen, Bilddrucke usw.",331907000,175307000,507214000
2015,4,WA50,Seide,6691000,6165000,12856000
2015,4,WA51,"Wolle, feine und grobe Tierhaare",46925000,57017000,103942000
2015,4,WA52,Baumwolle,78678000,80313000,158991000
2015,4,WA53,"Andere pflanzliche Spinnstoffe, Papiergarn",3025000,5035000,8060000
2015,4,WA54,Synthetisches oder künstliches Filament,167305000,131379000,298684000
2015,4,WA55,Synthetische oder künstliche Spinnfaser,165197000,128599000,293796000
2015,4,WA56,"Watte, Filz, Vliesstoff usw., Tauwerk",194659000,111207000,305866000
2015,4,WA57,"Teppiche, Fußbodenbelag aus Spinnstoff",38829000,80310000,119139000
2015,4,WA58,"Spezialgewebe, Spitzen, Tapisserien",40479000,22391000,62870000
2015,4,WA59,"Getränkte, bestrichene usw. Gewebe",181652000,91656000,273308000
2015,4,WA60,Gewirke und Gestricke,74551000,44547000,119098000
2015,4,WA61,"Bekleidung usw. aus Gewirken, Gestricken",479883000,1030936000,1510819000
2015,4,WA62,"Andere Bekleidung, Bekleidungszubehör",539592000,1047609000,1587201000
2015,4,WA63,"Andere Konfektion, Spinnstoffwaren usw.",205194000,275373000,480567000
2015,4,WA64,"Schuhe, Gamaschen, ähnliche Waren",312045000,606257000,918302000
2015,4,WA65,Kopfbedeckungen und Teile davon,26989000,30456000,57445000
2015,4,WA66,"Schirme, Gehstöcke usw., Peitschen",7957000,17763000,25720000
2015,4,WA67,"Zugerichtete Federn, Daunen, künstliche Blumen",6566000,7975000,14541000
2015,4,WA68,"Waren aus Steinen, Gips, Zement usw.",347474000,235494000,582968000
2015,4,WA69,Keramische Waren,259818000,204644000,464462000
2015,4,WA70,Glas und Glaswaren,489731000,377060000,866791000
2015,4,WA71,"Perlen, Edelsteine, Edelmetalle",997128000,1287264000,2284392000
2015,4,WA72,Eisen und Stahl,1896162000,1958638000,3854800000
2015,4,WA73,Waren aus Eisen oder Stahl,2199682000,1506018000,3705700000
2015,4,WA74,Kupfer und Waren daraus,925893000,819129000,1745022000
2015,4,WA75,Nickel und Waren daraus,100649000,130603000,231252000
2015,4,WA76,Aluminium und Waren daraus,1197766000,1310384000,2508150000
2015,4,WA78,Blei und Waren daraus,28214000,25025000,53239000
2015,4,WA79,Zink und Waren daraus,52851000,112996000,165847000
2015,4,WA80,Zinn und Waren daraus,9138000,37823000,46961000
2015,4,WA81,"Andere unedle Metalle, Cermets usw.",122055000,137414000,259469000
2015,4,WA82,"Werkzeuge, Schneidwaren, Essbestecke",645330000,354376000,999706000
2015,4,WA83,Verschiedene Waren aus unedlen Metallen,579218000,339952000,919170000
2015,4,WA84,"Maschinen, Apparate, mechanische Geräte",16632015000,10032596000,26664611000
2015,4,WA85,Elektrotechnische Erzeugnisse,9516198000,9129961000,18646159000
2015,4,WA86,Schienenfahrzeuge,233285000,193010000,426295000
2015,4,WA87,"Kraftfahrzeuge, Landfahrzeuge",18514145000,7677207000,26191352000
2015,4,WA88,"Luftfahrzeuge, Raumfahrzeuge",4486141000,2127813000,6613954000
2015,4,WA89,Wasserfahrzeuge,204348000,42501000,246849000
2015,4,WA90,"Optische, photografische usw. Erzeugnisse",4482166000,2741225000,7223391000
2015,4,WA91,Uhrmacherwaren,180973000,218318000,399291000
2015,4,WA92,Musikinstrumente,46776000,42813000,89589000
2015,4,WA93,Waffen und Munition,34232000,15826000,50058000
2015,4,WA94,"Möbel, Beleuchtungskörper usw.",1215023000,1336856000,2551879000
2015,4,WA95,"Spielzeug, Spiele usw., Sportgeräte",252848000,322612000,575460000
2015,4,WA96,Verschiedene Waren,306053000,182795000,488848000
2015,4,WA97,"Kunstgegenstände, Sammlungsstücke",45820000,28514000,74334000
2015,4,WA98,Vollständige Fabrikationsanlagen,202906000,1751000,204657000
2015,4,WA99,Zusammenstellungen verschiedener Waren,1710837000,828978000,2539815000
2015,5,WA01,Lebende Tiere,133106000,168867000,301973000
2015,5,WA02,Fleisch,579019000,497982000,1077001000
2015,5,WA03,"Fische, Krebs- und Weichtiere",103023000,277001000,380024000
2015,5,WA04,"Milch, Milcherzeugnisse, Eier, Honig",736883000,631013000,1367896000
2015,5,WA05,Andere Waren tierischen Ursprungs,69798000,68900000,138698000
2015,5,WA06,"Pflanzen, Waren des Blumenhandels",89304000,302509000,391813000
2015,5,WA07,"Gemüse, Pflanzen für Ernährung",91900000,515793000,607693000
2015,5,WA08,Genießbare Früchte und Nüsse,153779000,754897000,908676000
2015,5,WA09,"Kaffee, Tee, Mate, Gewürze",209994000,356920000,566914000
2015,5,WA10,Getreide,331791000,176231000,508022000
2015,5,WA11,"Müllereierzeugnisse, Malz usw.",112669000,39590000,152259000
2015,5,WA12,"Ölsamen usw., Heilpflanzen usw.",66300000,348872000,415172000
2015,5,WA13,"Schellack, Gummen, Harz, Pflanzensaft",46824000,39660000,86484000
2015,5,WA14,Flechtstoffe usw. pflanzlichen Ursprungs,790000,3716000,4506000
2015,5,WA15,"Tierische und pflanzliche Fette, Öle, Wachs",219064000,303466000,522530000
2015,5,WA16,"Zubereitungen von Fleisch, Fisch usw.",231754000,191709000,423463000
2015,5,WA17,Zucker und Zuckerwaren,138393000,125672000,264065000
2015,5,WA18,Kakao und Zubereitungen aus Kakao,334389000,299805000,634194000
2015,5,WA19,"Zubereitungen aus Getreide usw., Backwaren",432269000,280565000,712834000
2015,5,WA20,"Zubereitungen von Gemüse, Früchten usw.",205445000,365681000,571126000
2015,5,WA21,Verschiedene Lebensmittelzubereitungen,419335000,245698000,665033000
2015,5,WA22,"Getränke, alkoholhaltige Flüssigkeiten, Essig",472767000,524472000,997239000
2015,5,WA23,"Rückstände der Lebensmittelindustrie, Futter",299365000,296072000,595437000
2015,5,WA24,Tabak,361733000,135876000,497609000
2015,5,WA25,"Salz, Schwefel, Steine, Erden usw.",167618000,143837000,311455000
2015,5,WA26,"Erze, Schlacken, Aschen",29209000,687579000,716788000
2015,5,WA27,Mineralische Brennstoffe usw.,2264750000,7976198000,10240948000
2015,5,WA28,Anorganische chemische Erzeugnisse,672891000,523717000,1196608000
2015,5,WA29,Organische chemische Erzeugnisse,1967370000,2167897000,4135267000
2015,5,WA30,Pharmazeutische Erzeugnisse,5010261000,3065411000,8075672000
2015,5,WA31,Düngemittel,194047000,106101000,300148000
2015,5,WA32,"Gerb- und Farbstoffe, Farben, Lacke usw.",866503000,455017000,1321520000
2015,5,WA33,"Etherische Öle, Riech-, Schönheitsmittel",664477000,480340000,1144817000
2015,5,WA34,"Seifen, Waschmittel usw.",545992000,284572000,830564000
2015,5,WA35,"Eiweißstoffe, Klebstoffe, Enzyme",249607000,172720000,422327000
2015,5,WA36,"Sprengstoffe, pyrotechnische Artikel usw.",18381000,15467000,33848000
2015,5,WA37,Photochemische Erzeugnisse,89912000,58372000,148284000
2015,5,WA38,Verschiedene Erzeugnisse der Chemischen Industrie,1654424000,985440000,2639864000
2015,5,WA39,Kunststoffe und Waren daraus,4477925000,3027639000,7505564000
2015,5,WA40,Kautschuk und Waren daraus,1128352000,1097659000,2226011000
2015,5,WA41,"Häute, Felle, Leder",89441000,75255000,164696000
2015,5,WA42,"Lederwaren, Sattlerwaren",125204000,301055000,426259000
2015,5,WA43,"Pelzfelle, künstliches Pelzwerk",11368000,12106000,23474000
2015,5,WA44,"Holz, Holzwaren, Holzkohle",590775000,640283000,1231058000
2015,5,WA45,"Kork, Korkwaren",2109000,8636000,10745000
2015,5,WA46,"Flechtwaren, Korbmacherwaren",2943000,9333000,12276000
2015,5,WA47,"Halbstoffe aus Holz usw., Papierabfall",116848000,297383000,414231000
2015,5,WA48,"Papier, Pappe und Waren daraus",1354090000,971116000,2325206000
2015,5,WA49,"Bücher, Zeitungen, Bilddrucke usw.",317527000,171016000,488543000
2015,5,WA50,Seide,6101000,5392000,11493000
2015,5,WA51,"Wolle, feine und grobe Tierhaare",55293000,54624000,109917000
2015,5,WA52,Baumwolle,77764000,75543000,153307000
2015,5,WA53,"Andere pflanzliche Spinnstoffe, Papiergarn",2493000,5202000,7695000
2015,5,WA54,Synthetisches oder künstliches Filament,159321000,132594000,291915000
2015,5,WA55,Synthetische oder künstliche Spinnfaser,153523000,126203000,279726000
2015,5,WA56,"Watte, Filz, Vliesstoff usw., Tauwerk",186831000,111165000,297996000
2015,5,WA57,"Teppiche, Fußbodenbelag aus Spinnstoff",39416000,79282000,118698000
2015,5,WA58,"Spezialgewebe, Spitzen, Tapisserien",44447000,22030000,66477000
2015,5,WA59,"Getränkte, bestrichene usw. Gewebe",174527000,95545000,270072000
2015,5,WA60,Gewirke und Gestricke,70764000,43755000,114519000
2015,5,WA61,"Bekleidung usw. aus Gewirken, Gestricken",452859000,984204000,1437063000
2015,5,WA62,"Andere Bekleidung, Bekleidungszubehör",449157000,970583000,1419740000
2015,5,WA63,"Andere Konfektion, Spinnstoffwaren usw.",204977000,284230000,489207000
2015,5,WA64,"Schuhe, Gamaschen, ähnliche Waren",280292000,620951000,901243000
2015,5,WA65,Kopfbedeckungen und Teile davon,24487000,31627000,56114000
2015,5,WA66,"Schirme, Gehstöcke usw., Peitschen",9398000,19317000,28715000
2015,5,WA67,"Zugerichtete Federn, Daunen, künstliche Blumen",6297000,10428000,16725000
2015,5,WA68,"Waren aus Steinen, Gips, Zement usw.",341795000,245320000,587115000
2015,5,WA69,Keramische Waren,250550000,218767000,469317000
2015,5,WA70,Glas und Glaswaren,472427000,379481000,851908000
2015,5,WA71,"Perlen, Edelsteine, Edelmetalle",822599000,1100910000,1923509000
2015,5,WA72,Eisen und Stahl,1795195000,2000870000,3796065000
2015,5,WA73,Waren aus Eisen oder Stahl,2066340000,1466440000,3532780000
2015,5,WA74,Kupfer und Waren daraus,846875000,856168000,1703043000
2015,5,WA75,Nickel und Waren daraus,97933000,125324000,223257000
2015,5,WA76,Aluminium und Waren daraus,1186720000,1296375000,2483095000
2015,5,WA78,Blei und Waren daraus,40819000,22720000,63539000
2015,5,WA79,Zink und Waren daraus,52218000,121981000,174199000
2015,5,WA80,Zinn und Waren daraus,8524000,27764000,36288000
2015,5,WA81,"Andere unedle Metalle, Cermets usw.",120267000,126873000,247140000
2015,5,WA82,"Werkzeuge, Schneidwaren, Essbestecke",639647000,385742000,1025389000
2015,5,WA83,Verschiedene Waren aus unedlen Metallen,578140000,332709000,910849000
2015,5,WA84,"Maschinen, Apparate, mechanische Geräte",16280493000,9554044000,25834537000
2015,5,WA85,Elektrotechnische Erzeugnisse,9305626000,8552581000,17858207000
2015,5,WA86,Schienenfahrzeuge,237716000,171941000,409657000
2015,5,WA87,"Kraftfahrzeuge, Landfahrzeuge",17234848000,7472765000,24707613000
2015,5,WA88,"Luftfahrzeuge, Raumfahrzeuge",3363300000,1675579000,5038879000
2015,5,WA89,Wasserfahrzeuge,500786000,85064000,585850000
2015,5,WA90,"Optische, photografische usw. Erzeugnisse",4500323000,2598890000,7099213000
2015,5,WA91,Uhrmacherwaren,170968000,206687000,377655000
2015,5,WA92,Musikinstrumente,42277000,40013000,82290000
2015,5,WA93,Waffen und Munition,34052000,15263000,49315000
2015,5,WA94,"Möbel, Beleuchtungskörper usw.",1143334000,1339254000,2482588000
2015,5,WA95,"Spielzeug, Spiele usw., Sportgeräte",254115000,405406000,659521000
2015,5,WA96,Verschiedene Waren,292336000,202729000,495065000
2015,5,WA97,"Kunstgegenstände, Sammlungsstücke",67683000,59904000,127587000
2015,5,WA98,Vollständige Fabrikationsanlagen,218046000,7457000,225503000
2015,5,WA99,Zusammenstellungen verschiedener Waren,1574637000,847456000,2422093000
2015,6,WA01,Lebende Tiere,136730000,152261000,288991000
2015,6,WA02,Fleisch,604572000,499360000,1103932000
2015,6,WA03,"Fische, Krebs- und Weichtiere",132876000,300270000,433146000
2015,6,WA04,"Milch, Milcherzeugnisse, Eier, Honig",730057000,535044000,1265101000
2015,6,WA05,Andere Waren tierischen Ursprungs,64053000,72344000,136397000
2015,6,WA06,"Pflanzen, Waren des Blumenhandels",61600000,200086000,261686000
2015,6,WA07,"Gemüse, Pflanzen für Ernährung",79723000,451843000,531566000
2015,6,WA08,Genießbare Früchte und Nüsse,169405000,800417000,969822000
2015,6,WA09,"Kaffee, Tee, Mate, Gewürze",227239000,373201000,600440000
2015,6,WA10,Getreide,241757000,187009000,428766000
2015,6,WA11,"Müllereierzeugnisse, Malz usw.",127323000,43976000,171299000
2015,6,WA12,"Ölsamen usw., Heilpflanzen usw.",82599000,353220000,435819000
2015,6,WA13,"Schellack, Gummen, Harz, Pflanzensaft",44981000,40017000,84998000
2015,6,WA14,Flechtstoffe usw. pflanzlichen Ursprungs,880000,3155000,4035000
2015,6,WA15,"Tierische und pflanzliche Fette, Öle, Wachs",216697000,320377000,537074000
2015,6,WA16,"Zubereitungen von Fleisch, Fisch usw.",239350000,226726000,466076000
2015,6,WA17,Zucker und Zuckerwaren,155976000,140528000,296504000
2015,6,WA18,Kakao und Zubereitungen aus Kakao,331301000,303049000,634350000
2015,6,WA19,"Zubereitungen aus Getreide usw., Backwaren",470930000,307901000,778831000
2015,6,WA20,"Zubereitungen von Gemüse, Früchten usw.",219943000,363928000,583871000
2015,6,WA21,Verschiedene Lebensmittelzubereitungen,465257000,253575000,718832000
2015,6,WA22,"Getränke, alkoholhaltige Flüssigkeiten, Essig",536435000,530783000,1067218000
2015,6,WA23,"Rückstände der Lebensmittelindustrie, Futter",351564000,323997000,675561000
2015,6,WA24,Tabak,382259000,150590000,532849000
2015,6,WA25,"Salz, Schwefel, Steine, Erden usw.",193085000,151841000,344926000
2015,6,WA26,"Erze, Schlacken, Aschen",30810000,652447000,683257000
2015,6,WA27,Mineralische Brennstoffe usw.,2474326000,8092504000,10566830000
2015,6,WA28,Anorganische chemische Erzeugnisse,726935000,631018000,1357953000
2015,6,WA29,Organische chemische Erzeugnisse,2121094000,2420721000,4541815000
2015,6,WA30,Pharmazeutische Erzeugnisse,6397681000,3696506000,10094187000
2015,6,WA31,Düngemittel,216437000,123093000,339530000
2015,6,WA32,"Gerb- und Farbstoffe, Farben, Lacke usw.",985507000,487828000,1473335000
2015,6,WA33,"Etherische Öle, Riech-, Schönheitsmittel",683666000,479091000,1162757000
2015,6,WA34,"Seifen, Waschmittel usw.",592913000,286324000,879237000
2015,6,WA35,"Eiweißstoffe, Klebstoffe, Enzyme",293439000,184333000,477772000
2015,6,WA36,"Sprengstoffe, pyrotechnische Artikel usw.",17697000,24426000,42123000
2015,6,WA37,Photochemische Erzeugnisse,105180000,65639000,170819000
2015,6,WA38,Verschiedene Erzeugnisse der Chemischen Industrie,1734929000,1020968000,2755897000
2015,6,WA39,Kunststoffe und Waren daraus,4984221000,3134489000,8118710000
2015,6,WA40,Kautschuk und Waren daraus,1283343000,1133726000,2417069000
2015,6,WA41,"Häute, Felle, Leder",87552000,68675000,156227000
2015,6,WA42,"Lederwaren, Sattlerwaren",164824000,351831000,516655000
2015,6,WA43,"Pelzfelle, künstliches Pelzwerk",13109000,13558000,26667000
2015,6,WA44,"Holz, Holzwaren, Holzkohle",647122000,623585000,1270707000
2015,6,WA45,"Kork, Korkwaren",2632000,9000000,11632000
2015,6,WA46,"Flechtwaren, Korbmacherwaren",3201000,10280000,13481000
2015,6,WA47,"Halbstoffe aus Holz usw., Papierabfall",106369000,326022000,432391000
2015,6,WA48,"Papier, Pappe und Waren daraus",1495441000,990094000,2485535000
2015,6,WA49,"Bücher, Zeitungen, Bilddrucke usw.",346677000,180649000,527326000
2015,6,WA50,Seide,4978000,5424000,10402000
2015,6,WA51,"Wolle, feine und grobe Tierhaare",51434000,56896000,108330000
2015,6,WA52,Baumwolle,74599000,76935000,151534000
2015,6,WA53,"Andere pflanzliche Spinnstoffe, Papiergarn",3161000,6183000,9344000
2015,6,WA54,Synthetisches oder künstliches Filament,177112000,131466000,308578000
2015,6,WA55,Synthetische oder künstliche Spinnfaser,162897000,133505000,296402000
2015,6,WA56,"Watte, Filz, Vliesstoff usw., Tauwerk",202375000,114469000,316844000
2015,6,WA57,"Teppiche, Fußbodenbelag aus Spinnstoff",46420000,89618000,136038000
2015,6,WA58,"Spezialgewebe, Spitzen, Tapisserien",46558000,22287000,68845000
2015,6,WA59,"Getränkte, bestrichene usw. Gewebe",187660000,93369000,281029000
2015,6,WA60,Gewirke und Gestricke,67576000,41045000,108621000
2015,6,WA61,"Bekleidung usw. aus Gewirken, Gestricken",545067000,1185328000,1730395000
2015,6,WA62,"Andere Bekleidung, Bekleidungszubehör",535599000,1175193000,1710792000
2015,6,WA63,"Andere Konfektion, Spinnstoffwaren usw.",224804000,322077000,546881000
2015,6,WA64,"Schuhe, Gamaschen, ähnliche Waren",342638000,805338000,1147976000
2015,6,WA65,Kopfbedeckungen und Teile davon,25791000,37875000,63666000
2015,6,WA66,"Schirme, Gehstöcke usw., Peitschen",7750000,15762000,23512000
2015,6,WA67,"Zugerichtete Federn, Daunen, künstliche Blumen",7823000,13852000,21675000
2015,6,WA68,"Waren aus Steinen, Gips, Zement usw.",385231000,264453000,649684000
2015,6,WA69,Keramische Waren,274420000,237325000,511745000
2015,6,WA70,Glas und Glaswaren,521383000,408983000,930366000
2015,6,WA71,"Perlen, Edelsteine, Edelmetalle",931090000,1210576000,2141666000
2015,6,WA72,Eisen und Stahl,1960417000,2081273000,4041690000
2015,6,WA73,Waren aus Eisen oder Stahl,2283697000,1616846000,3900543000
2015,6,WA74,Kupfer und Waren daraus,913490000,789042000,1702532000
2015,6,WA75,Nickel und Waren daraus,102878000,106946000,209824000
2015,6,WA76,Aluminium und Waren daraus,1276513000,1366725000,2643238000
2015,6,WA78,Blei und Waren daraus,45035000,30279000,75314000
2015,6,WA79,Zink und Waren daraus,59355000,113438000,172793000
2015,6,WA80,Zinn und Waren daraus,9310000,29034000,38344000
2015,6,WA81,"Andere unedle Metalle, Cermets usw.",128123000,156805000,284928000
2015,6,WA82,"Werkzeuge, Schneidwaren, Essbestecke",679064000,390991000,1070055000
2015,6,WA83,Verschiedene Waren aus unedlen Metallen,609493000,372002000,981495000
2015,6,WA84,"Maschinen, Apparate, mechanische Geräte",18127690000,10216644000,28344334000
2015,6,WA85,Elektrotechnische Erzeugnisse,10375994000,9503768000,19879762000
2015,6,WA86,Schienenfahrzeuge,251817000,193799000,445616000
2015,6,WA87,"Kraftfahrzeuge, Landfahrzeuge",19258654000,8036922000,27295576000
2015,6,WA88,"Luftfahrzeuge, Raumfahrzeuge",2999543000,2011632000,5011175000
2015,6,WA89,Wasserfahrzeuge,503852000,32622000,536474000
2015,6,WA90,"Optische, photografische usw. Erzeugnisse",4940329000,2909922000,7850251000
2015,6,WA91,Uhrmacherwaren,164809000,220382000,385191000
2015,6,WA92,Musikinstrumente,47914000,43578000,91492000
2015,6,WA93,Waffen und Munition,43868000,14908000,58776000
2015,6,WA94,"Möbel, Beleuchtungskörper usw.",1301978000,1415626000,2717604000
2015,6,WA95,"Spielzeug, Spiele usw., Sportgeräte",289291000,405744000,695035000
2015,6,WA96,Verschiedene Waren,270285000,206968000,477253000
2015,6,WA97,"Kunstgegenstände, Sammlungsstücke",56395000,38520000,94915000
2015,6,WA98,Vollständige Fabrikationsanlagen,168209000,1392000,169601000
2015,6,WA99,Zusammenstellungen verschiedener Waren,1793293000,853097000,2646390000
2015,7,WA01,Lebende Tiere,133694000,153259000,286953000
2015,7,WA02,Fleisch,630995000,479348000,1110343000
2015,7,WA03,"Fische, Krebs- und Weichtiere",103097000,283389000,386486000
2015,7,WA04,"Milch, Milcherzeugnisse, Eier, Honig",714903000,571507000,1286410000
2015,7,WA05,Andere Waren tierischen Ursprungs,67114000,71730000,138844000
2015,7,WA06,"Pflanzen, Waren des Blumenhandels",49024000,157511000,206535000
2015,7,WA07,"Gemüse, Pflanzen für Ernährung",79999000,404763000,484762000
2015,7,WA08,Genießbare Früchte und Nüsse,155912000,845887000,1001799000
2015,7,WA09,"Kaffee, Tee, Mate, Gewürze",189962000,322637000,512599000
2015,7,WA10,Getreide,260244000,176307000,436551000
2015,7,WA11,"Müllereierzeugnisse, Malz usw.",126503000,42777000,169280000
2015,7,WA12,"Ölsamen usw., Heilpflanzen usw.",114705000,422997000,537702000
2015,7,WA13,"Schellack, Gummen, Harz, Pflanzensaft",50496000,41375000,91871000
2015,7,WA14,Flechtstoffe usw. pflanzlichen Ursprungs,657000,3838000,4495000
2015,7,WA15,"Tierische und pflanzliche Fette, Öle, Wachs",269122000,334941000,604063000
2015,7,WA16,"Zubereitungen von Fleisch, Fisch usw.",247064000,200804000,447868000
2015,7,WA17,Zucker und Zuckerwaren,161820000,140981000,302801000
2015,7,WA18,Kakao und Zubereitungen aus Kakao,357521000,343907000,701428000
2015,7,WA19,"Zubereitungen aus Getreide usw., Backwaren",468644000,324677000,793321000
2015,7,WA20,"Zubereitungen von Gemüse, Früchten usw.",205436000,415351000,620787000
2015,7,WA21,Verschiedene Lebensmittelzubereitungen,463516000,255170000,718686000
2015,7,WA22,"Getränke, alkoholhaltige Flüssigkeiten, Essig",523514000,610739000,1134253000
2015,7,WA23,"Rückstände der Lebensmittelindustrie, Futter",329246000,326088000,655334000
2015,7,WA24,Tabak,397493000,162539000,560032000
2015,7,WA25,"Salz, Schwefel, Steine, Erden usw.",185443000,164964000,350407000
2015,7,WA26,"Erze, Schlacken, Aschen",25941000,589424000,615365000
2015,7,WA27,Mineralische Brennstoffe usw.,2413654000,7814808000,10228462000
2015,7,WA28,Anorganische chemische Erzeugnisse,728324000,629270000,1357594000
2015,7,WA29,Organische chemische Erzeugnisse,2140980000,2334651000,4475631000
2015,7,WA30,Pharmazeutische Erzeugnisse,6111818000,3554257000,9666075000
2015,7,WA31,Düngemittel,204501000,103611000,308112000
2015,7,WA32,"Gerb- und Farbstoffe, Farben, Lacke usw.",948214000,486138000,1434352000
2015,7,WA33,"Etherische Öle, Riech-, Schönheitsmittel",809487000,630553000,1440040000
2015,7,WA34,"Seifen, Waschmittel usw.",629117000,328328000,957445000
2015,7,WA35,"Eiweißstoffe, Klebstoffe, Enzyme",270939000,187620000,458559000
2015,7,WA36,"Sprengstoffe, pyrotechnische Artikel usw.",17658000,27901000,45559000
2015,7,WA37,Photochemische Erzeugnisse,105725000,64635000,170360000
2015,7,WA38,Verschiedene Erzeugnisse der Chemischen Industrie,1715868000,1046180000,2762048000
2015,7,WA39,Kunststoffe und Waren daraus,4958044000,3273573000,8231617000
2015,7,WA40,Kautschuk und Waren daraus,1214541000,1209572000,2424113000
2015,7,WA41,"Häute, Felle, Leder",103597000,78321000,181918000
2015,7,WA42,"Lederwaren, Sattlerwaren",182339000,373355000,555694000
2015,7,WA43,"Pelzfelle, künstliches Pelzwerk",12990000,14822000,27812000
2015,7,WA44,"Holz, Holzwaren, Holzkohle",643845000,626174000,1270019000
2015,7,WA45,"Kork, Korkwaren",2609000,10429000,13038000
2015,7,WA46,"Flechtwaren, Korbmacherwaren",3891000,11372000,15263000
2015,7,WA47,"Halbstoffe aus Holz usw., Papierabfall",108566000,320264000,428830000
2015,7,WA48,"Papier, Pappe und Waren daraus",1577467000,1076881000,2654348000
2015,7,WA49,"Bücher, Zeitungen, Bilddrucke usw.",359611000,184899000,544510000
2015,7,WA50,Seide,4724000,4996000,9720000
2015,7,WA51,"Wolle, feine und grobe Tierhaare",46892000,49536000,96428000
2015,7,WA52,Baumwolle,74931000,72963000,147894000
2015,7,WA53,"Andere pflanzliche Spinnstoffe, Papiergarn",2642000,5341000,7983000
2015,7,WA54,Synthetisches oder künstliches Filament,160962000,131315000,292277000
2015,7,WA55,Synthetische oder künstliche Spinnfaser,153660000,127037000,280697000
2015,7,WA56,"Watte, Filz, Vliesstoff usw., Tauwerk",201222000,126095000,327317000
2015,7,WA57,"Teppiche, Fußbodenbelag aus Spinnstoff",42102000,85110000,127212000
2015,7,WA58,"Spezialgewebe, Spitzen, Tapisserien",45552000,23251000,68803000
2015,7,WA59,"Getränkte, bestrichene usw. Gewebe",188242000,94313000,282555000
2015,7,WA60,Gewirke und Gestricke,66562000,40036000,106598000
2015,7,WA61,"Bekleidung usw. aus Gewirken, Gestricken",668121000,1546954000,2215075000
2015,7,WA62,"Andere Bekleidung, Bekleidungszubehör",665486000,1492562000,2158048000
2015,7,WA63,"Andere Konfektion, Spinnstoffwaren usw.",220914000,320439000,541353000
2015,7,WA64,"Schuhe, Gamaschen, ähnliche Waren",463381000,1008063000,1471444000
2015,7,WA65,Kopfbedeckungen und Teile davon,26921000,41626000,68547000
2015,7,WA66,"Schirme, Gehstöcke usw., Peitschen",7335000,17458000,24793000
2015,7,WA67,"Zugerichtete Federn, Daunen, künstliche Blumen",7569000,17038000,24607000
2015,7,WA68,"Waren aus Steinen, Gips, Zement usw.",374440000,272737000,647177000
2015,7,WA69,Keramische Waren,257744000,234115000,491859000
2015,7,WA70,Glas und Glaswaren,503250000,418456000,921706000
2015,7,WA71,"Perlen, Edelsteine, Edelmetalle",968244000,1306118000,2274362000
2015,7,WA72,Eisen und Stahl,1728237000,2032958000,3761195000
2015,7,WA73,Waren aus Eisen oder Stahl,2282649000,1665038000,3947687000
2015,7,WA74,Kupfer und Waren daraus,906472000,820284000,1726756000
2015,7,WA75,Nickel und Waren daraus,99205000,106303000,205508000
2015,7,WA76,Aluminium und Waren daraus,1265051000,1351372000,2616423000
2015,7,WA78,Blei und Waren daraus,30617000,22565000,53182000
2015,7,WA79,Zink und Waren daraus,50983000,116678000,167661000
2015,7,WA80,Zinn und Waren daraus,9601000,32496000,42097000
2015,7,WA81,"Andere unedle Metalle, Cermets usw.",122666000,144750000,267416000
2015,7,WA82,"Werkzeuge, Schneidwaren, Essbestecke",701623000,410914000,1112537000
2015,7,WA83,Verschiedene Waren aus unedlen Metallen,607531000,393419000,1000950000
2015,7,WA84,"Maschinen, Apparate, mechanische Geräte",18052220000,10418651000,28470871000
2015,7,WA85,Elektrotechnische Erzeugnisse,10266034000,9529424000,19795458000
2015,7,WA86,Schienenfahrzeuge,239973000,197759000,437732000
2015,7,WA87,"Kraftfahrzeuge, Landfahrzeuge",20211016000,7883985000,28095001000
2015,7,WA88,"Luftfahrzeuge, Raumfahrzeuge",3870222000,1209921000,5080143000
2015,7,WA89,Wasserfahrzeuge,313383000,76547000,389930000
2015,7,WA90,"Optische, photografische usw. Erzeugnisse",4881725000,2893208000,7774933000
2015,7,WA91,Uhrmacherwaren,219612000,245947000,465559000
2015,7,WA92,Musikinstrumente,47728000,42784000,90512000
2015,7,WA93,Waffen und Munition,44616000,16330000,60946000
2015,7,WA94,"Möbel, Beleuchtungskörper usw.",1224704000,1362892000,2587596000
2015,7,WA95,"Spielzeug, Spiele usw., Sportgeräte",290937000,449837000,740774000
2015,7,WA96,Verschiedene Waren,375067000,232612000,607679000
2015,7,WA97,"Kunstgegenstände, Sammlungsstücke",73278000,54672000,127950000
2015,7,WA98,Vollständige Fabrikationsanlagen,225705000,1494000,227199000
2015,7,WA99,Zusammenstellungen verschiedener Waren,1864256000,906426000,2770682000
2015,8,WA01,Lebende Tiere,128801000,137303000,266104000
2015,8,WA02,Fleisch,585334000,475873000,1061207000
2015,8,WA03,"Fische, Krebs- und Weichtiere",123086000,272981000,396067000
2015,8,WA04,"Milch, Milcherzeugnisse, Eier, Honig",650269000,533652000,1183921000
2015,8,WA05,Andere Waren tierischen Ursprungs,55926000,61802000,117728000
2015,8,WA06,"Pflanzen, Waren des Blumenhandels",53106000,171577000,224683000
2015,8,WA07,"Gemüse, Pflanzen für Ernährung",68570000,361993000,430563000
2015,8,WA08,Genießbare Früchte und Nüsse,143153000,779341000,922494000
2015,8,WA09,"Kaffee, Tee, Mate, Gewürze",199423000,304964000,504387000
2015,8,WA10,Getreide,132499000,184613000,317112000
2015,8,WA11,"Müllereierzeugnisse, Malz usw.",103418000,39066000,142484000
2015,8,WA12,"Ölsamen usw., Heilpflanzen usw.",74245000,414117000,488362000
2015,8,WA13,"Schellack, Gummen, Harz, Pflanzensaft",42815000,40537000,83352000
2015,8,WA14,Flechtstoffe usw. pflanzlichen Ursprungs,666000,3184000,3850000
2015,8,WA15,"Tierische und pflanzliche Fette, Öle, Wachs",202032000,326208000,528240000
2015,8,WA16,"Zubereitungen von Fleisch, Fisch usw.",240617000,199220000,439837000
2015,8,WA17,Zucker und Zuckerwaren,145280000,138424000,283704000
2015,8,WA18,Kakao und Zubereitungen aus Kakao,388919000,362487000,751406000
2015,8,WA19,"Zubereitungen aus Getreide usw., Backwaren",462503000,290394000,752897000
2015,8,WA20,"Zubereitungen von Gemüse, Früchten usw.",192825000,367206000,560031000
2015,8,WA21,Verschiedene Lebensmittelzubereitungen,384766000,237761000,622527000
2015,8,WA22,"Getränke, alkoholhaltige Flüssigkeiten, Essig",453803000,519797000,973600000
2015,8,WA23,"Rückstände der Lebensmittelindustrie, Futter",319741000,293541000,613282000
2015,8,WA24,Tabak,345327000,148049000,493376000
2015,8,WA25,"Salz, Schwefel, Steine, Erden usw.",147656000,149142000,296798000
2015,8,WA26,"Erze, Schlacken, Aschen",28505000,596208000,624713000
2015,8,WA27,Mineralische Brennstoffe usw.,2223271000,7235419000,9458690000
2015,8,WA28,Anorganische chemische Erzeugnisse,697589000,428177000,1125766000
2015,8,WA29,Organische chemische Erzeugnisse,1866587000,2376649000,4243236000
2015,8,WA30,Pharmazeutische Erzeugnisse,5592717000,3286160000,8878877000
2015,8,WA31,Düngemittel,138547000,108273000,246820000
2015,8,WA32,"Gerb- und Farbstoffe, Farben, Lacke usw.",792738000,431113000,1223851000
2015,8,WA33,"Etherische Öle, Riech-, Schönheitsmittel",733450000,547731000,1281181000
2015,8,WA34,"Seifen, Waschmittel usw.",523500000,294392000,817892000
2015,8,WA35,"Eiweißstoffe, Klebstoffe, Enzyme",230238000,158875000,389113000
2015,8,WA36,"Sprengstoffe, pyrotechnische Artikel usw.",13864000,27613000,41477000
2015,8,WA37,Photochemische Erzeugnisse,86234000,56950000,143184000
2015,8,WA38,Verschiedene Erzeugnisse der Chemischen Industrie,1461582000,901394000,2362976000
2015,8,WA39,Kunststoffe und Waren daraus,4121705000,2798163000,6919868000
2015,8,WA40,Kautschuk und Waren daraus,1079472000,1050074000,2129546000
2015,8,WA41,"Häute, Felle, Leder",71141000,61236000,132377000
2015,8,WA42,"Lederwaren, Sattlerwaren",167500000,338175000,505675000
2015,8,WA43,"Pelzfelle, künstliches Pelzwerk",11024000,13446000,24470000
2015,8,WA44,"Holz, Holzwaren, Holzkohle",531557000,561800000,1093357000
2015,8,WA45,"Kork, Korkwaren",2420000,7597000,10017000
2015,8,WA46,"Flechtwaren, Korbmacherwaren",3394000,10650000,14044000
2015,8,WA47,"Halbstoffe aus Holz usw., Papierabfall",108671000,306681000,415352000
2015,8,WA48,"Papier, Pappe und Waren daraus",1353207000,989515000,2342722000
2015,8,WA49,"Bücher, Zeitungen, Bilddrucke usw.",359149000,177537000,536686000
2015,8,WA50,Seide,2735000,4398000,7133000
2015,8,WA51,"Wolle, feine und grobe Tierhaare",34424000,39354000,73778000
2015,8,WA52,Baumwolle,50193000,65247000,115440000
2015,8,WA53,"Andere pflanzliche Spinnstoffe, Papiergarn",2348000,5221000,7569000
2015,8,WA54,Synthetisches oder künstliches Filament,127992000,109621000,237613000
2015,8,WA55,Synthetische oder künstliche Spinnfaser,132328000,106083000,238411000
2015,8,WA56,"Watte, Filz, Vliesstoff usw., Tauwerk",172093000,99060000,271153000
2015,8,WA57,"Teppiche, Fußbodenbelag aus Spinnstoff",37418000,73465000,110883000
2015,8,WA58,"Spezialgewebe, Spitzen, Tapisserien",37388000,19850000,57238000
2015,8,WA59,"Getränkte, bestrichene usw. Gewebe",154636000,80843000,235479000
2015,8,WA60,Gewirke und Gestricke,47111000,25856000,72967000
2015,8,WA61,"Bekleidung usw. aus Gewirken, Gestricken",682210000,1537376000,2219586000
2015,8,WA62,"Andere Bekleidung, Bekleidungszubehör",748086000,1524713000,2272799000
2015,8,WA63,"Andere Konfektion, Spinnstoffwaren usw.",187424000,308492000,495916000
2015,8,WA64,"Schuhe, Gamaschen, ähnliche Waren",439267000,921871000,1361138000
2015,8,WA65,Kopfbedeckungen und Teile davon,32271000,52745000,85016000
2015,8,WA66,"Schirme, Gehstöcke usw., Peitschen",7873000,14719000,22592000
2015,8,WA67,"Zugerichtete Federn, Daunen, künstliche Blumen",9101000,18269000,27370000
2015,8,WA68,"Waren aus Steinen, Gips, Zement usw.",311114000,235910000,547024000
2015,8,WA69,Keramische Waren,232637000,217683000,450320000
2015,8,WA70,Glas und Glaswaren,414692000,363190000,777882000
2015,8,WA71,"Perlen, Edelsteine, Edelmetalle",744539000,1344985000,2089524000
2015,8,WA72,Eisen und Stahl,1530072000,1653457000,3183529000
2015,8,WA73,Waren aus Eisen oder Stahl,1961549000,1392470000,3354019000
2015,8,WA74,Kupfer und Waren daraus,720796000,651727000,1372523000
2015,8,WA75,Nickel und Waren daraus,94980000,89747000,184727000
2015,8,WA76,Aluminium und Waren daraus,1073193000,1194364000,2267557000
2015,8,WA78,Blei und Waren daraus,30279000,39896000,70175000
2015,8,WA79,Zink und Waren daraus,41664000,95244000,136908000
2015,8,WA80,Zinn und Waren daraus,6400000,27622000,34022000
2015,8,WA81,"Andere unedle Metalle, Cermets usw.",100194000,132446000,232640000
2015,8,WA82,"Werkzeuge, Schneidwaren, Essbestecke",554020000,370343000,924363000
2015,8,WA83,Verschiedene Waren aus unedlen Metallen,533398000,309751000,843149000
2015,8,WA84,"Maschinen, Apparate, mechanische Geräte",14794722000,8520219000,23314941000
2015,8,WA85,Elektrotechnische Erzeugnisse,8834201000,8629127000,17463328000
2015,8,WA86,Schienenfahrzeuge,287807000,200466000,488273000
2015,8,WA87,"Kraftfahrzeuge, Landfahrzeuge",13911438000,5706421000,19617859000
2015,8,WA88,"Luftfahrzeuge, Raumfahrzeuge",2665281000,1300897000,3966178000
2015,8,WA89,Wasserfahrzeuge,189993000,95397000,285390000
2015,8,WA90,"Optische, photografische usw. Erzeugnisse",4230472000,2563745000,6794217000
2015,8,WA91,Uhrmacherwaren,142621000,216379000,359000000
2015,8,WA92,Musikinstrumente,34037000,41114000,75151000
2015,8,WA93,Waffen und Munition,30480000,14094000,44574000
2015,8,WA94,"Möbel, Beleuchtungskörper usw.",1055230000,1263226000,2318456000
2015,8,WA95,"Spielzeug, Spiele usw., Sportgeräte",276511000,489360000,765871000
2015,8,WA96,Verschiedene Waren,291055000,211456000,502511000
2015,8,WA97,"Kunstgegenstände, Sammlungsstücke",47436000,31495000,78931000
2015,8,WA98,Vollständige Fabrikationsanlagen,245011000,2898000,247909000
2015,8,WA99,Zusammenstellungen verschiedener Waren,1600849000,722883000,2323732000
2015,9,WA01,Lebende Tiere,143387000,142698000,286085000
2015,9,WA02,Fleisch,647891000,536243000,1184134000
2015,9,WA03,"Fische, Krebs- und Weichtiere",128911000,304640000,433551000
2015,9,WA04,"Milch, Milcherzeugnisse, Eier, Honig",690364000,581970000,1272334000
2015,9,WA05,Andere Waren tierischen Ursprungs,67471000,67200000,134671000
2015,9,WA06,"Pflanzen, Waren des Blumenhandels",74709000,189724000,264433000
2015,9,WA07,"Gemüse, Pflanzen für Ernährung",91323000,385233000,476556000
2015,9,WA08,Genießbare Früchte und Nüsse,158652000,762670000,921322000
2015,9,WA09,"Kaffee, Tee, Mate, Gewürze",219922000,315703000,535625000
2015,9,WA10,Getreide,141350000,213033000,354383000
2015,9,WA11,"Müllereierzeugnisse, Malz usw.",124489000,46023000,170512000
2015,9,WA12,"Ölsamen usw., Heilpflanzen usw.",65917000,480433000,546350000
2015,9,WA13,"Schellack, Gummen, Harz, Pflanzensaft",42876000,34764000,77640000
2015,9,WA14,Flechtstoffe usw. pflanzlichen Ursprungs,710000,3659000,4369000
2015,9,WA15,"Tierische und pflanzliche Fette, Öle, Wachs",231542000,341787000,573329000
2015,9,WA16,"Zubereitungen von Fleisch, Fisch usw.",230631000,202955000,433586000
2015,9,WA17,Zucker und Zuckerwaren,156228000,142018000,298246000
2015,9,WA18,Kakao und Zubereitungen aus Kakao,463678000,372453000,836131000
2015,9,WA19,"Zubereitungen aus Getreide usw., Backwaren",505907000,362378000,868285000
2015,9,WA20,"Zubereitungen von Gemüse, Früchten usw.",222962000,398411000,621373000
2015,9,WA21,Verschiedene Lebensmittelzubereitungen,411553000,241731000,653284000
2015,9,WA22,"Getränke, alkoholhaltige Flüssigkeiten, Essig",450786000,580289000,1031075000
2015,9,WA23,"Rückstände der Lebensmittelindustrie, Futter",369980000,354165000,724145000
2015,9,WA24,Tabak,379336000,179936000,559272000
2015,9,WA25,"Salz, Schwefel, Steine, Erden usw.",180809000,144791000,325600000
2015,9,WA26,"Erze, Schlacken, Aschen",29690000,543563000,573253000
2015,9,WA27,Mineralische Brennstoffe usw.,2329937000,7274885000,9604822000
2015,9,WA28,Anorganische chemische Erzeugnisse,701300000,478919000,1180219000
2015,9,WA29,Organische chemische Erzeugnisse,1930916000,2372510000,4303426000
2015,9,WA30,Pharmazeutische Erzeugnisse,6186241000,3844719000,10030960000
2015,9,WA31,Düngemittel,182704000,94165000,276869000
2015,9,WA32,"Gerb- und Farbstoffe, Farben, Lacke usw.",899225000,445186000,1344411000
2015,9,WA33,"Etherische Öle, Riech-, Schönheitsmittel",791345000,581893000,1373238000
2015,9,WA34,"Seifen, Waschmittel usw.",611722000,333084000,944806000
2015,9,WA35,"Eiweißstoffe, Klebstoffe, Enzyme",268069000,175681000,443750000
2015,9,WA36,"Sprengstoffe, pyrotechnische Artikel usw.",18968000,36677000,55645000
2015,9,WA37,Photochemische Erzeugnisse,103583000,61544000,165127000
2015,9,WA38,Verschiedene Erzeugnisse der Chemischen Industrie,1592902000,978647000,2571549000
2015,9,WA39,Kunststoffe und Waren daraus,4747729000,3146510000,7894239000
2015,9,WA40,Kautschuk und Waren daraus,1261588000,1221570000,2483158000
2015,9,WA41,"Häute, Felle, Leder",97573000,69317000,166890000
2015,9,WA42,"Lederwaren, Sattlerwaren",170594000,327901000,498495000
2015,9,WA43,"Pelzfelle, künstliches Pelzwerk",14683000,14021000,28704000
2015,9,WA44,"Holz, Holzwaren, Holzkohle",636296000,651298000,1287594000
2015,9,WA45,"Kork, Korkwaren",2489000,6211000,8700000
2015,9,WA46,"Flechtwaren, Korbmacherwaren",4119000,10061000,14180000
2015,9,WA47,"Halbstoffe aus Holz usw., Papierabfall",97660000,362924000,460584000
2015,9,WA48,"Papier, Pappe und Waren daraus",1480008000,1036126000,2516134000
2015,9,WA49,"Bücher, Zeitungen, Bilddrucke usw.",380491000,218567000,599058000
2015,9,WA50,Seide,4996000,4067000,9063000
2015,9,WA51,"Wolle, feine und grobe Tierhaare",49880000,51158000,101038000
2015,9,WA52,Baumwolle,74482000,77009000,151491000
2015,9,WA53,"Andere pflanzliche Spinnstoffe, Papiergarn",3420000,6111000,9531000
2015,9,WA54,Synthetisches oder künstliches Filament,166084000,130809000,296893000
2015,9,WA55,Synthetische oder künstliche Spinnfaser,159052000,137823000,296875000
2015,9,WA56,"Watte, Filz, Vliesstoff usw., Tauwerk",204802000,115365000,320167000
2015,9,WA57,"Teppiche, Fußbodenbelag aus Spinnstoff",48579000,87459000,136038000
2015,9,WA58,"Spezialgewebe, Spitzen, Tapisserien",47196000,22968000,70164000
2015,9,WA59,"Getränkte, bestrichene usw. Gewebe",185282000,91294000,276576000
2015,9,WA60,Gewirke und Gestricke,67322000,38572000,105894000
2015,9,WA61,"Bekleidung usw. aus Gewirken, Gestricken",733643000,1454575000,2188218000
2015,9,WA62,"Andere Bekleidung, Bekleidungszubehör",796574000,1494181000,2290755000
2015,9,WA63,"Andere Konfektion, Spinnstoffwaren usw.",223060000,319503000,542563000
2015,9,WA64,"Schuhe, Gamaschen, ähnliche Waren",455820000,856396000,1312216000
2015,9,WA65,Kopfbedeckungen und Teile davon,39540000,53642000,93182000
2015,9,WA66,"Schirme, Gehstöcke usw., Peitschen",7323000,12886000,20209000
2015,9,WA67,"Zugerichtete Federn, Daunen, künstliche Blumen",10877000,17312000,28189000
2015,9,WA68,"Waren aus Steinen, Gips, Zement usw.",370475000,268461000,638936000
2015,9,WA69,Keramische Waren,265001000,230557000,495558000
2015,9,WA70,Glas und Glaswaren,552453000,440003000,992456000
2015,9,WA71,"Perlen, Edelsteine, Edelmetalle",862748000,1264083000,2126831000
2015,9,WA72,Eisen und Stahl,1772565000,1920642000,3693207000
2015,9,WA73,Waren aus Eisen oder Stahl,2277692000,1655308000,3933000000
2015,9,WA74,Kupfer und Waren daraus,876533000,690600000,1567133000
2015,9,WA75,Nickel und Waren daraus,86185000,99889000,186074000
2015,9,WA76,Aluminium und Waren daraus,1216797000,1333817000,2550614000
2015,9,WA78,Blei und Waren daraus,45858000,17420000,63278000
2015,9,WA79,Zink und Waren daraus,51017000,105368000,156385000
2015,9,WA80,Zinn und Waren daraus,8824000,28462000,37286000
2015,9,WA81,"Andere unedle Metalle, Cermets usw.",124370000,143925000,268295000
2015,9,WA82,"Werkzeuge, Schneidwaren, Essbestecke",686943000,398528000,1085471000
2015,9,WA83,Verschiedene Waren aus unedlen Metallen,604218000,392394000,996612000
2015,9,WA84,"Maschinen, Apparate, mechanische Geräte",17092426000,10396672000,27489098000
2015,9,WA85,Elektrotechnische Erzeugnisse,10474054000,10039825000,20513879000
2015,9,WA86,Schienenfahrzeuge,333294000,202440000,535734000
2015,9,WA87,"Kraftfahrzeuge, Landfahrzeuge",20026342000,8274106000,28300448000
2015,9,WA88,"Luftfahrzeuge, Raumfahrzeuge",3237013000,1568219000,4805232000
2015,9,WA89,Wasserfahrzeuge,996647000,657969000,1654616000
2015,9,WA90,"Optische, photografische usw. Erzeugnisse",4885381000,2823010000,7708391000
2015,9,WA91,Uhrmacherwaren,189220000,230719000,419939000
2015,9,WA92,Musikinstrumente,55880000,52268000,108148000
2015,9,WA93,Waffen und Munition,37320000,16760000,54080000
2015,9,WA94,"Möbel, Beleuchtungskörper usw.",1341062000,1526938000,2868000000
2015,9,WA95,"Spielzeug, Spiele usw., Sportgeräte",453767000,691853000,1145620000
2015,9,WA96,Verschiedene Waren,323781000,212359000,536140000
2015,9,WA97,"Kunstgegenstände, Sammlungsstücke",45921000,38295000,84216000
2015,9,WA98,Vollständige Fabrikationsanlagen,257774000,719000,258493000
2015,9,WA99,Zusammenstellungen verschiedener Waren,1875025000,813682000,2688707000
2015,10,WA01,Lebende Tiere,151901000,159863000,311764000
2015,10,WA02,Fleisch,650543000,547305000,1197848000
2015,10,WA03,"Fische, Krebs- und Weichtiere",151662000,340987000,492649000
2015,10,WA04,"Milch, Milcherzeugnisse, Eier, Honig",669011000,567904000,1236915000
2015,10,WA05,Andere Waren tierischen Ursprungs,69566000,72937000,142503000
2015,10,WA06,"Pflanzen, Waren des Blumenhandels",74103000,175114000,249217000
2015,10,WA07,"Gemüse, Pflanzen für Ernährung",89027000,392999000,482026000
2015,10,WA08,Genießbare Früchte und Nüsse,151421000,791534000,942955000
2015,10,WA09,"Kaffee, Tee, Mate, Gewürze",222479000,349429000,571908000
2015,10,WA10,Getreide,166871000,213955000,380826000
2015,10,WA11,"Müllereierzeugnisse, Malz usw.",123360000,49369000,172729000
2015,10,WA12,"Ölsamen usw., Heilpflanzen usw.",67774000,437193000,504967000
2015,10,WA13,"Schellack, Gummen, Harz, Pflanzensaft",42354000,39915000,82269000
2015,10,WA14,Flechtstoffe usw. pflanzlichen Ursprungs,756000,2788000,3544000
2015,10,WA15,"Tierische und pflanzliche Fette, Öle, Wachs",250465000,280239000,530704000
2015,10,WA16,"Zubereitungen von Fleisch, Fisch usw.",247790000,213435000,461225000
2015,10,WA17,Zucker und Zuckerwaren,159941000,138429000,298370000
2015,10,WA18,Kakao und Zubereitungen aus Kakao,546621000,441192000,987813000
2015,10,WA19,"Zubereitungen aus Getreide usw., Backwaren",519373000,334791000,854164000
2015,10,WA20,"Zubereitungen von Gemüse, Früchten usw.",211582000,402293000,613875000
2015,10,WA21,Verschiedene Lebensmittelzubereitungen,410162000,247540000,657702000
2015,10,WA22,"Getränke, alkoholhaltige Flüssigkeiten, Essig",471291000,577388000,1048679000
2015,10,WA23,"Rückstände der Lebensmittelindustrie, Futter",344069000,354895000,698964000
2015,10,WA24,Tabak,357186000,183881000,541067000
2015,10,WA25,"Salz, Schwefel, Steine, Erden usw.",184108000,141643000,325751000
2015,10,WA26,"Erze, Schlacken, Aschen",23415000,449398000,472813000
2015,10,WA27,Mineralische Brennstoffe usw.,2240414000,7144404000,9384818000
2015,10,WA28,Anorganische chemische Erzeugnisse,705260000,461850000,1167110000
2015,10,WA29,Organische chemische Erzeugnisse,2003927000,2497441000,4501368000
2015,10,WA30,Pharmazeutische Erzeugnisse,5815776000,3646062000,9461838000
2015,10,WA31,Düngemittel,182125000,84519000,266644000
2015,10,WA32,"Gerb- und Farbstoffe, Farben, Lacke usw.",940076000,516336000,1456412000
2015,10,WA33,"Etherische Öle, Riech-, Schönheitsmittel",775674000,575148000,1350822000
2015,10,WA34,"Seifen, Waschmittel usw.",591960000,350868000,942828000
2015,10,WA35,"Eiweißstoffe, Klebstoffe, Enzyme",264389000,173964000,438353000
2015,10,WA36,"Sprengstoffe, pyrotechnische Artikel usw.",18056000,26851000,44907000
2015,10,WA37,Photochemische Erzeugnisse,107810000,68571000,176381000
2015,10,WA38,Verschiedene Erzeugnisse der Chemischen Industrie,1752954000,1031041000,2783995000
2015,10,WA39,Kunststoffe und Waren daraus,4849617000,3058654000,7908271000
2015,10,WA40,Kautschuk und Waren daraus,1293844000,1214477000,2508321000
2015,10,WA41,"Häute, Felle, Leder",99983000,72036000,172019000
2015,10,WA42,"Lederwaren, Sattlerwaren",160947000,319809000,480756000
2015,10,WA43,"Pelzfelle, künstliches Pelzwerk",10067000,11437000,21504000
2015,10,WA44,"Holz, Holzwaren, Holzkohle",644495000,637704000,1282199000
2015,10,WA45,"Kork, Korkwaren",2549000,8145000,10694000
2015,10,WA46,"Flechtwaren, Korbmacherwaren",4409000,9623000,14032000
2015,10,WA47,"Halbstoffe aus Holz usw., Papierabfall",98734000,328182000,426916000
2015,10,WA48,"Papier, Pappe und Waren daraus",1565999000,1050507000,2616506000
2015,10,WA49,"Bücher, Zeitungen, Bilddrucke usw.",381157000,210643000,591800000
2015,10,WA50,Seide,5760000,5236000,10996000
2015,10,WA51,"Wolle, feine und grobe Tierhaare",48420000,54507000,102927000
2015,10,WA52,Baumwolle,83241000,85039000,168280000
2015,10,WA53,"Andere pflanzliche Spinnstoffe, Papiergarn",4487000,7724000,12211000
2015,10,WA54,Synthetisches oder künstliches Filament,174890000,136945000,311835000
2015,10,WA55,Synthetische oder künstliche Spinnfaser,161523000,133401000,294924000
2015,10,WA56,"Watte, Filz, Vliesstoff usw., Tauwerk",206294000,111951000,318245000
2015,10,WA57,"Teppiche, Fußbodenbelag aus Spinnstoff",47579000,94393000,141972000
2015,10,WA58,"Spezialgewebe, Spitzen, Tapisserien",46346000,22745000,69091000
2015,10,WA59,"Getränkte, bestrichene usw. Gewebe",196994000,94535000,291529000
2015,10,WA60,Gewirke und Gestricke,71439000,39736000,111175000
2015,10,WA61,"Bekleidung usw. aus Gewirken, Gestricken",627656000,1402152000,2029808000
2015,10,WA62,"Andere Bekleidung, Bekleidungszubehör",639656000,1228093000,1867749000
2015,10,WA63,"Andere Konfektion, Spinnstoffwaren usw.",225054000,316147000,541201000
2015,10,WA64,"Schuhe, Gamaschen, ähnliche Waren",320582000,687881000,1008463000
2015,10,WA65,Kopfbedeckungen und Teile davon,34581000,49565000,84146000
2015,10,WA66,"Schirme, Gehstöcke usw., Peitschen",9455000,14061000,23516000
2015,10,WA67,"Zugerichtete Federn, Daunen, künstliche Blumen",10202000,15644000,25846000
2015,10,WA68,"Waren aus Steinen, Gips, Zement usw.",359092000,260492000,619584000
2015,10,WA69,Keramische Waren,275250000,231443000,506693000
2015,10,WA70,Glas und Glaswaren,518660000,439883000,958543000
2015,10,WA71,"Perlen, Edelsteine, Edelmetalle",967319000,1067486000,2034805000
2015,10,WA72,Eisen und Stahl,1666597000,1876390000,3542987000
2015,10,WA73,Waren aus Eisen oder Stahl,2288837000,1669070000,3957907000
2015,10,WA74,Kupfer und Waren daraus,841532000,683879000,1525411000
2015,10,WA75,Nickel und Waren daraus,81588000,103859000,185447000
2015,10,WA76,Aluminium und Waren daraus,1217839000,1384332000,2602171000
2015,10,WA78,Blei und Waren daraus,27813000,19429000,47242000
2015,10,WA79,Zink und Waren daraus,50531000,100066000,150597000
2015,10,WA80,Zinn und Waren daraus,7650000,25267000,32917000
2015,10,WA81,"Andere unedle Metalle, Cermets usw.",116594000,173493000,290087000
2015,10,WA82,"Werkzeuge, Schneidwaren, Essbestecke",666308000,407708000,1074016000
2015,10,WA83,Verschiedene Waren aus unedlen Metallen,615316000,386276000,1001592000
2015,10,WA84,"Maschinen, Apparate, mechanische Geräte",17767899000,10879934000,28647833000
2015,10,WA85,Elektrotechnische Erzeugnisse,10567407000,10486974000,21054381000
2015,10,WA86,Schienenfahrzeuge,252996000,199134000,452130000
2015,10,WA87,"Kraftfahrzeuge, Landfahrzeuge",20111710000,8434227000,28545937000
2015,10,WA88,"Luftfahrzeuge, Raumfahrzeuge",3614262000,2277613000,5891875000
2015,10,WA89,Wasserfahrzeuge,536321000,268383000,804704000
2015,10,WA90,"Optische, photografische usw. Erzeugnisse",4846618000,2858318000,7704936000
2015,10,WA91,Uhrmacherwaren,223149000,239428000,462577000
2015,10,WA92,Musikinstrumente,48280000,50483000,98763000
2015,10,WA93,Waffen und Munition,44388000,17109000,61497000
2015,10,WA94,"Möbel, Beleuchtungskörper usw.",1378524000,1604558000,2983082000
2015,10,WA95,"Spielzeug, Spiele usw., Sportgeräte",509382000,738095000,1247477000
2015,10,WA96,Verschiedene Waren,327332000,226388000,553720000
2015,10,WA97,"Kunstgegenstände, Sammlungsstücke",68403000,40648000,109051000
2015,10,WA98,Vollständige Fabrikationsanlagen,184973000,1137000,186110000
2015,10,WA99,Zusammenstellungen verschiedener Waren,1863927000,1036727000,2900654000
2015,11,WA01,Lebende Tiere,129717000,130805000,260522000
2015,11,WA02,Fleisch,635413000,535238000,1170651000
2015,11,WA03,"Fische, Krebs- und Weichtiere",134193000,342019000,476212000
2015,11,WA04,"Milch, Milcherzeugnisse, Eier, Honig",677886000,627189000,1305075000
2015,11,WA05,Andere Waren tierischen Ursprungs,66214000,72119000,138333000
2015,11,WA06,"Pflanzen, Waren des Blumenhandels",57717000,183318000,241035000
2015,11,WA07,"Gemüse, Pflanzen für Ernährung",96412000,425912000,522324000
2015,11,WA08,Genießbare Früchte und Nüsse,174118000,840893000,1015011000
2015,11,WA09,"Kaffee, Tee, Mate, Gewürze",230041000,324800000,554841000
2015,11,WA10,Getreide,182254000,188473000,370727000
2015,11,WA11,"Müllereierzeugnisse, Malz usw.",120216000,50178000,170394000
2015,11,WA12,"Ölsamen usw., Heilpflanzen usw.",90016000,402144000,492160000
2015,11,WA13,"Schellack, Gummen, Harz, Pflanzensaft",47228000,35861000,83089000
2015,11,WA14,Flechtstoffe usw. pflanzlichen Ursprungs,566000,3076000,3642000
2015,11,WA15,"Tierische und pflanzliche Fette, Öle, Wachs",215169000,341198000,556367000
2015,11,WA16,"Zubereitungen von Fleisch, Fisch usw.",237399000,207459000,444858000
2015,11,WA17,Zucker und Zuckerwaren,161333000,139878000,301211000
2015,11,WA18,Kakao und Zubereitungen aus Kakao,542060000,443632000,985692000
2015,11,WA19,"Zubereitungen aus Getreide usw., Backwaren",508295000,356968000,865263000
2015,11,WA20,"Zubereitungen von Gemüse, Früchten usw.",209748000,436175000,645923000
2015,11,WA21,Verschiedene Lebensmittelzubereitungen,395674000,237405000,633079000
2015,11,WA22,"Getränke, alkoholhaltige Flüssigkeiten, Essig",449797000,598821000,1048618000
2015,11,WA23,"Rückstände der Lebensmittelindustrie, Futter",341597000,308390000,649987000
2015,11,WA24,Tabak,382069000,200787000,582856000
2015,11,WA25,"Salz, Schwefel, Steine, Erden usw.",175867000,151295000,327162000
2015,11,WA26,"Erze, Schlacken, Aschen",25596000,435339000,460935000
2015,11,WA27,Mineralische Brennstoffe usw.,2068595000,7066505000,9135100000
2015,11,WA28,Anorganische chemische Erzeugnisse,666519000,494182000,1160701000
2015,11,WA29,Organische chemische Erzeugnisse,1870302000,2477745000,4348047000
2015,11,WA30,Pharmazeutische Erzeugnisse,6258870000,3534640000,9793510000
2015,11,WA31,Düngemittel,210684000,98496000,309180000
2015,11,WA32,"Gerb- und Farbstoffe, Farben, Lacke usw.",878983000,475906000,1354889000
2015,11,WA33,"Etherische Öle, Riech-, Schönheitsmittel",743185000,530594000,1273779000
2015,11,WA34,"Seifen, Waschmittel usw.",558644000,321057000,879701000
2015,11,WA35,"Eiweißstoffe, Klebstoffe, Enzyme",266202000,178900000,445102000
2015,11,WA36,"Sprengstoffe, pyrotechnische Artikel usw.",23807000,30069000,53876000
2015,11,WA37,Photochemische Erzeugnisse,98368000,59961000,158329000
2015,11,WA38,Verschiedene Erzeugnisse der Chemischen Industrie,1725716000,1034800000,2760516000
2015,11,WA39,Kunststoffe und Waren daraus,4485563000,2950195000,7435758000
2015,11,WA40,Kautschuk und Waren daraus,1180832000,1051798000,2232630000
2015,11,WA41,"Häute, Felle, Leder",92035000,71992000,164027000
2015,11,WA42,"Lederwaren, Sattlerwaren",155585000,335985000,491570000
2015,11,WA43,"Pelzfelle, künstliches Pelzwerk",10050000,10959000,21009000
2015,11,WA44,"Holz, Holzwaren, Holzkohle",602046000,609553000,1211599000
2015,11,WA45,"Kork, Korkwaren",2334000,7078000,9412000
2015,11,WA46,"Flechtwaren, Korbmacherwaren",3409000,11974000,15383000
2015,11,WA47,"Halbstoffe aus Holz usw., Papierabfall",98596000,328529000,427125000
2015,11,WA48,"Papier, Pappe und Waren daraus",1413949000,1052320000,2466269000
2015,11,WA49,"Bücher, Zeitungen, Bilddrucke usw.",401158000,243550000,644708000
2015,11,WA50,Seide,2902000,4314000,7216000
2015,11,WA51,"Wolle, feine und grobe Tierhaare",42989000,45051000,88040000
2015,11,WA52,Baumwolle,79287000,84732000,164019000
2015,11,WA53,"Andere pflanzliche Spinnstoffe, Papiergarn",4836000,7868000,12704000
2015,11,WA54,Synthetisches oder künstliches Filament,158870000,129724000,288594000
2015,11,WA55,Synthetische oder künstliche Spinnfaser,155482000,126864000,282346000
2015,11,WA56,"Watte, Filz, Vliesstoff usw., Tauwerk",198496000,108439000,306935000
2015,11,WA57,"Teppiche, Fußbodenbelag aus Spinnstoff",46840000,92577000,139417000
2015,11,WA58,"Spezialgewebe, Spitzen, Tapisserien",41109000,23492000,64601000
2015,11,WA59,"Getränkte, bestrichene usw. Gewebe",184836000,91409000,276245000
2015,11,WA60,Gewirke und Gestricke,67846000,39474000,107320000
2015,11,WA61,"Bekleidung usw. aus Gewirken, Gestricken",549579000,1203541000,1753120000
2015,11,WA62,"Andere Bekleidung, Bekleidungszubehör",501239000,1071462000,1572701000
2015,11,WA63,"Andere Konfektion, Spinnstoffwaren usw.",210210000,294569000,504779000
2015,11,WA64,"Schuhe, Gamaschen, ähnliche Waren",296873000,617174000,914047000
2015,11,WA65,Kopfbedeckungen und Teile davon,27904000,42519000,70423000
2015,11,WA66,"Schirme, Gehstöcke usw., Peitschen",6734000,10318000,17052000
2015,11,WA67,"Zugerichtete Federn, Daunen, künstliche Blumen",7696000,15084000,22780000
2015,11,WA68,"Waren aus Steinen, Gips, Zement usw.",345697000,239200000,584897000
2015,11,WA69,Keramische Waren,269960000,225762000,495722000
2015,11,WA70,Glas und Glaswaren,499009000,411174000,910183000
2015,11,WA71,"Perlen, Edelsteine, Edelmetalle",957904000,1119726000,2077630000
2015,11,WA72,Eisen und Stahl,1563688000,1776303000,3339991000
2015,11,WA73,Waren aus Eisen oder Stahl,2187303000,1610099000,3797402000
2015,11,WA74,Kupfer und Waren daraus,796791000,782710000,1579501000
2015,11,WA75,Nickel und Waren daraus,79826000,101207000,181033000
2015,11,WA76,Aluminium und Waren daraus,1155717000,1179472000,2335189000
2015,11,WA78,Blei und Waren daraus,32433000,32892000,65325000
2015,11,WA79,Zink und Waren daraus,45938000,88909000,134847000
2015,11,WA80,Zinn und Waren daraus,8845000,21525000,30370000
2015,11,WA81,"Andere unedle Metalle, Cermets usw.",113708000,129987000,243695000
2015,11,WA82,"Werkzeuge, Schneidwaren, Essbestecke",647830000,409438000,1057268000
2015,11,WA83,Verschiedene Waren aus unedlen Metallen,564832000,366063000,930895000
2015,11,WA84,"Maschinen, Apparate, mechanische Geräte",17279438000,10976859000,28256297000
2015,11,WA85,Elektrotechnische Erzeugnisse,10646870000,10745709000,21392579000
2015,11,WA86,Schienenfahrzeuge,209335000,176761000,386096000
2015,11,WA87,"Kraftfahrzeuge, Landfahrzeuge",19448419000,8261690000,27710109000
2015,11,WA88,"Luftfahrzeuge, Raumfahrzeuge",2912197000,1584430000,4496627000
2015,11,WA89,Wasserfahrzeuge,308591000,277319000,585910000
2015,11,WA90,"Optische, photografische usw. Erzeugnisse",4957472000,2893276000,7850748000
2015,11,WA91,Uhrmacherwaren,207072000,232213000,439285000
2015,11,WA92,Musikinstrumente,58211000,60419000,118630000
2015,11,WA93,Waffen und Munition,40306000,15091000,55397000
2015,11,WA94,"Möbel, Beleuchtungskörper usw.",1361314000,1531512000,2892826000
2015,11,WA95,"Spielzeug, Spiele usw., Sportgeräte",498737000,636486000,1135223000
2015,11,WA96,Verschiedene Waren,324289000,232100000,556389000
2015,11,WA97,"Kunstgegenstände, Sammlungsstücke",76475000,42325000,118800000
2015,11,WA98,Vollständige Fabrikationsanlagen,255170000,1438000,256608000
2015,11,WA99,Zusammenstellungen verschiedener Waren,2144901000,1012363000,3157264000
2015,12,WA01,Lebende Tiere,124902000,132503000,257405000
2015,12,WA02,Fleisch,587064000,534991000,1122055000
2015,12,WA03,"Fische, Krebs- und Weichtiere",136242000,332790000,469032000
2015,12,WA04,"Milch, Milcherzeugnisse, Eier, Honig",652667000,607652000,1260319000
2015,12,WA05,Andere Waren tierischen Ursprungs,54602000,64419000,119021000
2015,12,WA06,"Pflanzen, Waren des Blumenhandels",54513000,202516000,257029000
2015,12,WA07,"Gemüse, Pflanzen für Ernährung",70968000,472287000,543255000
2015,12,WA08,Genießbare Früchte und Nüsse,159306000,753350000,912656000
2015,12,WA09,"Kaffee, Tee, Mate, Gewürze",195878000,300641000,496519000
2015,12,WA10,Getreide,200642000,217534000,418176000
2015,12,WA11,"Müllereierzeugnisse, Malz usw.",121074000,42862000,163936000
2015,12,WA12,"Ölsamen usw., Heilpflanzen usw.",82489000,464705000,547194000
2015,12,WA13,"Schellack, Gummen, Harz, Pflanzensaft",46399000,31892000,78291000
2015,12,WA14,Flechtstoffe usw. pflanzlichen Ursprungs,455000,3174000,3629000
2015,12,WA15,"Tierische und pflanzliche Fette, Öle, Wachs",207305000,285186000,492491000
2015,12,WA16,"Zubereitungen von Fleisch, Fisch usw.",233243000,203366000,436609000
2015,12,WA17,Zucker und Zuckerwaren,155697000,124755000,280452000
2015,12,WA18,Kakao und Zubereitungen aus Kakao,491286000,422580000,913866000
2015,12,WA19,"Zubereitungen aus Getreide usw., Backwaren",477119000,335181000,812300000
2015,12,WA20,"Zubereitungen von Gemüse, Früchten usw.",219908000,402836000,622744000
2015,12,WA21,Verschiedene Lebensmittelzubereitungen,377070000,231419000,608489000
2015,12,WA22,"Getränke, alkoholhaltige Flüssigkeiten, Essig",423456000,558191000,981647000
2015,12,WA23,"Rückstände der Lebensmittelindustrie, Futter",354711000,348827000,703538000
2015,12,WA24,Tabak,281088000,151116000,432204000
2015,12,WA25,"Salz, Schwefel, Steine, Erden usw.",132627000,131958000,264585000
2015,12,WA26,"Erze, Schlacken, Aschen",32350000,528587000,560937000
2015,12,WA27,Mineralische Brennstoffe usw.,2054780000,6625948000,8680728000
2015,12,WA28,Anorganische chemische Erzeugnisse,614646000,444946000,1059592000
2015,12,WA29,Organische chemische Erzeugnisse,1811563000,2253901000,4065464000
2015,12,WA30,Pharmazeutische Erzeugnisse,5352281000,3276954000,8629235000
2015,12,WA31,Düngemittel,182423000,110086000,292509000
2015,12,WA32,"Gerb- und Farbstoffe, Farben, Lacke usw.",723351000,402693000,1126044000
2015,12,WA33,"Etherische Öle, Riech-, Schönheitsmittel",703853000,538912000,1242765000
2015,12,WA34,"Seifen, Waschmittel usw.",497533000,291519000,789052000
2015,12,WA35,"Eiweißstoffe, Klebstoffe, Enzyme",226644000,145277000,371921000
2015,12,WA36,"Sprengstoffe, pyrotechnische Artikel usw.",23577000,26037000,49614000
2015,12,WA37,Photochemische Erzeugnisse,94637000,63308000,157945000
2015,12,WA38,Verschiedene Erzeugnisse der Chemischen Industrie,1556461000,990707000,2547168000
2015,12,WA39,Kunststoffe und Waren daraus,3708598000,2518579000,6227177000
2015,12,WA40,Kautschuk und Waren daraus,941687000,783039000,1724726000
2015,12,WA41,"Häute, Felle, Leder",72374000,48931000,121305000
2015,12,WA42,"Lederwaren, Sattlerwaren",149343000,329237000,478580000
2015,12,WA43,"Pelzfelle, künstliches Pelzwerk",10967000,9474000,20441000
2015,12,WA44,"Holz, Holzwaren, Holzkohle",485738000,479603000,965341000
2015,12,WA45,"Kork, Korkwaren",1846000,7229000,9075000
2015,12,WA46,"Flechtwaren, Korbmacherwaren",3310000,10137000,13447000
2015,12,WA47,"Halbstoffe aus Holz usw., Papierabfall",97844000,324340000,422184000
2015,12,WA48,"Papier, Pappe und Waren daraus",1317192000,873774000,2190966000
2015,12,WA49,"Bücher, Zeitungen, Bilddrucke usw.",387054000,238836000,625890000
2015,12,WA50,Seide,4788000,3295000,8083000
2015,12,WA51,"Wolle, feine und grobe Tierhaare",43929000,36199000,80128000
2015,12,WA52,Baumwolle,72532000,67990000,140522000
2015,12,WA53,"Andere pflanzliche Spinnstoffe, Papiergarn",4100000,6170000,10270000
2015,12,WA54,Synthetisches oder künstliches Filament,133605000,93043000,226648000
2015,12,WA55,Synthetische oder künstliche Spinnfaser,141888000,102338000,244226000
2015,12,WA56,"Watte, Filz, Vliesstoff usw., Tauwerk",163409000,87956000,251365000
2015,12,WA57,"Teppiche, Fußbodenbelag aus Spinnstoff",38658000,90846000,129504000
2015,12,WA58,"Spezialgewebe, Spitzen, Tapisserien",32820000,18839000,51659000
2015,12,WA59,"Getränkte, bestrichene usw. Gewebe",156911000,76942000,233853000
2015,12,WA60,Gewirke und Gestricke,55198000,31282000,86480000
2015,12,WA61,"Bekleidung usw. aus Gewirken, Gestricken",512619000,1164037000,1676656000
2015,12,WA62,"Andere Bekleidung, Bekleidungszubehör",506983000,1142628000,1649611000
2015,12,WA63,"Andere Konfektion, Spinnstoffwaren usw.",196489000,284663000,481152000
2015,12,WA64,"Schuhe, Gamaschen, ähnliche Waren",290427000,676054000,966481000
2015,12,WA65,Kopfbedeckungen und Teile davon,21535000,39057000,60592000
2015,12,WA66,"Schirme, Gehstöcke usw., Peitschen",5144000,16242000,21386000
2015,12,WA67,"Zugerichtete Federn, Daunen, künstliche Blumen",6903000,18743000,25646000
2015,12,WA68,"Waren aus Steinen, Gips, Zement usw.",282379000,199131000,481510000
2015,12,WA69,Keramische Waren,236822000,193830000,430652000
2015,12,WA70,Glas und Glaswaren,404198000,323791000,727989000
2015,12,WA71,"Perlen, Edelsteine, Edelmetalle",732520000,990163000,1722683000
2015,12,WA72,Eisen und Stahl,1235249000,1276576000,2511825000
2015,12,WA73,Waren aus Eisen oder Stahl,1901516000,1458208000,3359724000
2015,12,WA74,Kupfer und Waren daraus,553849000,565931000,1119780000
2015,12,WA75,Nickel und Waren daraus,59913000,74672000,134585000
2015,12,WA76,Aluminium und Waren daraus,909625000,1004415000,1914040000
2015,12,WA78,Blei und Waren daraus,22121000,27506000,49627000
2015,12,WA79,Zink und Waren daraus,38837000,75529000,114366000
2015,12,WA80,Zinn und Waren daraus,5996000,23104000,29100000
2015,12,WA81,"Andere unedle Metalle, Cermets usw.",102475000,109579000,212054000
2015,12,WA82,"Werkzeuge, Schneidwaren, Essbestecke",558113000,361978000,920091000
2015,12,WA83,Verschiedene Waren aus unedlen Metallen,473288000,307324000,780612000
2015,12,WA84,"Maschinen, Apparate, mechanische Geräte",16711217000,9796245000,26507462000
2015,12,WA85,Elektrotechnische Erzeugnisse,9338223000,8837550000,18175773000
2015,12,WA86,Schienenfahrzeuge,218880000,202945000,421825000
2015,12,WA87,"Kraftfahrzeuge, Landfahrzeuge",15357374000,6880198000,22237572000
2015,12,WA88,"Luftfahrzeuge, Raumfahrzeuge",3789131000,1624088000,5413219000
2015,12,WA89,Wasserfahrzeuge,258909000,34704000,293613000
2015,12,WA90,"Optische, photografische usw. Erzeugnisse",4847733000,2704191000,7551924000
2015,12,WA91,Uhrmacherwaren,181392000,194474000,375866000
2015,12,WA92,Musikinstrumente,51779000,54752000,106531000
2015,12,WA93,Waffen und Munition,40664000,17181000,57845000
2015,12,WA94,"Möbel, Beleuchtungskörper usw.",1121265000,1350897000,2472162000
2015,12,WA95,"Spielzeug, Spiele usw., Sportgeräte",378862000,533870000,912732000
2015,12,WA96,Verschiedene Waren,295778000,208731000,504509000
2015,12,WA97,"Kunstgegenstände, Sammlungsstücke",192064000,78187000,270251000
2015,12,WA98,Vollständige Fabrikationsanlagen,235661000,2182000,237843000
2015,12,WA99,Zusammenstellungen verschiedener Waren,1806421000,1109658000,2916079000
2016,1,WA01,Lebende Tiere,116960000,144153000,261113000
2016,1,WA02,Fleisch,580285000,488553000,1068838000
2016,1,WA03,"Fische, Krebs- und Weichtiere",104345000,312625000,416970000
2016,1,WA04,"Milch, Milcherzeugnisse, Eier, Honig",627455000,521898000,1149353000
2016,1,WA05,Andere Waren tierischen Ursprungs,59295000,74210000,133505000
2016,1,WA06,"Pflanzen, Waren des Blumenhandels",42590000,176520000,219110000
2016,1,WA07,"Gemüse, Pflanzen für Ernährung",85077000,489345000,574422000
2016,1,WA08,Genießbare Früchte und Nüsse,149481000,752577000,902058000
2016,1,WA09,"Kaffee, Tee, Mate, Gewürze",207803000,318722000,526525000
2016,1,WA10,Getreide,207388000,226601000,433989000
2016,1,WA11,"Müllereierzeugnisse, Malz usw.",109533000,44413000,153946000
2016,1,WA12,"Ölsamen usw., Heilpflanzen usw.",115959000,398667000,514626000
2016,1,WA13,"Schellack, Gummen, Harz, Pflanzensaft",47707000,36184000,83891000
2016,1,WA14,Flechtstoffe usw. pflanzlichen Ursprungs,557000,3513000,4070000
2016,1,WA15,"Tierische und pflanzliche Fette, Öle, Wachs",223180000,313155000,536335000
2016,1,WA16,"Zubereitungen von Fleisch, Fisch usw.",221404000,208533000,429937000
2016,1,WA17,Zucker und Zuckerwaren,132458000,121232000,253690000
2016,1,WA18,Kakao und Zubereitungen aus Kakao,445040000,389059000,834099000
2016,1,WA19,"Zubereitungen aus Getreide usw., Backwaren",437983000,317876000,755859000
2016,1,WA20,"Zubereitungen von Gemüse, Früchten usw.",193194000,371987000,565181000
2016,1,WA21,Verschiedene Lebensmittelzubereitungen,374382000,227531000,601913000
2016,1,WA22,"Getränke, alkoholhaltige Flüssigkeiten, Essig",369143000,495049000,864192000
2016,1,WA23,"Rückstände der Lebensmittelindustrie, Futter",313899000,295775000,609674000
2016,1,WA24,Tabak,373340000,152266000,525606000
2016,1,WA25,"Salz, Schwefel, Steine, Erden usw.",147759000,145577000,293336000
2016,1,WA26,"Erze, Schlacken, Aschen",20596000,541851000,562447000
2016,1,WA27,Mineralische Brennstoffe usw.,1681123000,5953782000,7634905000
2016,1,WA28,Anorganische chemische Erzeugnisse,675944000,474994000,1150938000
2016,1,WA29,Organische chemische Erzeugnisse,2169010000,2678976000,4847986000
2016,1,WA30,Pharmazeutische Erzeugnisse,5354322000,3400863000,8755185000
2016,1,WA31,Düngemittel,193746000,133702000,327448000
2016,1,WA32,"Gerb- und Farbstoffe, Farben, Lacke usw.",842989000,464085000,1307074000
2016,1,WA33,"Etherische Öle, Riech-, Schönheitsmittel",631955000,495582000,1127537000
2016,1,WA34,"Seifen, Waschmittel usw.",556039000,283280000,839319000
2016,1,WA35,"Eiweißstoffe, Klebstoffe, Enzyme",229648000,163355000,393003000
2016,1,WA36,"Sprengstoffe, pyrotechnische Artikel usw.",18541000,14031000,32572000
2016,1,WA37,Photochemische Erzeugnisse,95293000,54600000,149893000
2016,1,WA38,Verschiedene Erzeugnisse der Chemischen Industrie,1796285000,1003185000,2799470000
2016,1,WA39,Kunststoffe und Waren daraus,4459487000,2873995000,7333482000
2016,1,WA40,Kautschuk und Waren daraus,1077293000,1021802000,2099095000
2016,1,WA41,"Häute, Felle, Leder",82323000,66662000,148985000
2016,1,WA42,"Lederwaren, Sattlerwaren",159553000,357028000,516581000
2016,1,WA43,"Pelzfelle, künstliches Pelzwerk",11494000,7540000,19034000
2016,1,WA44,"Holz, Holzwaren, Holzkohle",546858000,596621000,1143479000
2016,1,WA45,"Kork, Korkwaren",2454000,9278000,11732000
2016,1,WA46,"Flechtwaren, Korbmacherwaren",5173000,12017000,17190000
2016,1,WA47,"Halbstoffe aus Holz usw., Papierabfall",98836000,309357000,408193000
2016,1,WA48,"Papier, Pappe und Waren daraus",1404817000,1028717000,2433534000
2016,1,WA49,"Bücher, Zeitungen, Bilddrucke usw.",330583000,208740000,539323000
2016,1,WA50,Seide,3566000,4250000,7816000
2016,1,WA51,"Wolle, feine und grobe Tierhaare",55009000,51754000,106763000
2016,1,WA52,Baumwolle,67683000,78944000,146627000
2016,1,WA53,"Andere pflanzliche Spinnstoffe, Papiergarn",4251000,6541000,10792000
2016,1,WA54,Synthetisches oder künstliches Filament,145233000,132601000,277834000
2016,1,WA55,Synthetische oder künstliche Spinnfaser,137884000,127473000,265357000
2016,1,WA56,"Watte, Filz, Vliesstoff usw., Tauwerk",179713000,105363000,285076000
2016,1,WA57,"Teppiche, Fußbodenbelag aus Spinnstoff",45749000,101324000,147073000
2016,1,WA58,"Spezialgewebe, Spitzen, Tapisserien",39618000,24368000,63986000
2016,1,WA59,"Getränkte, bestrichene usw. Gewebe",180241000,90435000,270676000
2016,1,WA60,Gewirke und Gestricke,60460000,33351000,93811000
2016,1,WA61,"Bekleidung usw. aus Gewirken, Gestricken",576557000,1310787000,1887344000
2016,1,WA62,"Andere Bekleidung, Bekleidungszubehör",648947000,1396080000,2045027000
2016,1,WA63,"Andere Konfektion, Spinnstoffwaren usw.",185152000,318867000,504019000
2016,1,WA64,"Schuhe, Gamaschen, ähnliche Waren",490461000,970527000,1460988000
2016,1,WA65,Kopfbedeckungen und Teile davon,30912000,46020000,76932000
2016,1,WA66,"Schirme, Gehstöcke usw., Peitschen",7115000,27378000,34493000
2016,1,WA67,"Zugerichtete Federn, Daunen, künstliche Blumen",9728000,16057000,25785000
2016,1,WA68,"Waren aus Steinen, Gips, Zement usw.",303451000,225845000,529296000
2016,1,WA69,Keramische Waren,228385000,211559000,439944000
2016,1,WA70,Glas und Glaswaren,486528000,371439000,857967000
2016,1,WA71,"Perlen, Edelsteine, Edelmetalle",733497000,1180193000,1913690000
2016,1,WA72,Eisen und Stahl,1488213000,1613638000,3101851000
2016,1,WA73,Waren aus Eisen oder Stahl,1867763000,1489017000,3356780000
2016,1,WA74,Kupfer und Waren daraus,778162000,556139000,1334301000
2016,1,WA75,Nickel und Waren daraus,65894000,77116000,143010000
2016,1,WA76,Aluminium und Waren daraus,1040257000,1121580000,2161837000
2016,1,WA78,Blei und Waren daraus,28652000,27393000,56045000
2016,1,WA79,Zink und Waren daraus,40327000,80817000,121144000
2016,1,WA80,Zinn und Waren daraus,6826000,19973000,26799000
2016,1,WA81,"Andere unedle Metalle, Cermets usw.",103403000,132278000,235681000
2016,1,WA82,"Werkzeuge, Schneidwaren, Essbestecke",555564000,381888000,937452000
2016,1,WA83,Verschiedene Waren aus unedlen Metallen,560137000,362407000,922544000
2016,1,WA84,"Maschinen, Apparate, mechanische Geräte",14240651000,9763411000,24004062000
2016,1,WA85,Elektrotechnische Erzeugnisse,9321764000,9166495000,18488259000
2016,1,WA86,Schienenfahrzeuge,407873000,162723000,570596000
2016,1,WA87,"Kraftfahrzeuge, Landfahrzeuge",15296296000,6926023000,22222319000
2016,1,WA88,"Luftfahrzeuge, Raumfahrzeuge",2264996000,1379312000,3644308000
2016,1,WA89,Wasserfahrzeuge,79544000,63889000,143433000
2016,1,WA90,"Optische, photografische usw. Erzeugnisse",4183760000,2629967000,6813727000
2016,1,WA91,Uhrmacherwaren,123395000,193693000,317088000
2016,1,WA92,Musikinstrumente,39220000,45257000,84477000
2016,1,WA93,Waffen und Munition,26570000,15166000,41736000
2016,1,WA94,"Möbel, Beleuchtungskörper usw.",1084874000,1534108000,2618982000
2016,1,WA95,"Spielzeug, Spiele usw., Sportgeräte",257986000,440499000,698485000
2016,1,WA96,Verschiedene Waren,321914000,206622000,528536000
2016,1,WA97,"Kunstgegenstände, Sammlungsstücke",54158000,31268000,85426000
2016,1,WA98,Vollständige Fabrikationsanlagen,205221000,246000,205467000
2016,1,WA99,Zusammenstellungen verschiedener Waren,1549541000,833451000,2382992000
2016,2,WA01,Lebende Tiere,109958000,150811000,260769000
2016,2,WA02,Fleisch,558007000,512342000,1070349000
2016,2,WA03,"Fische, Krebs- und Weichtiere",122551000,324193000,446744000
2016,2,WA04,"Milch, Milcherzeugnisse, Eier, Honig",626434000,558153000,1184587000
2016,2,WA05,Andere Waren tierischen Ursprungs,64276000,66474000,130750000
2016,2,WA06,"Pflanzen, Waren des Blumenhandels",63690000,246728000,310418000
2016,2,WA07,"Gemüse, Pflanzen für Ernährung",85935000,522464000,608399000
2016,2,WA08,Genießbare Früchte und Nüsse,149775000,715237000,865012000
2016,2,WA09,"Kaffee, Tee, Mate, Gewürze",208376000,330315000,538691000
2016,2,WA10,Getreide,218299000,256573000,474872000
2016,2,WA11,"Müllereierzeugnisse, Malz usw.",121635000,45088000,166723000
2016,2,WA12,"Ölsamen usw., Heilpflanzen usw.",163743000,431407000,595150000
2016,2,WA13,"Schellack, Gummen, Harz, Pflanzensaft",48036000,45531000,93567000
2016,2,WA14,Flechtstoffe usw. pflanzlichen Ursprungs,668000,3426000,4094000
2016,2,WA15,"Tierische und pflanzliche Fette, Öle, Wachs",240301000,302884000,543185000
2016,2,WA16,"Zubereitungen von Fleisch, Fisch usw.",232364000,198017000,430381000
2016,2,WA17,Zucker und Zuckerwaren,149324000,140357000,289681000
2016,2,WA18,Kakao und Zubereitungen aus Kakao,393268000,362498000,755766000
2016,2,WA19,"Zubereitungen aus Getreide usw., Backwaren",452312000,321812000,774124000
2016,2,WA20,"Zubereitungen von Gemüse, Früchten usw.",203966000,370215000,574181000
2016,2,WA21,Verschiedene Lebensmittelzubereitungen,410473000,255882000,666355000
2016,2,WA22,"Getränke, alkoholhaltige Flüssigkeiten, Essig",400013000,474526000,874539000
2016,2,WA23,"Rückstände der Lebensmittelindustrie, Futter",314437000,301581000,616018000
2016,2,WA24,Tabak,375004000,160098000,535102000
2016,2,WA25,"Salz, Schwefel, Steine, Erden usw.",165495000,153179000,318674000
2016,2,WA26,"Erze, Schlacken, Aschen",25381000,461735000,487116000
2016,2,WA27,Mineralische Brennstoffe usw.,1714262000,5238155000,6952417000
2016,2,WA28,Anorganische chemische Erzeugnisse,662628000,478539000,1141167000
2016,2,WA29,Organische chemische Erzeugnisse,1909294000,2569815000,4479109000
2016,2,WA30,Pharmazeutische Erzeugnisse,5573479000,3665821000,9239300000
2016,2,WA31,Düngemittel,229507000,155401000,384908000
2016,2,WA32,"Gerb- und Farbstoffe, Farben, Lacke usw.",896263000,475992000,1372255000
2016,2,WA33,"Etherische Öle, Riech-, Schönheitsmittel",744781000,532343000,1277124000
2016,2,WA34,"Seifen, Waschmittel usw.",587239000,291112000,878351000
2016,2,WA35,"Eiweißstoffe, Klebstoffe, Enzyme",257966000,166138000,424104000
2016,2,WA36,"Sprengstoffe, pyrotechnische Artikel usw.",19888000,11623000,31511000
2016,2,WA37,Photochemische Erzeugnisse,102433000,63256000,165689000
2016,2,WA38,Verschiedene Erzeugnisse der Chemischen Industrie,1826238000,1108193000,2934431000
2016,2,WA39,Kunststoffe und Waren daraus,4672090000,3074663000,7746753000
2016,2,WA40,Kautschuk und Waren daraus,1182263000,1143075000,2325338000
2016,2,WA41,"Häute, Felle, Leder",91296000,72438000,163734000
2016,2,WA42,"Lederwaren, Sattlerwaren",162710000,348515000,511225000
2016,2,WA43,"Pelzfelle, künstliches Pelzwerk",10481000,8053000,18534000
2016,2,WA44,"Holz, Holzwaren, Holzkohle",609077000,635232000,1244309000
2016,2,WA45,"Kork, Korkwaren",2419000,9194000,11613000
2016,2,WA46,"Flechtwaren, Korbmacherwaren",4535000,12694000,17229000
2016,2,WA47,"Halbstoffe aus Holz usw., Papierabfall",104118000,324051000,428169000
2016,2,WA48,"Papier, Pappe und Waren daraus",1458435000,1035218000,2493653000
2016,2,WA49,"Bücher, Zeitungen, Bilddrucke usw.",337014000,223212000,560226000
2016,2,WA50,Seide,4041000,4235000,8276000
2016,2,WA51,"Wolle, feine und grobe Tierhaare",45830000,48100000,93930000
2016,2,WA52,Baumwolle,73112000,74881000,147993000
2016,2,WA53,"Andere pflanzliche Spinnstoffe, Papiergarn",4389000,6792000,11181000
2016,2,WA54,Synthetisches oder künstliches Filament,163155000,127533000,290688000
2016,2,WA55,Synthetische oder künstliche Spinnfaser,152117000,132729000,284846000
2016,2,WA56,"Watte, Filz, Vliesstoff usw., Tauwerk",185673000,113632000,299305000
2016,2,WA57,"Teppiche, Fußbodenbelag aus Spinnstoff",44974000,99014000,143988000
2016,2,WA58,"Spezialgewebe, Spitzen, Tapisserien",39627000,23533000,63160000
2016,2,WA59,"Getränkte, bestrichene usw. Gewebe",196477000,97075000,293552000
2016,2,WA60,Gewirke und Gestricke,66162000,37596000,103758000
2016,2,WA61,"Bekleidung usw. aus Gewirken, Gestricken",625692000,1292055000,1917747000
2016,2,WA62,"Andere Bekleidung, Bekleidungszubehör",774629000,1488876000,2263505000
2016,2,WA63,"Andere Konfektion, Spinnstoffwaren usw.",201190000,336490000,537680000
2016,2,WA64,"Schuhe, Gamaschen, ähnliche Waren",541295000,1033209000,1574504000
2016,2,WA65,Kopfbedeckungen und Teile davon,32724000,51156000,83880000
2016,2,WA66,"Schirme, Gehstöcke usw., Peitschen",16577000,33422000,49999000
2016,2,WA67,"Zugerichtete Federn, Daunen, künstliche Blumen",11091000,16098000,27189000
2016,2,WA68,"Waren aus Steinen, Gips, Zement usw.",349054000,253580000,602634000
2016,2,WA69,Keramische Waren,253915000,234807000,488722000
2016,2,WA70,Glas und Glaswaren,492309000,417266000,909575000
2016,2,WA71,"Perlen, Edelsteine, Edelmetalle",803682000,1081684000,1885366000
2016,2,WA72,Eisen und Stahl,1583626000,1727772000,3311398000
2016,2,WA73,Waren aus Eisen oder Stahl,2091990000,1620832000,3712822000
2016,2,WA74,Kupfer und Waren daraus,820957000,792473000,1613430000
2016,2,WA75,Nickel und Waren daraus,81018000,96887000,177905000
2016,2,WA76,Aluminium und Waren daraus,1122337000,1260487000,2382824000
2016,2,WA78,Blei und Waren daraus,28774000,26626000,55400000
2016,2,WA79,Zink und Waren daraus,46171000,93885000,140056000
2016,2,WA80,Zinn und Waren daraus,9269000,31654000,40923000
2016,2,WA81,"Andere unedle Metalle, Cermets usw.",120435000,131973000,252408000
2016,2,WA82,"Werkzeuge, Schneidwaren, Essbestecke",646735000,392448000,1039183000
2016,2,WA83,Verschiedene Waren aus unedlen Metallen,616658000,381204000,997862000
2016,2,WA84,"Maschinen, Apparate, mechanische Geräte",16041928000,10279266000,26321194000
2016,2,WA85,Elektrotechnische Erzeugnisse,9676388000,9450056000,19126444000
2016,2,WA86,Schienenfahrzeuge,304904000,175176000,480080000
2016,2,WA87,"Kraftfahrzeuge, Landfahrzeuge",19202852000,8235981000,27438833000
2016,2,WA88,"Luftfahrzeuge, Raumfahrzeuge",2885472000,1839930000,4725402000
2016,2,WA89,Wasserfahrzeuge,475963000,152852000,628815000
2016,2,WA90,"Optische, photografische usw. Erzeugnisse",4547348000,2860664000,7408012000
2016,2,WA91,Uhrmacherwaren,154649000,180262000,334911000
2016,2,WA92,Musikinstrumente,42005000,44931000,86936000
2016,2,WA93,Waffen und Munition,40253000,20695000,60948000
2016,2,WA94,"Möbel, Beleuchtungskörper usw.",1308542000,1718315000,3026857000
2016,2,WA95,"Spielzeug, Spiele usw., Sportgeräte",328501000,460541000,789042000
2016,2,WA96,Verschiedene Waren,301524000,227357000,528881000
2016,2,WA97,"Kunstgegenstände, Sammlungsstücke",66918000,47978000,114896000
2016,2,WA98,Vollständige Fabrikationsanlagen,219874000,902000,220776000
2016,2,WA99,Zusammenstellungen verschiedener Waren,1662661000,838972000,2501633000
2016,3,WA01,Lebende Tiere,114282000,162172000,276454000
2016,3,WA02,Fleisch,585539000,527185000,1112724000
2016,3,WA03,"Fische, Krebs- und Weichtiere",129623000,330527000,460150000
2016,3,WA04,"Milch, Milcherzeugnisse, Eier, Honig",687115000,567749000,1254864000
2016,3,WA05,Andere Waren tierischen Ursprungs,59511000,72735000,132246000
2016,3,WA06,"Pflanzen, Waren des Blumenhandels",107732000,310124000,417856000
2016,3,WA07,"Gemüse, Pflanzen für Ernährung",89743000,617458000,707201000
2016,3,WA08,Genießbare Früchte und Nüsse,156082000,747781000,903863000
2016,3,WA09,"Kaffee, Tee, Mate, Gewürze",229368000,337416000,566784000
2016,3,WA10,Getreide,288415000,241307000,529722000
2016,3,WA11,"Müllereierzeugnisse, Malz usw.",118803000,47561000,166364000
2016,3,WA12,"Ölsamen usw., Heilpflanzen usw.",176269000,378602000,554871000
2016,3,WA13,"Schellack, Gummen, Harz, Pflanzensaft",53835000,48953000,102788000
2016,3,WA14,Flechtstoffe usw. pflanzlichen Ursprungs,565000,3113000,3678000
2016,3,WA15,"Tierische und pflanzliche Fette, Öle, Wachs",219347000,297812000,517159000
2016,3,WA16,"Zubereitungen von Fleisch, Fisch usw.",231293000,207785000,439078000
2016,3,WA17,Zucker und Zuckerwaren,157320000,139037000,296357000
2016,3,WA18,Kakao und Zubereitungen aus Kakao,352307000,368179000,720486000
2016,3,WA19,"Zubereitungen aus Getreide usw., Backwaren",478045000,336564000,814609000
2016,3,WA20,"Zubereitungen von Gemüse, Früchten usw.",219539000,364677000,584216000
2016,3,WA21,Verschiedene Lebensmittelzubereitungen,448923000,276257000,725180000
2016,3,WA22,"Getränke, alkoholhaltige Flüssigkeiten, Essig",467204000,527036000,994240000
2016,3,WA23,"Rückstände der Lebensmittelindustrie, Futter",321073000,289337000,610410000
2016,3,WA24,Tabak,401308000,185498000,586806000
2016,3,WA25,"Salz, Schwefel, Steine, Erden usw.",177328000,150222000,327550000
2016,3,WA26,"Erze, Schlacken, Aschen",29531000,434817000,464348000
2016,3,WA27,Mineralische Brennstoffe usw.,1696201000,5643365000,7339566000
2016,3,WA28,Anorganische chemische Erzeugnisse,656113000,480870000,1136983000
2016,3,WA29,Organische chemische Erzeugnisse,1947700000,2380897000,4328597000
2016,3,WA30,Pharmazeutische Erzeugnisse,6114517000,3684788000,9799305000
2016,3,WA31,Düngemittel,204107000,127250000,331357000
2016,3,WA32,"Gerb- und Farbstoffe, Farben, Lacke usw.",955822000,488100000,1443922000
2016,3,WA33,"Etherische Öle, Riech-, Schönheitsmittel",788268000,549755000,1338023000
2016,3,WA34,"Seifen, Waschmittel usw.",601646000,319877000,921523000
2016,3,WA35,"Eiweißstoffe, Klebstoffe, Enzyme",263348000,167882000,431230000
2016,3,WA36,"Sprengstoffe, pyrotechnische Artikel usw.",21549000,14412000,35961000
2016,3,WA37,Photochemische Erzeugnisse,111440000,67083000,178523000
2016,3,WA38,Verschiedene Erzeugnisse der Chemischen Industrie,1923802000,1139499000,3063301000
2016,3,WA39,Kunststoffe und Waren daraus,4832685000,3187106000,8019791000
2016,3,WA40,Kautschuk und Waren daraus,1244279000,1194949000,2439228000
2016,3,WA41,"Häute, Felle, Leder",93113000,68644000,161757000
2016,3,WA42,"Lederwaren, Sattlerwaren",167738000,318688000,486426000
2016,3,WA43,"Pelzfelle, künstliches Pelzwerk",7029000,10454000,17483000
2016,3,WA44,"Holz, Holzwaren, Holzkohle",645224000,678871000,1324095000
2016,3,WA45,"Kork, Korkwaren",3104000,9643000,12747000
2016,3,WA46,"Flechtwaren, Korbmacherwaren",6446000,13381000,19827000
2016,3,WA47,"Halbstoffe aus Holz usw., Papierabfall",105973000,338790000,444763000
2016,3,WA48,"Papier, Pappe und Waren daraus",1493056000,1021521000,2514577000
2016,3,WA49,"Bücher, Zeitungen, Bilddrucke usw.",358318000,214762000,573080000
2016,3,WA50,Seide,4138000,3796000,7934000
2016,3,WA51,"Wolle, feine und grobe Tierhaare",55843000,63046000,118889000
2016,3,WA52,Baumwolle,73477000,78493000,151970000
2016,3,WA53,"Andere pflanzliche Spinnstoffe, Papiergarn",3715000,7196000,10911000
2016,3,WA54,Synthetisches oder künstliches Filament,166446000,131008000,297454000
2016,3,WA55,Synthetische oder künstliche Spinnfaser,151258000,129032000,280290000
2016,3,WA56,"Watte, Filz, Vliesstoff usw., Tauwerk",213706000,122865000,336571000
2016,3,WA57,"Teppiche, Fußbodenbelag aus Spinnstoff",48085000,98516000,146601000
2016,3,WA58,"Spezialgewebe, Spitzen, Tapisserien",44699000,23760000,68459000
2016,3,WA59,"Getränkte, bestrichene usw. Gewebe",207564000,100106000,307670000
2016,3,WA60,Gewirke und Gestricke,74913000,42488000,117401000
2016,3,WA61,"Bekleidung usw. aus Gewirken, Gestricken",607477000,1196234000,1803711000
2016,3,WA62,"Andere Bekleidung, Bekleidungszubehör",725897000,1375701000,2101598000
2016,3,WA63,"Andere Konfektion, Spinnstoffwaren usw.",239682000,325590000,565272000
2016,3,WA64,"Schuhe, Gamaschen, ähnliche Waren",489943000,866857000,1356800000
2016,3,WA65,Kopfbedeckungen und Teile davon,30964000,49078000,80042000
2016,3,WA66,"Schirme, Gehstöcke usw., Peitschen",25037000,24023000,49060000
2016,3,WA67,"Zugerichtete Federn, Daunen, künstliche Blumen",10820000,13145000,23965000
2016,3,WA68,"Waren aus Steinen, Gips, Zement usw.",375245000,253783000,629028000
2016,3,WA69,Keramische Waren,267948000,242049000,509997000
2016,3,WA70,Glas und Glaswaren,525072000,439338000,964410000
2016,3,WA71,"Perlen, Edelsteine, Edelmetalle",1069901000,1314756000,2384657000
2016,3,WA72,Eisen und Stahl,1593310000,1638340000,3231650000
2016,3,WA73,Waren aus Eisen oder Stahl,2149260000,1676358000,3825618000
2016,3,WA74,Kupfer und Waren daraus,810675000,727795000,1538470000
2016,3,WA75,Nickel und Waren daraus,71027000,94708000,165735000
2016,3,WA76,Aluminium und Waren daraus,1203381000,1278168000,2481549000
2016,3,WA78,Blei und Waren daraus,21464000,17913000,39377000
2016,3,WA79,Zink und Waren daraus,49171000,91577000,140748000
2016,3,WA80,Zinn und Waren daraus,7672000,32742000,40414000
2016,3,WA81,"Andere unedle Metalle, Cermets usw.",115989000,139892000,255881000
2016,3,WA82,"Werkzeuge, Schneidwaren, Essbestecke",662393000,397807000,1060200000
2016,3,WA83,Verschiedene Waren aus unedlen Metallen,610327000,395089000,1005416000
2016,3,WA84,"Maschinen, Apparate, mechanische Geräte",17814415000,10719138000,28533553000
2016,3,WA85,Elektrotechnische Erzeugnisse,10629203000,9773765000,20402968000
2016,3,WA86,Schienenfahrzeuge,348077000,232971000,581048000
2016,3,WA87,"Kraftfahrzeuge, Landfahrzeuge",19633052000,8645374000,28278426000
2016,3,WA88,"Luftfahrzeuge, Raumfahrzeuge",3879258000,1570843000,5450101000
2016,3,WA89,Wasserfahrzeuge,885223000,173360000,1058583000
2016,3,WA90,"Optische, photografische usw. Erzeugnisse",5044671000,2966193000,8010864000
2016,3,WA91,Uhrmacherwaren,139556000,170434000,309990000
2016,3,WA92,Musikinstrumente,43525000,43719000,87244000
2016,3,WA93,Waffen und Munition,37521000,18858000,56379000
2016,3,WA94,"Möbel, Beleuchtungskörper usw.",1328278000,1627117000,2955395000
2016,3,WA95,"Spielzeug, Spiele usw., Sportgeräte",398131000,429973000,828104000
2016,3,WA96,Verschiedene Waren,325346000,226914000,552260000
2016,3,WA97,"Kunstgegenstände, Sammlungsstücke",52449000,51149000,103598000
2016,3,WA98,Vollständige Fabrikationsanlagen,239404000,100000,239504000
2016,3,WA99,Zusammenstellungen verschiedener Waren,2416389000,875347000,3291736000
2016,4,WA01,Lebende Tiere,122441000,154374000,276815000
2016,4,WA02,Fleisch,583836000,497561000,1081397000
2016,4,WA03,"Fische, Krebs- und Weichtiere",118408000,318428000,436836000
2016,4,WA04,"Milch, Milcherzeugnisse, Eier, Honig",613873000,553735000,1167608000
2016,4,WA05,Andere Waren tierischen Ursprungs,65244000,63492000,128736000
2016,4,WA06,"Pflanzen, Waren des Blumenhandels",125945000,318081000,444026000
2016,4,WA07,"Gemüse, Pflanzen für Ernährung",110581000,608942000,719523000
2016,4,WA08,Genießbare Früchte und Nüsse,151997000,753604000,905601000
2016,4,WA09,"Kaffee, Tee, Mate, Gewürze",219400000,349128000,568528000
2016,4,WA10,Getreide,294793000,216745000,511538000
2016,4,WA11,"Müllereierzeugnisse, Malz usw.",121479000,41958000,163437000
2016,4,WA12,"Ölsamen usw., Heilpflanzen usw.",92664000,401547000,494211000
2016,4,WA13,"Schellack, Gummen, Harz, Pflanzensaft",54920000,46305000,101225000
2016,4,WA14,Flechtstoffe usw. pflanzlichen Ursprungs,712000,2959000,3671000
2016,4,WA15,"Tierische und pflanzliche Fette, Öle, Wachs",222672000,324786000,547458000
2016,4,WA16,"Zubereitungen von Fleisch, Fisch usw.",228063000,201840000,429903000
2016,4,WA17,Zucker und Zuckerwaren,156865000,128708000,285573000
2016,4,WA18,Kakao und Zubereitungen aus Kakao,373392000,413865000,787257000
2016,4,WA19,"Zubereitungen aus Getreide usw., Backwaren",484444000,328430000,812874000
2016,4,WA20,"Zubereitungen von Gemüse, Früchten usw.",227585000,390072000,617657000
2016,4,WA21,Verschiedene Lebensmittelzubereitungen,469609000,259839000,729448000
2016,4,WA22,"Getränke, alkoholhaltige Flüssigkeiten, Essig",487489000,559311000,1046800000
2016,4,WA23,"Rückstände der Lebensmittelindustrie, Futter",322889000,302671000,625560000
2016,4,WA24,Tabak,390114000,175257000,565371000
2016,4,WA25,"Salz, Schwefel, Steine, Erden usw.",182622000,157828000,340450000
2016,4,WA26,"Erze, Schlacken, Aschen",27261000,494188000,521449000
2016,4,WA27,Mineralische Brennstoffe usw.,1554413000,5273744000,6828157000
2016,4,WA28,Anorganische chemische Erzeugnisse,715066000,517920000,1232986000
2016,4,WA29,Organische chemische Erzeugnisse,1843614000,2249522000,4093136000
2016,4,WA30,Pharmazeutische Erzeugnisse,5484046000,3405833000,8889879000
2016,4,WA31,Düngemittel,198313000,109262000,307575000
2016,4,WA32,"Gerb- und Farbstoffe, Farben, Lacke usw.",955138000,484051000,1439189000
2016,4,WA33,"Etherische Öle, Riech-, Schönheitsmittel",780911000,512098000,1293009000
2016,4,WA34,"Seifen, Waschmittel usw.",592286000,292383000,884669000
2016,4,WA35,"Eiweißstoffe, Klebstoffe, Enzyme",256582000,154180000,410762000
2016,4,WA36,"Sprengstoffe, pyrotechnische Artikel usw.",21984000,11789000,33773000
2016,4,WA37,Photochemische Erzeugnisse,100411000,61499000,161910000
2016,4,WA38,Verschiedene Erzeugnisse der Chemischen Industrie,1822800000,1085183000,2907983000
2016,4,WA39,Kunststoffe und Waren daraus,4884897000,3082727000,7967624000
2016,4,WA40,Kautschuk und Waren daraus,1256493000,1203844000,2460337000
2016,4,WA41,"Häute, Felle, Leder",90148000,75749000,165897000
2016,4,WA42,"Lederwaren, Sattlerwaren",157784000,292690000,450474000
2016,4,WA43,"Pelzfelle, künstliches Pelzwerk",7613000,7460000,15073000
2016,4,WA44,"Holz, Holzwaren, Holzkohle",638617000,636873000,1275490000
2016,4,WA45,"Kork, Korkwaren",2824000,10243000,13067000
2016,4,WA46,"Flechtwaren, Korbmacherwaren",5963000,10632000,16595000
2016,4,WA47,"Halbstoffe aus Holz usw., Papierabfall",99255000,296321000,395576000
2016,4,WA48,"Papier, Pappe und Waren daraus",1459730000,1004817000,2464547000
2016,4,WA49,"Bücher, Zeitungen, Bilddrucke usw.",339139000,203578000,542717000
2016,4,WA50,Seide,4000000,3872000,7872000
2016,4,WA51,"Wolle, feine und grobe Tierhaare",55710000,62269000,117979000
2016,4,WA52,Baumwolle,76075000,76292000,152367000
2016,4,WA53,"Andere pflanzliche Spinnstoffe, Papiergarn",3032000,6259000,9291000
2016,4,WA54,Synthetisches oder künstliches Filament,160192000,129449000,289641000
2016,4,WA55,Synthetische oder künstliche Spinnfaser,148208000,128240000,276448000
2016,4,WA56,"Watte, Filz, Vliesstoff usw., Tauwerk",207082000,118520000,325602000
2016,4,WA57,"Teppiche, Fußbodenbelag aus Spinnstoff",47328000,91520000,138848000
2016,4,WA58,"Spezialgewebe, Spitzen, Tapisserien",43877000,22875000,66752000
2016,4,WA59,"Getränkte, bestrichene usw. Gewebe",201518000,96055000,297573000
2016,4,WA60,Gewirke und Gestricke,76973000,46506000,123479000
2016,4,WA61,"Bekleidung usw. aus Gewirken, Gestricken",526689000,1070746000,1597435000
2016,4,WA62,"Andere Bekleidung, Bekleidungszubehör",599553000,1117941000,1717494000
2016,4,WA63,"Andere Konfektion, Spinnstoffwaren usw.",220586000,302691000,523277000
2016,4,WA64,"Schuhe, Gamaschen, ähnliche Waren",380617000,676808000,1057425000
2016,4,WA65,Kopfbedeckungen und Teile davon,32517000,34539000,67056000
2016,4,WA66,"Schirme, Gehstöcke usw., Peitschen",13619000,17896000,31515000
2016,4,WA67,"Zugerichtete Federn, Daunen, künstliche Blumen",7926000,10692000,18618000
2016,4,WA68,"Waren aus Steinen, Gips, Zement usw.",392118000,268394000,660512000
2016,4,WA69,Keramische Waren,271558000,240773000,512331000
2016,4,WA70,Glas und Glaswaren,519521000,413321000,932842000
2016,4,WA71,"Perlen, Edelsteine, Edelmetalle",895766000,1147635000,2043401000
2016,4,WA72,Eisen und Stahl,1701126000,1713055000,3414181000
2016,4,WA73,Waren aus Eisen oder Stahl,2241720000,1628186000,3869906000
2016,4,WA74,Kupfer und Waren daraus,802510000,712904000,1515414000
2016,4,WA75,Nickel und Waren daraus,72419000,88944000,161363000
2016,4,WA76,Aluminium und Waren daraus,1193915000,1281938000,2475853000
2016,4,WA78,Blei und Waren daraus,34305000,32637000,66942000
2016,4,WA79,Zink und Waren daraus,47059000,114138000,161197000
2016,4,WA80,Zinn und Waren daraus,7994000,30808000,38802000
2016,4,WA81,"Andere unedle Metalle, Cermets usw.",106828000,135872000,242700000
2016,4,WA82,"Werkzeuge, Schneidwaren, Essbestecke",695937000,383841000,1079778000
2016,4,WA83,Verschiedene Waren aus unedlen Metallen,620866000,375475000,996341000
2016,4,WA84,"Maschinen, Apparate, mechanische Geräte",17649993000,10517688000,28167681000
2016,4,WA85,Elektrotechnische Erzeugnisse,10202421000,9470712000,19673133000
2016,4,WA86,Schienenfahrzeuge,343938000,183532000,527470000
2016,4,WA87,"Kraftfahrzeuge, Landfahrzeuge",20447804000,8744816000,29192620000
2016,4,WA88,"Luftfahrzeuge, Raumfahrzeuge",3747232000,1597132000,5344364000
2016,4,WA89,Wasserfahrzeuge,433636000,435727000,869363000
2016,4,WA90,"Optische, photografische usw. Erzeugnisse",4843953000,2867232000,7711185000
2016,4,WA91,Uhrmacherwaren,149014000,163209000,312223000
2016,4,WA92,Musikinstrumente,48692000,43935000,92627000
2016,4,WA93,Waffen und Munition,43982000,24196000,68178000
2016,4,WA94,"Möbel, Beleuchtungskörper usw.",1328802000,1546504000,2875306000
2016,4,WA95,"Spielzeug, Spiele usw., Sportgeräte",282435000,361394000,643829000
2016,4,WA96,Verschiedene Waren,334575000,203015000,537590000
2016,4,WA97,"Kunstgegenstände, Sammlungsstücke",56454000,42857000,99311000
2016,4,WA98,Vollständige Fabrikationsanlagen,230494000,185000,230679000
2016,4,WA99,Zusammenstellungen verschiedener Waren,1872344000,927326000,2799670000
2016,5,WA01,Lebende Tiere,127441000,163168000,290609000
2016,5,WA02,Fleisch,610470000,522801000,1133271000
2016,5,WA03,"Fische, Krebs- und Weichtiere",133860000,301387000,435247000
2016,5,WA04,"Milch, Milcherzeugnisse, Eier, Honig",607230000,526971000,1134201000
2016,5,WA05,Andere Waren tierischen Ursprungs,67063000,73352000,140415000
2016,5,WA06,"Pflanzen, Waren des Blumenhandels",114359000,350704000,465063000
2016,5,WA07,"Gemüse, Pflanzen für Ernährung",84450000,556491000,640941000
2016,5,WA08,Genießbare Früchte und Nüsse,165751000,787149000,952900000
2016,5,WA09,"Kaffee, Tee, Mate, Gewürze",213590000,338926000,552516000
2016,5,WA10,Getreide,213027000,177618000,390645000
2016,5,WA11,"Müllereierzeugnisse, Malz usw.",128543000,45649000,174192000
2016,5,WA12,"Ölsamen usw., Heilpflanzen usw.",76881000,393023000,469904000
2016,5,WA13,"Schellack, Gummen, Harz, Pflanzensaft",49541000,41877000,91418000
2016,5,WA14,Flechtstoffe usw. pflanzlichen Ursprungs,744000,3823000,4567000
2016,5,WA15,"Tierische und pflanzliche Fette, Öle, Wachs",236964000,306423000,543387000
2016,5,WA16,"Zubereitungen von Fleisch, Fisch usw.",246682000,215574000,462256000
2016,5,WA17,Zucker und Zuckerwaren,155634000,132296000,287930000
2016,5,WA18,Kakao und Zubereitungen aus Kakao,332022000,337456000,669478000
2016,5,WA19,"Zubereitungen aus Getreide usw., Backwaren",469261000,339219000,808480000
2016,5,WA20,"Zubereitungen von Gemüse, Früchten usw.",210601000,385204000,595805000
2016,5,WA21,Verschiedene Lebensmittelzubereitungen,458926000,273497000,732423000
2016,5,WA22,"Getränke, alkoholhaltige Flüssigkeiten, Essig",504648000,565990000,1070638000
2016,5,WA23,"Rückstände der Lebensmittelindustrie, Futter",303522000,318220000,621742000
2016,5,WA24,Tabak,391611000,196048000,587659000
2016,5,WA25,"Salz, Schwefel, Steine, Erden usw.",168028000,147452000,315480000
2016,5,WA26,"Erze, Schlacken, Aschen",28355000,452617000,480972000
2016,5,WA27,Mineralische Brennstoffe usw.,1602153000,5279907000,6882060000
2016,5,WA28,Anorganische chemische Erzeugnisse,691209000,500153000,1191362000
2016,5,WA29,Organische chemische Erzeugnisse,1889813000,1750538000,3640351000
2016,5,WA30,Pharmazeutische Erzeugnisse,5454725000,3625596000,9080321000
2016,5,WA31,Düngemittel,161862000,74142000,236004000
2016,5,WA32,"Gerb- und Farbstoffe, Farben, Lacke usw.",931285000,491306000,1422591000
2016,5,WA33,"Etherische Öle, Riech-, Schönheitsmittel",711621000,547978000,1259599000
2016,5,WA34,"Seifen, Waschmittel usw.",580446000,301163000,881609000
2016,5,WA35,"Eiweißstoffe, Klebstoffe, Enzyme",248887000,152292000,401179000
2016,5,WA36,"Sprengstoffe, pyrotechnische Artikel usw.",25117000,15823000,40940000
2016,5,WA37,Photochemische Erzeugnisse,105039000,63776000,168815000
2016,5,WA38,Verschiedene Erzeugnisse der Chemischen Industrie,1711613000,1003097000,2714710000
2016,5,WA39,Kunststoffe und Waren daraus,4676165000,3056768000,7732933000
2016,5,WA40,Kautschuk und Waren daraus,1175214000,1076975000,2252189000
2016,5,WA41,"Häute, Felle, Leder",79701000,70069000,149770000
2016,5,WA42,"Lederwaren, Sattlerwaren",151172000,320840000,472012000
2016,5,WA43,"Pelzfelle, künstliches Pelzwerk",8777000,11817000,20594000
2016,5,WA44,"Holz, Holzwaren, Holzkohle",635706000,665345000,1301051000
2016,5,WA45,"Kork, Korkwaren",2319000,8664000,10983000
2016,5,WA46,"Flechtwaren, Korbmacherwaren",4305000,10008000,14313000
2016,5,WA47,"Halbstoffe aus Holz usw., Papierabfall",101749000,314665000,416414000
2016,5,WA48,"Papier, Pappe und Waren daraus",1422885000,962383000,2385268000
2016,5,WA49,"Bücher, Zeitungen, Bilddrucke usw.",317132000,212740000,529872000
2016,5,WA50,Seide,4568000,5204000,9772000
2016,5,WA51,"Wolle, feine und grobe Tierhaare",44073000,60497000,104570000
2016,5,WA52,Baumwolle,71067000,79622000,150689000
2016,5,WA53,"Andere pflanzliche Spinnstoffe, Papiergarn",2922000,5570000,8492000
2016,5,WA54,Synthetisches oder künstliches Filament,159643000,126551000,286194000
2016,5,WA55,Synthetische oder künstliche Spinnfaser,152587000,133275000,285862000
2016,5,WA56,"Watte, Filz, Vliesstoff usw., Tauwerk",198205000,114104000,312309000
2016,5,WA57,"Teppiche, Fußbodenbelag aus Spinnstoff",41320000,84711000,126031000
2016,5,WA58,"Spezialgewebe, Spitzen, Tapisserien",42598000,25134000,67732000
2016,5,WA59,"Getränkte, bestrichene usw. Gewebe",194801000,98648000,293449000
2016,5,WA60,Gewirke und Gestricke,72071000,46062000,118133000
2016,5,WA61,"Bekleidung usw. aus Gewirken, Gestricken",480388000,1088401000,1568789000
2016,5,WA62,"Andere Bekleidung, Bekleidungszubehör",503634000,1122930000,1626564000
2016,5,WA63,"Andere Konfektion, Spinnstoffwaren usw.",208104000,309835000,517939000
2016,5,WA64,"Schuhe, Gamaschen, ähnliche Waren",322007000,713562000,1035569000
2016,5,WA65,Kopfbedeckungen und Teile davon,26444000,40386000,66830000
2016,5,WA66,"Schirme, Gehstöcke usw., Peitschen",8278000,18523000,26801000
2016,5,WA67,"Zugerichtete Federn, Daunen, künstliche Blumen",7265000,12460000,19725000
2016,5,WA68,"Waren aus Steinen, Gips, Zement usw.",356298000,261361000,617659000
2016,5,WA69,Keramische Waren,262972000,230483000,493455000
2016,5,WA70,Glas und Glaswaren,491353000,416044000,907397000
2016,5,WA71,"Perlen, Edelsteine, Edelmetalle",881745000,1054484000,1936229000
2016,5,WA72,Eisen und Stahl,1654584000,1657349000,3311933000
2016,5,WA73,Waren aus Eisen oder Stahl,2085743000,1584571000,3670314000
2016,5,WA74,Kupfer und Waren daraus,713174000,612287000,1325461000
2016,5,WA75,Nickel und Waren daraus,67870000,85384000,153254000
2016,5,WA76,Aluminium und Waren daraus,1144919000,1304473000,2449392000
2016,5,WA78,Blei und Waren daraus,25061000,27833000,52894000
2016,5,WA79,Zink und Waren daraus,47619000,101277000,148896000
2016,5,WA80,Zinn und Waren daraus,8054000,27634000,35688000
2016,5,WA81,"Andere unedle Metalle, Cermets usw.",111015000,134646000,245661000
2016,5,WA82,"Werkzeuge, Schneidwaren, Essbestecke",616077000,392941000,1009018000
2016,5,WA83,Verschiedene Waren aus unedlen Metallen,607044000,371379000,978423000
2016,5,WA84,"Maschinen, Apparate, mechanische Geräte",15945168000,9904863000,25850031000
2016,5,WA85,Elektrotechnische Erzeugnisse,9902306000,9266853000,19169159000
2016,5,WA86,Schienenfahrzeuge,284440000,212191000,496631000
2016,5,WA87,"Kraftfahrzeuge, Landfahrzeuge",17552574000,8391673000,25944247000
2016,5,WA88,"Luftfahrzeuge, Raumfahrzeuge",3274969000,1669361000,4944330000
2016,5,WA89,Wasserfahrzeuge,918737000,69568000,988305000
2016,5,WA90,"Optische, photografische usw. Erzeugnisse",4566077000,2742807000,7308884000
2016,5,WA91,Uhrmacherwaren,125094000,155356000,280450000
2016,5,WA92,Musikinstrumente,44882000,47172000,92054000
2016,5,WA93,Waffen und Munition,43762000,21230000,64992000
2016,5,WA94,"Möbel, Beleuchtungskörper usw.",1196857000,1469152000,2666009000
2016,5,WA95,"Spielzeug, Spiele usw., Sportgeräte",270693000,393571000,664264000
2016,5,WA96,Verschiedene Waren,304818000,213496000,518314000
2016,5,WA97,"Kunstgegenstände, Sammlungsstücke",53146000,44050000,97196000
2016,5,WA98,Vollständige Fabrikationsanlagen,205158000,1900000,207058000
2016,5,WA99,Zusammenstellungen verschiedener Waren,1671915000,851748000,2523663000
2016,6,WA01,Lebende Tiere,126476000,169805000,296281000
2016,6,WA02,Fleisch,661563000,511273000,1172836000
2016,6,WA03,"Fische, Krebs- und Weichtiere",140778000,329085000,469863000
2016,6,WA04,"Milch, Milcherzeugnisse, Eier, Honig",739970000,554789000,1294759000
2016,6,WA05,Andere Waren tierischen Ursprungs,66763000,65137000,131900000
2016,6,WA06,"Pflanzen, Waren des Blumenhandels",69362000,212129000,281491000
2016,6,WA07,"Gemüse, Pflanzen für Ernährung",79525000,491134000,570659000
2016,6,WA08,Genießbare Früchte und Nüsse,180553000,839576000,1020129000
2016,6,WA09,"Kaffee, Tee, Mate, Gewürze",214394000,320720000,535114000
2016,6,WA10,Getreide,241313000,194571000,435884000
2016,6,WA11,"Müllereierzeugnisse, Malz usw.",133934000,47544000,181478000
2016,6,WA12,"Ölsamen usw., Heilpflanzen usw.",97152000,362671000,459823000
2016,6,WA13,"Schellack, Gummen, Harz, Pflanzensaft",49022000,39818000,88840000
2016,6,WA14,Flechtstoffe usw. pflanzlichen Ursprungs,642000,3327000,3969000
2016,6,WA15,"Tierische und pflanzliche Fette, Öle, Wachs",231981000,329556000,561537000
2016,6,WA16,"Zubereitungen von Fleisch, Fisch usw.",231176000,202111000,433287000
2016,6,WA17,Zucker und Zuckerwaren,163747000,146088000,309835000
2016,6,WA18,Kakao und Zubereitungen aus Kakao,338820000,348037000,686857000
2016,6,WA19,"Zubereitungen aus Getreide usw., Backwaren",491933000,317939000,809872000
2016,6,WA20,"Zubereitungen von Gemüse, Früchten usw.",238921000,378473000,617394000
2016,6,WA21,Verschiedene Lebensmittelzubereitungen,496110000,283167000,779277000
2016,6,WA22,"Getränke, alkoholhaltige Flüssigkeiten, Essig",537758000,594385000,1132143000
2016,6,WA23,"Rückstände der Lebensmittelindustrie, Futter",378814000,307494000,686308000
2016,6,WA24,Tabak,369645000,135439000,505084000
2016,6,WA25,"Salz, Schwefel, Steine, Erden usw.",183851000,154937000,338788000
2016,6,WA26,"Erze, Schlacken, Aschen",34518000,575194000,609712000
2016,6,WA27,Mineralische Brennstoffe usw.,1579416000,5610149000,7189565000
2016,6,WA28,Anorganische chemische Erzeugnisse,701802000,472393000,1174195000
2016,6,WA29,Organische chemische Erzeugnisse,1914438000,2355085000,4269523000
2016,6,WA30,Pharmazeutische Erzeugnisse,6123086000,3611524000,9734610000
2016,6,WA31,Düngemittel,147587000,74705000,222292000
2016,6,WA32,"Gerb- und Farbstoffe, Farben, Lacke usw.",994167000,501316000,1495483000
2016,6,WA33,"Etherische Öle, Riech-, Schönheitsmittel",783305000,527625000,1310930000
2016,6,WA34,"Seifen, Waschmittel usw.",619152000,309003000,928155000
2016,6,WA35,"Eiweißstoffe, Klebstoffe, Enzyme",276702000,166952000,443654000
2016,6,WA36,"Sprengstoffe, pyrotechnische Artikel usw.",19222000,21886000,41108000
2016,6,WA37,Photochemische Erzeugnisse,93663000,63807000,157470000
2016,6,WA38,Verschiedene Erzeugnisse der Chemischen Industrie,1791588000,1001071000,2792659000
2016,6,WA39,Kunststoffe und Waren daraus,5008127000,3167525000,8175652000
2016,6,WA40,Kautschuk und Waren daraus,1245377000,1194513000,2439890000
2016,6,WA41,"Häute, Felle, Leder",81086000,72211000,153297000
2016,6,WA42,"Lederwaren, Sattlerwaren",180636000,359794000,540430000
2016,6,WA43,"Pelzfelle, künstliches Pelzwerk",8502000,12731000,21233000
2016,6,WA44,"Holz, Holzwaren, Holzkohle",647324000,643829000,1291153000
2016,6,WA45,"Kork, Korkwaren",2917000,10515000,13432000
2016,6,WA46,"Flechtwaren, Korbmacherwaren",4035000,9321000,13356000
2016,6,WA47,"Halbstoffe aus Holz usw., Papierabfall",85207000,312791000,397998000
2016,6,WA48,"Papier, Pappe und Waren daraus",1514002000,1020021000,2534023000
2016,6,WA49,"Bücher, Zeitungen, Bilddrucke usw.",325451000,201133000,526584000
2016,6,WA50,Seide,3977000,4081000,8058000
2016,6,WA51,"Wolle, feine und grobe Tierhaare",57952000,59330000,117282000
2016,6,WA52,Baumwolle,78212000,76993000,155205000
2016,6,WA53,"Andere pflanzliche Spinnstoffe, Papiergarn",2773000,5250000,8023000
2016,6,WA54,Synthetisches oder künstliches Filament,161889000,134042000,295931000
2016,6,WA55,Synthetische oder künstliche Spinnfaser,157953000,123672000,281625000
2016,6,WA56,"Watte, Filz, Vliesstoff usw., Tauwerk",207754000,112313000,320067000
2016,6,WA57,"Teppiche, Fußbodenbelag aus Spinnstoff",48250000,87018000,135268000
2016,6,WA58,"Spezialgewebe, Spitzen, Tapisserien",45502000,25148000,70650000
2016,6,WA59,"Getränkte, bestrichene usw. Gewebe",207323000,90815000,298138000
2016,6,WA60,Gewirke und Gestricke,72916000,42292000,115208000
2016,6,WA61,"Bekleidung usw. aus Gewirken, Gestricken",532056000,1257752000,1789808000
2016,6,WA62,"Andere Bekleidung, Bekleidungszubehör",538301000,1237398000,1775699000
2016,6,WA63,"Andere Konfektion, Spinnstoffwaren usw.",236418000,332383000,568801000
2016,6,WA64,"Schuhe, Gamaschen, ähnliche Waren",405600000,822503000,1228103000
2016,6,WA65,Kopfbedeckungen und Teile davon,23584000,38991000,62575000
2016,6,WA66,"Schirme, Gehstöcke usw., Peitschen",9884000,14848000,24732000
2016,6,WA67,"Zugerichtete Federn, Daunen, künstliche Blumen",8250000,14047000,22297000
2016,6,WA68,"Waren aus Steinen, Gips, Zement usw.",408518000,277055000,685573000
2016,6,WA69,Keramische Waren,279703000,235432000,515135000
2016,6,WA70,Glas und Glaswaren,517978000,458817000,976795000
2016,6,WA71,"Perlen, Edelsteine, Edelmetalle",1003634000,2056140000,3059774000
2016,6,WA72,Eisen und Stahl,1751763000,1862895000,3614658000
2016,6,WA73,Waren aus Eisen oder Stahl,2326965000,1691618000,4018583000
2016,6,WA74,Kupfer und Waren daraus,829362000,688818000,1518180000
2016,6,WA75,Nickel und Waren daraus,80525000,102431000,182956000
2016,6,WA76,Aluminium und Waren daraus,1218351000,1287669000,2506020000
2016,6,WA78,Blei und Waren daraus,26864000,24791000,51655000
2016,6,WA79,Zink und Waren daraus,54722000,100222000,154944000
2016,6,WA80,Zinn und Waren daraus,9938000,24413000,34351000
2016,6,WA81,"Andere unedle Metalle, Cermets usw.",116189000,154921000,271110000
2016,6,WA82,"Werkzeuge, Schneidwaren, Essbestecke",692019000,417172000,1109191000
2016,6,WA83,Verschiedene Waren aus unedlen Metallen,638060000,407410000,1045470000
2016,6,WA84,"Maschinen, Apparate, mechanische Geräte",17898330000,10670190000,28568520000
2016,6,WA85,Elektrotechnische Erzeugnisse,10643101000,10030210000,20673311000
2016,6,WA86,Schienenfahrzeuge,401619000,177850000,579469000
2016,6,WA87,"Kraftfahrzeuge, Landfahrzeuge",20203814000,9110157000,29313971000
2016,6,WA88,"Luftfahrzeuge, Raumfahrzeuge",3747695000,1637730000,5385425000
2016,6,WA89,Wasserfahrzeuge,213672000,160539000,374211000
2016,6,WA90,"Optische, photografische usw. Erzeugnisse",5226683000,2929416000,8156099000
2016,6,WA91,Uhrmacherwaren,154138000,168612000,322750000
2016,6,WA92,Musikinstrumente,46986000,44057000,91043000
2016,6,WA93,Waffen und Munition,51038000,22109000,73147000
2016,6,WA94,"Möbel, Beleuchtungskörper usw.",1359937000,1488662000,2848599000
2016,6,WA95,"Spielzeug, Spiele usw., Sportgeräte",306256000,477080000,783336000
2016,6,WA96,Verschiedene Waren,343796000,220201000,563997000
2016,6,WA97,"Kunstgegenstände, Sammlungsstücke",86943000,86393000,173336000
2016,6,WA98,Vollständige Fabrikationsanlagen,169120000,49000,169169000
2016,6,WA99,Zusammenstellungen verschiedener Waren,1885705000,926036000,2811741000
2016,7,WA01,Lebende Tiere,126394000,177600000,303994000
2016,7,WA02,Fleisch,636304000,461962000,1098266000
2016,7,WA03,"Fische, Krebs- und Weichtiere",118977000,284094000,403071000
2016,7,WA04,"Milch, Milcherzeugnisse, Eier, Honig",619704000,525110000,1144814000
2016,7,WA05,Andere Waren tierischen Ursprungs,67526000,68243000,135769000
2016,7,WA06,"Pflanzen, Waren des Blumenhandels",48168000,185909000,234077000
2016,7,WA07,"Gemüse, Pflanzen für Ernährung",81136000,436045000,517181000
2016,7,WA08,Genießbare Früchte und Nüsse,174708000,841453000,1016161000
2016,7,WA09,"Kaffee, Tee, Mate, Gewürze",216398000,300185000,516583000
2016,7,WA10,Getreide,205208000,139058000,344266000
2016,7,WA11,"Müllereierzeugnisse, Malz usw.",116816000,43276000,160092000
2016,7,WA12,"Ölsamen usw., Heilpflanzen usw.",106992000,372357000,479349000
2016,7,WA13,"Schellack, Gummen, Harz, Pflanzensaft",47909000,40937000,88846000
2016,7,WA14,Flechtstoffe usw. pflanzlichen Ursprungs,602000,3491000,4093000
2016,7,WA15,"Tierische und pflanzliche Fette, Öle, Wachs",237675000,354267000,591942000
2016,7,WA16,"Zubereitungen von Fleisch, Fisch usw.",218637000,205318000,423955000
2016,7,WA17,Zucker und Zuckerwaren,158824000,124560000,283384000
2016,7,WA18,Kakao und Zubereitungen aus Kakao,422780000,368221000,791001000
2016,7,WA19,"Zubereitungen aus Getreide usw., Backwaren",476801000,321625000,798426000
2016,7,WA20,"Zubereitungen von Gemüse, Früchten usw.",211938000,379676000,591614000
2016,7,WA21,Verschiedene Lebensmittelzubereitungen,440665000,267272000,707937000
2016,7,WA22,"Getränke, alkoholhaltige Flüssigkeiten, Essig",512701000,585622000,1098323000
2016,7,WA23,"Rückstände der Lebensmittelindustrie, Futter",322098000,323307000,645405000
2016,7,WA24,Tabak,342645000,144841000,487486000
2016,7,WA25,"Salz, Schwefel, Steine, Erden usw.",163274000,147742000,311016000
2016,7,WA26,"Erze, Schlacken, Aschen",33436000,454808000,488244000
2016,7,WA27,Mineralische Brennstoffe usw.,1853287000,5792061000,7645348000
2016,7,WA28,Anorganische chemische Erzeugnisse,649412000,481868000,1131280000
2016,7,WA29,Organische chemische Erzeugnisse,1868822000,2040618000,3909440000
2016,7,WA30,Pharmazeutische Erzeugnisse,5886433000,3629142000,9515575000
2016,7,WA31,Düngemittel,114743000,75486000,190229000
2016,7,WA32,"Gerb- und Farbstoffe, Farben, Lacke usw.",850341000,486820000,1337161000
2016,7,WA33,"Etherische Öle, Riech-, Schönheitsmittel",743839000,612744000,1356583000
2016,7,WA34,"Seifen, Waschmittel usw.",577953000,305079000,883032000
2016,7,WA35,"Eiweißstoffe, Klebstoffe, Enzyme",260758000,164706000,425464000
2016,7,WA36,"Sprengstoffe, pyrotechnische Artikel usw.",17268000,30527000,47795000
2016,7,WA37,Photochemische Erzeugnisse,111628000,67295000,178923000
2016,7,WA38,Verschiedene Erzeugnisse der Chemischen Industrie,1640281000,1021127000,2661408000
2016,7,WA39,Kunststoffe und Waren daraus,4537584000,3030626000,7568210000
2016,7,WA40,Kautschuk und Waren daraus,1128917000,1085817000,2214734000
2016,7,WA41,"Häute, Felle, Leder",78022000,63757000,141779000
2016,7,WA42,"Lederwaren, Sattlerwaren",180456000,345266000,525722000
2016,7,WA43,"Pelzfelle, künstliches Pelzwerk",9211000,13123000,22334000
2016,7,WA44,"Holz, Holzwaren, Holzkohle",637825000,617796000,1255621000
2016,7,WA45,"Kork, Korkwaren",2614000,9368000,11982000
2016,7,WA46,"Flechtwaren, Korbmacherwaren",3170000,9330000,12500000
2016,7,WA47,"Halbstoffe aus Holz usw., Papierabfall",122058000,275945000,398003000
2016,7,WA48,"Papier, Pappe und Waren daraus",1394752000,999106000,2393858000
2016,7,WA49,"Bücher, Zeitungen, Bilddrucke usw.",313560000,202742000,516302000
2016,7,WA50,Seide,3357000,3730000,7087000
2016,7,WA51,"Wolle, feine und grobe Tierhaare",38385000,53036000,91421000
2016,7,WA52,Baumwolle,62394000,66634000,129028000
2016,7,WA53,"Andere pflanzliche Spinnstoffe, Papiergarn",2717000,5072000,7789000
2016,7,WA54,Synthetisches oder künstliches Filament,136503000,116374000,252877000
2016,7,WA55,Synthetische oder künstliche Spinnfaser,143394000,125260000,268654000
2016,7,WA56,"Watte, Filz, Vliesstoff usw., Tauwerk",191823000,112070000,303893000
2016,7,WA57,"Teppiche, Fußbodenbelag aus Spinnstoff",40452000,80890000,121342000
2016,7,WA58,"Spezialgewebe, Spitzen, Tapisserien",39416000,21521000,60937000
2016,7,WA59,"Getränkte, bestrichene usw. Gewebe",183863000,100745000,284608000
2016,7,WA60,Gewirke und Gestricke,63712000,35442000,99154000
2016,7,WA61,"Bekleidung usw. aus Gewirken, Gestricken",623792000,1402331000,2026123000
2016,7,WA62,"Andere Bekleidung, Bekleidungszubehör",633893000,1373342000,2007235000
2016,7,WA63,"Andere Konfektion, Spinnstoffwaren usw.",214377000,307053000,521430000
2016,7,WA64,"Schuhe, Gamaschen, ähnliche Waren",481448000,921400000,1402848000
2016,7,WA65,Kopfbedeckungen und Teile davon,28559000,46321000,74880000
2016,7,WA66,"Schirme, Gehstöcke usw., Peitschen",6451000,13219000,19670000
2016,7,WA67,"Zugerichtete Federn, Daunen, künstliche Blumen",8759000,17497000,26256000
2016,7,WA68,"Waren aus Steinen, Gips, Zement usw.",362869000,266222000,629091000
2016,7,WA69,Keramische Waren,254632000,221580000,476212000
2016,7,WA70,Glas und Glaswaren,489053000,410474000,899527000
2016,7,WA71,"Perlen, Edelsteine, Edelmetalle",967170000,1187304000,2154474000
2016,7,WA72,Eisen und Stahl,1581984000,1723410000,3305394000
2016,7,WA73,Waren aus Eisen oder Stahl,2126433000,1595122000,3721555000
2016,7,WA74,Kupfer und Waren daraus,745867000,755131000,1500998000
2016,7,WA75,Nickel und Waren daraus,67355000,94584000,161939000
2016,7,WA76,Aluminium und Waren daraus,1144515000,1242950000,2387465000
2016,7,WA78,Blei und Waren daraus,25898000,30453000,56351000
2016,7,WA79,Zink und Waren daraus,50307000,125134000,175441000
2016,7,WA80,Zinn und Waren daraus,7684000,36408000,44092000
2016,7,WA81,"Andere unedle Metalle, Cermets usw.",113854000,142114000,255968000
2016,7,WA82,"Werkzeuge, Schneidwaren, Essbestecke",659011000,409595000,1068606000
2016,7,WA83,Verschiedene Waren aus unedlen Metallen,588867000,364048000,952915000
2016,7,WA84,"Maschinen, Apparate, mechanische Geräte",15886287000,9825844000,25712131000
2016,7,WA85,Elektrotechnische Erzeugnisse,9525966000,9048658000,18574624000
2016,7,WA86,Schienenfahrzeuge,365298000,204804000,570102000
2016,7,WA87,"Kraftfahrzeuge, Landfahrzeuge",17435761000,7643332000,25079093000
2016,7,WA88,"Luftfahrzeuge, Raumfahrzeuge",2517511000,1760101000,4277612000
2016,7,WA89,Wasserfahrzeuge,279710000,115329000,395039000
2016,7,WA90,"Optische, photografische usw. Erzeugnisse",4468231000,2852280000,7320511000
2016,7,WA91,Uhrmacherwaren,158454000,172924000,331378000
2016,7,WA92,Musikinstrumente,38690000,41217000,79907000
2016,7,WA93,Waffen und Munition,48829000,20079000,68908000
2016,7,WA94,"Möbel, Beleuchtungskörper usw.",1216437000,1338007000,2554444000
2016,7,WA95,"Spielzeug, Spiele usw., Sportgeräte",285364000,400305000,685669000
2016,7,WA96,Verschiedene Waren,306494000,226336000,532830000
2016,7,WA97,"Kunstgegenstände, Sammlungsstücke",56873000,52870000,109743000
2016,7,WA98,Vollständige Fabrikationsanlagen,168506000,420000,168926000
2016,7,WA99,Zusammenstellungen verschiedener Waren,1893175000,938832000,2832007000
2016,8,WA01,Lebende Tiere,152213000,187497000,339710000
2016,8,WA02,Fleisch,663432000,514208000,1177640000
2016,8,WA03,"Fische, Krebs- und Weichtiere",131426000,335697000,467123000
2016,8,WA04,"Milch, Milcherzeugnisse, Eier, Honig",670460000,580832000,1251292000
2016,8,WA05,Andere Waren tierischen Ursprungs,65437000,70004000,135441000
2016,8,WA06,"Pflanzen, Waren des Blumenhandels",64440000,188189000,252629000
2016,8,WA07,"Gemüse, Pflanzen für Ernährung",100456000,407854000,508310000
2016,8,WA08,Genießbare Früchte und Nüsse,148449000,807782000,956231000
2016,8,WA09,"Kaffee, Tee, Mate, Gewürze",208618000,333144000,541762000
2016,8,WA10,Getreide,163722000,178542000,342264000
2016,8,WA11,"Müllereierzeugnisse, Malz usw.",114347000,44338000,158685000
2016,8,WA12,"Ölsamen usw., Heilpflanzen usw.",89010000,435273000,524283000
2016,8,WA13,"Schellack, Gummen, Harz, Pflanzensaft",45309000,37344000,82653000
2016,8,WA14,Flechtstoffe usw. pflanzlichen Ursprungs,528000,3092000,3620000
2016,8,WA15,"Tierische und pflanzliche Fette, Öle, Wachs",231383000,335802000,567185000
2016,8,WA16,"Zubereitungen von Fleisch, Fisch usw.",239862000,211090000,450952000
2016,8,WA17,Zucker und Zuckerwaren,170986000,137847000,308833000
2016,8,WA18,Kakao und Zubereitungen aus Kakao,434355000,383721000,818076000
2016,8,WA19,"Zubereitungen aus Getreide usw., Backwaren",519364000,316440000,835804000
2016,8,WA20,"Zubereitungen von Gemüse, Früchten usw.",212645000,374732000,587377000
2016,8,WA21,Verschiedene Lebensmittelzubereitungen,432896000,245935000,678831000
2016,8,WA22,"Getränke, alkoholhaltige Flüssigkeiten, Essig",487262000,556622000,1043884000
2016,8,WA23,"Rückstände der Lebensmittelindustrie, Futter",366371000,302829000,669200000
2016,8,WA24,Tabak,352606000,144497000,497103000
2016,8,WA25,"Salz, Schwefel, Steine, Erden usw.",151655000,158820000,310475000
2016,8,WA26,"Erze, Schlacken, Aschen",24494000,525839000,550333000
2016,8,WA27,Mineralische Brennstoffe usw.,1717200000,6344263000,8061463000
2016,8,WA28,Anorganische chemische Erzeugnisse,685870000,480429000,1166299000
2016,8,WA29,Organische chemische Erzeugnisse,1895158000,2153636000,4048794000
2016,8,WA30,Pharmazeutische Erzeugnisse,5484354000,3813901000,9298255000
2016,8,WA31,Düngemittel,132949000,77220000,210169000
2016,8,WA32,"Gerb- und Farbstoffe, Farben, Lacke usw.",868186000,464290000,1332476000
2016,8,WA33,"Etherische Öle, Riech-, Schönheitsmittel",816180000,549601000,1365781000
2016,8,WA34,"Seifen, Waschmittel usw.",580646000,318336000,898982000
2016,8,WA35,"Eiweißstoffe, Klebstoffe, Enzyme",251411000,156638000,408049000
2016,8,WA36,"Sprengstoffe, pyrotechnische Artikel usw.",17174000,28686000,45860000
2016,8,WA37,Photochemische Erzeugnisse,101989000,63612000,165601000
2016,8,WA38,Verschiedene Erzeugnisse der Chemischen Industrie,1592189000,963344000,2555533000
2016,8,WA39,Kunststoffe und Waren daraus,4439917000,2941885000,7381802000
2016,8,WA40,Kautschuk und Waren daraus,1139823000,1142222000,2282045000
2016,8,WA41,"Häute, Felle, Leder",64885000,53283000,118168000
2016,8,WA42,"Lederwaren, Sattlerwaren",179036000,349143000,528179000
2016,8,WA43,"Pelzfelle, künstliches Pelzwerk",10985000,10960000,21945000
2016,8,WA44,"Holz, Holzwaren, Holzkohle",562455000,601046000,1163501000
2016,8,WA45,"Kork, Korkwaren",2620000,9051000,11671000
2016,8,WA46,"Flechtwaren, Korbmacherwaren",3693000,10015000,13708000
2016,8,WA47,"Halbstoffe aus Holz usw., Papierabfall",96261000,319863000,416124000
2016,8,WA48,"Papier, Pappe und Waren daraus",1413862000,1002557000,2416419000
2016,8,WA49,"Bücher, Zeitungen, Bilddrucke usw.",377221000,223351000,600572000
2016,8,WA50,Seide,2744000,3534000,6278000
2016,8,WA51,"Wolle, feine und grobe Tierhaare",37812000,43397000,81209000
2016,8,WA52,Baumwolle,50277000,60467000,110744000
2016,8,WA53,"Andere pflanzliche Spinnstoffe, Papiergarn",2488000,4761000,7249000
2016,8,WA54,Synthetisches oder künstliches Filament,130326000,110399000,240725000
2016,8,WA55,Synthetische oder künstliche Spinnfaser,129222000,108046000,237268000
2016,8,WA56,"Watte, Filz, Vliesstoff usw., Tauwerk",180338000,108472000,288810000
2016,8,WA57,"Teppiche, Fußbodenbelag aus Spinnstoff",42929000,77212000,120141000
2016,8,WA58,"Spezialgewebe, Spitzen, Tapisserien",39121000,20838000,59959000
2016,8,WA59,"Getränkte, bestrichene usw. Gewebe",178024000,81938000,259962000
2016,8,WA60,Gewirke und Gestricke,51386000,29850000,81236000
2016,8,WA61,"Bekleidung usw. aus Gewirken, Gestricken",720624000,1645973000,2366597000
2016,8,WA62,"Andere Bekleidung, Bekleidungszubehör",792758000,1603840000,2396598000
2016,8,WA63,"Andere Konfektion, Spinnstoffwaren usw.",215915000,315160000,531075000
2016,8,WA64,"Schuhe, Gamaschen, ähnliche Waren",585140000,1024774000,1609914000
2016,8,WA65,Kopfbedeckungen und Teile davon,32249000,50517000,82766000
2016,8,WA66,"Schirme, Gehstöcke usw., Peitschen",8377000,14824000,23201000
2016,8,WA67,"Zugerichtete Federn, Daunen, künstliche Blumen",10283000,20307000,30590000
2016,8,WA68,"Waren aus Steinen, Gips, Zement usw.",350463000,252527000,602990000
2016,8,WA69,Keramische Waren,252760000,249469000,502229000
2016,8,WA70,Glas und Glaswaren,465912000,415551000,881463000
2016,8,WA71,"Perlen, Edelsteine, Edelmetalle",1043157000,1056813000,2099970000
2016,8,WA72,Eisen und Stahl,1476467000,1608124000,3084591000
2016,8,WA73,Waren aus Eisen oder Stahl,2139212000,1506328000,3645540000
2016,8,WA74,Kupfer und Waren daraus,699597000,566585000,1266182000
2016,8,WA75,Nickel und Waren daraus,68191000,81271000,149462000
2016,8,WA76,Aluminium und Waren daraus,1119457000,1166473000,2285930000
2016,8,WA78,Blei und Waren daraus,26016000,29111000,55127000
2016,8,WA79,Zink und Waren daraus,44304000,110411000,154715000
2016,8,WA80,Zinn und Waren daraus,9586000,30952000,40538000
2016,8,WA81,"Andere unedle Metalle, Cermets usw.",108364000,130347000,238711000
2016,8,WA82,"Werkzeuge, Schneidwaren, Essbestecke",630139000,386749000,1016888000
2016,8,WA83,Verschiedene Waren aus unedlen Metallen,580908000,355131000,936039000
2016,8,WA84,"Maschinen, Apparate, mechanische Geräte",15991588000,9571470000,25563058000
2016,8,WA85,Elektrotechnische Erzeugnisse,10068948000,9524218000,19593166000
2016,8,WA86,Schienenfahrzeuge,399639000,187993000,587632000
2016,8,WA87,"Kraftfahrzeuge, Landfahrzeuge",16116503000,7073808000,23190311000
2016,8,WA88,"Luftfahrzeuge, Raumfahrzeuge",3278944000,1023898000,4302842000
2016,8,WA89,Wasserfahrzeuge,333152000,165698000,498850000
2016,8,WA90,"Optische, photografische usw. Erzeugnisse",4842448000,2711254000,7553702000
2016,8,WA91,Uhrmacherwaren,139254000,159640000,298894000
2016,8,WA92,Musikinstrumente,35266000,46667000,81933000
2016,8,WA93,Waffen und Munition,38218000,19534000,57752000
2016,8,WA94,"Möbel, Beleuchtungskörper usw.",1146726000,1401843000,2548569000
2016,8,WA95,"Spielzeug, Spiele usw., Sportgeräte",270065000,462249000,732314000
2016,8,WA96,Verschiedene Waren,317268000,245260000,562528000
2016,8,WA97,"Kunstgegenstände, Sammlungsstücke",53623000,27645000,81268000
2016,8,WA98,Vollständige Fabrikationsanlagen,183788000,1267000,185055000
2016,8,WA99,Zusammenstellungen verschiedener Waren,1864021000,846507000,2710528000
2016,9,WA01,Lebende Tiere,132802000,176889000,309691000
2016,9,WA02,Fleisch,714812000,523890000,1238702000
2016,9,WA03,"Fische, Krebs- und Weichtiere",152417000,351552000,503969000
2016,9,WA04,"Milch, Milcherzeugnisse, Eier, Honig",717016000,586189000,1303205000
2016,9,WA05,Andere Waren tierischen Ursprungs,71733000,70683000,142416000
2016,9,WA06,"Pflanzen, Waren des Blumenhandels",78012000,181038000,259050000
2016,9,WA07,"Gemüse, Pflanzen für Ernährung",89855000,378667000,468522000
2016,9,WA08,Genießbare Früchte und Nüsse,156967000,782184000,939151000
2016,9,WA09,"Kaffee, Tee, Mate, Gewürze",248503000,342345000,590848000
2016,9,WA10,Getreide,179956000,192382000,372338000
2016,9,WA11,"Müllereierzeugnisse, Malz usw.",126396000,47658000,174054000
2016,9,WA12,"Ölsamen usw., Heilpflanzen usw.",67568000,509966000,577534000
2016,9,WA13,"Schellack, Gummen, Harz, Pflanzensaft",47263000,36948000,84211000
2016,9,WA14,Flechtstoffe usw. pflanzlichen Ursprungs,550000,3227000,3777000
2016,9,WA15,"Tierische und pflanzliche Fette, Öle, Wachs",258731000,337720000,596451000
2016,9,WA16,"Zubereitungen von Fleisch, Fisch usw.",246163000,213850000,460013000
2016,9,WA17,Zucker und Zuckerwaren,180120000,144239000,324359000
2016,9,WA18,Kakao und Zubereitungen aus Kakao,592790000,475194000,1067984000
2016,9,WA19,"Zubereitungen aus Getreide usw., Backwaren",541005000,338561000,879566000
2016,9,WA20,"Zubereitungen von Gemüse, Früchten usw.",233547000,385990000,619537000
2016,9,WA21,Verschiedene Lebensmittelzubereitungen,437548000,256727000,694275000
2016,9,WA22,"Getränke, alkoholhaltige Flüssigkeiten, Essig",505240000,592607000,1097847000
2016,9,WA23,"Rückstände der Lebensmittelindustrie, Futter",314645000,321708000,636353000
2016,9,WA24,Tabak,354272000,154226000,508498000
2016,9,WA25,"Salz, Schwefel, Steine, Erden usw.",179066000,147563000,326629000
2016,9,WA26,"Erze, Schlacken, Aschen",34177000,477623000,511800000
2016,9,WA27,Mineralische Brennstoffe usw.,1819453000,5620048000,7439501000
2016,9,WA28,Anorganische chemische Erzeugnisse,685511000,520593000,1206104000
2016,9,WA29,Organische chemische Erzeugnisse,1932125000,2059122000,3991247000
2016,9,WA30,Pharmazeutische Erzeugnisse,5787433000,3677882000,9465315000
2016,9,WA31,Düngemittel,155057000,74415000,229472000
2016,9,WA32,"Gerb- und Farbstoffe, Farben, Lacke usw.",959852000,510858000,1470710000
2016,9,WA33,"Etherische Öle, Riech-, Schönheitsmittel",793998000,624046000,1418044000
2016,9,WA34,"Seifen, Waschmittel usw.",635251000,340309000,975560000
2016,9,WA35,"Eiweißstoffe, Klebstoffe, Enzyme",282179000,165430000,447609000
2016,9,WA36,"Sprengstoffe, pyrotechnische Artikel usw.",20362000,24800000,45162000
2016,9,WA37,Photochemische Erzeugnisse,105870000,68755000,174625000
2016,9,WA38,Verschiedene Erzeugnisse der Chemischen Industrie,1740259000,1010618000,2750877000
2016,9,WA39,Kunststoffe und Waren daraus,4904224000,3050364000,7954588000
2016,9,WA40,Kautschuk und Waren daraus,1234863000,1193607000,2428470000
2016,9,WA41,"Häute, Felle, Leder",86651000,63044000,149695000
2016,9,WA42,"Lederwaren, Sattlerwaren",175325000,319640000,494965000
2016,9,WA43,"Pelzfelle, künstliches Pelzwerk",10530000,11087000,21617000
2016,9,WA44,"Holz, Holzwaren, Holzkohle",663740000,636609000,1300349000
2016,9,WA45,"Kork, Korkwaren",2239000,7378000,9617000
2016,9,WA46,"Flechtwaren, Korbmacherwaren",3755000,9578000,13333000
2016,9,WA47,"Halbstoffe aus Holz usw., Papierabfall",100845000,296389000,397234000
2016,9,WA48,"Papier, Pappe und Waren daraus",1520205000,1027988000,2548193000
2016,9,WA49,"Bücher, Zeitungen, Bilddrucke usw.",376453000,231907000,608360000
2016,9,WA50,Seide,4317000,4759000,9076000
2016,9,WA51,"Wolle, feine und grobe Tierhaare",44779000,53930000,98709000
2016,9,WA52,Baumwolle,80221000,71180000,151401000
2016,9,WA53,"Andere pflanzliche Spinnstoffe, Papiergarn",2975000,5754000,8729000
2016,9,WA54,Synthetisches oder künstliches Filament,162807000,124948000,287755000
2016,9,WA55,Synthetische oder künstliche Spinnfaser,158054000,121351000,279405000
2016,9,WA56,"Watte, Filz, Vliesstoff usw., Tauwerk",202471000,113410000,315881000
2016,9,WA57,"Teppiche, Fußbodenbelag aus Spinnstoff",46203000,89709000,135912000
2016,9,WA58,"Spezialgewebe, Spitzen, Tapisserien",45620000,22599000,68219000
2016,9,WA59,"Getränkte, bestrichene usw. Gewebe",203384000,92815000,296199000
2016,9,WA60,Gewirke und Gestricke,65085000,34671000,99756000
2016,9,WA61,"Bekleidung usw. aus Gewirken, Gestricken",643563000,1434348000,2077911000
2016,9,WA62,"Andere Bekleidung, Bekleidungszubehör",757576000,1426696000,2184272000
2016,9,WA63,"Andere Konfektion, Spinnstoffwaren usw.",215670000,320324000,535994000
2016,9,WA64,"Schuhe, Gamaschen, ähnliche Waren",438186000,907391000,1345577000
2016,9,WA65,Kopfbedeckungen und Teile davon,40445000,57935000,98380000
2016,9,WA66,"Schirme, Gehstöcke usw., Peitschen",5034000,12220000,17254000
2016,9,WA67,"Zugerichtete Federn, Daunen, künstliche Blumen",12962000,19751000,32713000
2016,9,WA68,"Waren aus Steinen, Gips, Zement usw.",387102000,269525000,656627000
2016,9,WA69,Keramische Waren,268873000,231018000,499891000
2016,9,WA70,Glas und Glaswaren,551898000,439772000,991670000
2016,9,WA71,"Perlen, Edelsteine, Edelmetalle",1060615000,1122243000,2182858000
2016,9,WA72,Eisen und Stahl,1727043000,1839465000,3566508000
2016,9,WA73,Waren aus Eisen oder Stahl,2255706000,1616882000,3872588000
2016,9,WA74,Kupfer und Waren daraus,834040000,720553000,1554593000
2016,9,WA75,Nickel und Waren daraus,79223000,97931000,177154000
2016,9,WA76,Aluminium und Waren daraus,1190208000,1341655000,2531863000
2016,9,WA78,Blei und Waren daraus,34368000,25235000,59603000
2016,9,WA79,Zink und Waren daraus,52821000,112200000,165021000
2016,9,WA80,Zinn und Waren daraus,10134000,33944000,44078000
2016,9,WA81,"Andere unedle Metalle, Cermets usw.",120800000,137499000,258299000
2016,9,WA82,"Werkzeuge, Schneidwaren, Essbestecke",655529000,401158000,1056687000
2016,9,WA83,Verschiedene Waren aus unedlen Metallen,637013000,384673000,1021686000
2016,9,WA84,"Maschinen, Apparate, mechanische Geräte",17561144000,10509818000,28070962000
2016,9,WA85,Elektrotechnische Erzeugnisse,11120517000,10303936000,21424453000
2016,9,WA86,Schienenfahrzeuge,359982000,259779000,619761000
2016,9,WA87,"Kraftfahrzeuge, Landfahrzeuge",20234631000,9112307000,29346938000
2016,9,WA88,"Luftfahrzeuge, Raumfahrzeuge",3099265000,1275272000,4374537000
2016,9,WA89,Wasserfahrzeuge,60413000,639169000,699582000
2016,9,WA90,"Optische, photografische usw. Erzeugnisse",5252903000,2895721000,8148624000
2016,9,WA91,Uhrmacherwaren,161645000,176081000,337726000
2016,9,WA92,Musikinstrumente,56965000,55196000,112161000
2016,9,WA93,Waffen und Munition,49016000,21256000,70272000
2016,9,WA94,"Möbel, Beleuchtungskörper usw.",1347499000,1571220000,2918719000
2016,9,WA95,"Spielzeug, Spiele usw., Sportgeräte",429961000,592307000,1022268000
2016,9,WA96,Verschiedene Waren,318633000,240982000,559615000
2016,9,WA97,"Kunstgegenstände, Sammlungsstücke",56269000,37777000,94046000
2016,9,WA98,Vollständige Fabrikationsanlagen,199717000,29000,199746000
2016,9,WA99,Zusammenstellungen verschiedener Waren,1643012000,901881000,2544893000
2016,10,WA01,Lebende Tiere,132840000,177882000,310722000
2016,10,WA02,Fleisch,673472000,559796000,1233268000
2016,10,WA03,"Fische, Krebs- und Weichtiere",141860000,360993000,502853000
2016,10,WA04,"Milch, Milcherzeugnisse, Eier, Honig",669869000,602489000,1272358000
2016,10,WA05,Andere Waren tierischen Ursprungs,64731000,65924000,130655000
2016,10,WA06,"Pflanzen, Waren des Blumenhandels",79878000,185682000,265560000
2016,10,WA07,"Gemüse, Pflanzen für Ernährung",79134000,394018000,473152000
2016,10,WA08,Genießbare Früchte und Nüsse,146948000,743736000,890684000
2016,10,WA09,"Kaffee, Tee, Mate, Gewürze",230156000,389923000,620079000
2016,10,WA10,Getreide,152097000,195706000,347803000
2016,10,WA11,"Müllereierzeugnisse, Malz usw.",123632000,48862000,172494000
2016,10,WA12,"Ölsamen usw., Heilpflanzen usw.",72902000,439893000,512795000
2016,10,WA13,"Schellack, Gummen, Harz, Pflanzensaft",47522000,37353000,84875000
2016,10,WA14,Flechtstoffe usw. pflanzlichen Ursprungs,611000,3487000,4098000
2016,10,WA15,"Tierische und pflanzliche Fette, Öle, Wachs",202472000,350800000,553272000
2016,10,WA16,"Zubereitungen von Fleisch, Fisch usw.",210938000,209455000,420393000
2016,10,WA17,Zucker und Zuckerwaren,177559000,141978000,319537000
2016,10,WA18,Kakao und Zubereitungen aus Kakao,538084000,424152000,962236000
2016,10,WA19,"Zubereitungen aus Getreide usw., Backwaren",520581000,327101000,847682000
2016,10,WA20,"Zubereitungen von Gemüse, Früchten usw.",215260000,391532000,606792000
2016,10,WA21,Verschiedene Lebensmittelzubereitungen,415680000,249965000,665645000
2016,10,WA22,"Getränke, alkoholhaltige Flüssigkeiten, Essig",462093000,552927000,1015020000
2016,10,WA23,"Rückstände der Lebensmittelindustrie, Futter",371447000,271800000,643247000
2016,10,WA24,Tabak,339910000,169096000,509006000
2016,10,WA25,"Salz, Schwefel, Steine, Erden usw.",172780000,152704000,325484000
2016,10,WA26,"Erze, Schlacken, Aschen",33120000,592405000,625525000
2016,10,WA27,Mineralische Brennstoffe usw.,1874276000,6568438000,8442714000
2016,10,WA28,Anorganische chemische Erzeugnisse,616026000,452623000,1068649000
2016,10,WA29,Organische chemische Erzeugnisse,1751368000,2148565000,3899933000
2016,10,WA30,Pharmazeutische Erzeugnisse,5628480000,3800833000,9429313000
2016,10,WA31,Düngemittel,135459000,72459000,207918000
2016,10,WA32,"Gerb- und Farbstoffe, Farben, Lacke usw.",910900000,484634000,1395534000
2016,10,WA33,"Etherische Öle, Riech-, Schönheitsmittel",771206000,587252000,1358458000
2016,10,WA34,"Seifen, Waschmittel usw.",587621000,343325000,930946000
2016,10,WA35,"Eiweißstoffe, Klebstoffe, Enzyme",252467000,166045000,418512000
2016,10,WA36,"Sprengstoffe, pyrotechnische Artikel usw.",20647000,23855000,44502000
2016,10,WA37,Photochemische Erzeugnisse,104201000,72175000,176376000
2016,10,WA38,Verschiedene Erzeugnisse der Chemischen Industrie,1724631000,978061000,2702692000
2016,10,WA39,Kunststoffe und Waren daraus,4575541000,2949847000,7525388000
2016,10,WA40,Kautschuk und Waren daraus,1242332000,1150113000,2392445000
2016,10,WA41,"Häute, Felle, Leder",84489000,69208000,153697000
2016,10,WA42,"Lederwaren, Sattlerwaren",162812000,314230000,477042000
2016,10,WA43,"Pelzfelle, künstliches Pelzwerk",8884000,10964000,19848000
2016,10,WA44,"Holz, Holzwaren, Holzkohle",605983000,654487000,1260470000
2016,10,WA45,"Kork, Korkwaren",2345000,8484000,10829000
2016,10,WA46,"Flechtwaren, Korbmacherwaren",3193000,9162000,12355000
2016,10,WA47,"Halbstoffe aus Holz usw., Papierabfall",94915000,275202000,370117000
2016,10,WA48,"Papier, Pappe und Waren daraus",1446671000,988121000,2434792000
2016,10,WA49,"Bücher, Zeitungen, Bilddrucke usw.",371158000,234193000,605351000
2016,10,WA50,Seide,3544000,4107000,7651000
2016,10,WA51,"Wolle, feine und grobe Tierhaare",45659000,60507000,106166000
2016,10,WA52,Baumwolle,72669000,80405000,153074000
2016,10,WA53,"Andere pflanzliche Spinnstoffe, Papiergarn",4075000,6364000,10439000
2016,10,WA54,Synthetisches oder künstliches Filament,156354000,121745000,278099000
2016,10,WA55,Synthetische oder künstliche Spinnfaser,147740000,128228000,275968000
2016,10,WA56,"Watte, Filz, Vliesstoff usw., Tauwerk",194488000,107070000,301558000
2016,10,WA57,"Teppiche, Fußbodenbelag aus Spinnstoff",45606000,93917000,139523000
2016,10,WA58,"Spezialgewebe, Spitzen, Tapisserien",43256000,24353000,67609000
2016,10,WA59,"Getränkte, bestrichene usw. Gewebe",190561000,92410000,282971000
2016,10,WA60,Gewirke und Gestricke,67866000,39321000,107187000
2016,10,WA61,"Bekleidung usw. aus Gewirken, Gestricken",689069000,1477369000,2166438000
2016,10,WA62,"Andere Bekleidung, Bekleidungszubehör",673611000,1292566000,1966177000
2016,10,WA63,"Andere Konfektion, Spinnstoffwaren usw.",206293000,302373000,508666000
2016,10,WA64,"Schuhe, Gamaschen, ähnliche Waren",434947000,688586000,1123533000
2016,10,WA65,Kopfbedeckungen und Teile davon,38743000,51452000,90195000
2016,10,WA66,"Schirme, Gehstöcke usw., Peitschen",6998000,11129000,18127000
2016,10,WA67,"Zugerichtete Federn, Daunen, künstliche Blumen",10956000,14067000,25023000
2016,10,WA68,"Waren aus Steinen, Gips, Zement usw.",361488000,251329000,612817000
2016,10,WA69,Keramische Waren,269211000,230859000,500070000
2016,10,WA70,Glas und Glaswaren,497364000,431384000,928748000
2016,10,WA71,"Perlen, Edelsteine, Edelmetalle",993601000,1223855000,2217456000
2016,10,WA72,Eisen und Stahl,1609715000,1781123000,3390838000
2016,10,WA73,Waren aus Eisen oder Stahl,2086848000,1602068000,3688916000
2016,10,WA74,Kupfer und Waren daraus,769649000,663190000,1432839000
2016,10,WA75,Nickel und Waren daraus,76801000,97791000,174592000
2016,10,WA76,Aluminium und Waren daraus,1152634000,1232020000,2384654000
2016,10,WA78,Blei und Waren daraus,33562000,28493000,62055000
2016,10,WA79,Zink und Waren daraus,55104000,128027000,183131000
2016,10,WA80,Zinn und Waren daraus,8243000,35620000,43863000
2016,10,WA81,"Andere unedle Metalle, Cermets usw.",112309000,123111000,235420000
2016,10,WA82,"Werkzeuge, Schneidwaren, Essbestecke",649152000,384804000,1033956000
2016,10,WA83,Verschiedene Waren aus unedlen Metallen,605408000,374377000,979785000
2016,10,WA84,"Maschinen, Apparate, mechanische Geräte",16287336000,10424740000,26712076000
2016,10,WA85,Elektrotechnische Erzeugnisse,11074608000,11075734000,22150342000
2016,10,WA86,Schienenfahrzeuge,315369000,210401000,525770000
2016,10,WA87,"Kraftfahrzeuge, Landfahrzeuge",18376623000,8532965000,26909588000
2016,10,WA88,"Luftfahrzeuge, Raumfahrzeuge",3189732000,1782973000,4972705000
2016,10,WA89,Wasserfahrzeuge,843792000,45627000,889419000
2016,10,WA90,"Optische, photografische usw. Erzeugnisse",4901477000,2857214000,7758691000
2016,10,WA91,Uhrmacherwaren,161837000,179426000,341263000
2016,10,WA92,Musikinstrumente,46946000,53855000,100801000
2016,10,WA93,Waffen und Munition,44924000,16991000,61915000
2016,10,WA94,"Möbel, Beleuchtungskörper usw.",1271122000,1587822000,2858944000
2016,10,WA95,"Spielzeug, Spiele usw., Sportgeräte",433393000,687883000,1121276000
2016,10,WA96,Verschiedene Waren,329923000,228817000,558740000
2016,10,WA97,"Kunstgegenstände, Sammlungsstücke",64767000,22035000,86802000
2016,10,WA98,Vollständige Fabrikationsanlagen,156229000,183000,156412000
2016,10,WA99,Zusammenstellungen verschiedener Waren,1988014000,934565000,2922579000
2016,11,WA01,Lebende Tiere,115918000,184537000,300455000
2016,11,WA02,Fleisch,717366000,605850000,1323216000
2016,11,WA03,"Fische, Krebs- und Weichtiere",154354000,396990000,551344000
2016,11,WA04,"Milch, Milcherzeugnisse, Eier, Honig",697810000,653637000,1351447000
2016,11,WA05,Andere Waren tierischen Ursprungs,71385000,80143000,151528000
2016,11,WA06,"Pflanzen, Waren des Blumenhandels",64804000,208888000,273692000
2016,11,WA07,"Gemüse, Pflanzen für Ernährung",85232000,439075000,524307000
2016,11,WA08,Genießbare Früchte und Nüsse,165624000,817665000,983289000
2016,11,WA09,"Kaffee, Tee, Mate, Gewürze",245991000,395993000,641984000
2016,11,WA10,Getreide,185447000,235157000,420604000
2016,11,WA11,"Müllereierzeugnisse, Malz usw.",118843000,49901000,168744000
2016,11,WA12,"Ölsamen usw., Heilpflanzen usw.",107069000,412081000,519150000
2016,11,WA13,"Schellack, Gummen, Harz, Pflanzensaft",51680000,32473000,84153000
2016,11,WA14,Flechtstoffe usw. pflanzlichen Ursprungs,455000,3260000,3715000
2016,11,WA15,"Tierische und pflanzliche Fette, Öle, Wachs",252867000,351582000,604449000
2016,11,WA16,"Zubereitungen von Fleisch, Fisch usw.",234760000,227573000,462333000
2016,11,WA17,Zucker und Zuckerwaren,195406000,131229000,326635000
2016,11,WA18,Kakao und Zubereitungen aus Kakao,539247000,436425000,975672000
2016,11,WA19,"Zubereitungen aus Getreide usw., Backwaren",540728000,363558000,904286000
2016,11,WA20,"Zubereitungen von Gemüse, Früchten usw.",222168000,418902000,641070000
2016,11,WA21,Verschiedene Lebensmittelzubereitungen,439698000,264050000,703748000
2016,11,WA22,"Getränke, alkoholhaltige Flüssigkeiten, Essig",493427000,671513000,1164940000
2016,11,WA23,"Rückstände der Lebensmittelindustrie, Futter",353294000,337418000,690712000
2016,11,WA24,Tabak,395354000,173723000,569077000
2016,11,WA25,"Salz, Schwefel, Steine, Erden usw.",169266000,147520000,316786000
2016,11,WA26,"Erze, Schlacken, Aschen",37711000,476426000,514137000
2016,11,WA27,Mineralische Brennstoffe usw.,1792209000,6825498000,8617707000
2016,11,WA28,Anorganische chemische Erzeugnisse,644702000,506459000,1151161000
2016,11,WA29,Organische chemische Erzeugnisse,1931606000,2522232000,4453838000
2016,11,WA30,Pharmazeutische Erzeugnisse,6238888000,3767584000,10006472000
2016,11,WA31,Düngemittel,166118000,83258000,249376000
2016,11,WA32,"Gerb- und Farbstoffe, Farben, Lacke usw.",914279000,511161000,1425440000
2016,11,WA33,"Etherische Öle, Riech-, Schönheitsmittel",802365000,599304000,1401669000
2016,11,WA34,"Seifen, Waschmittel usw.",616571000,343159000,959730000
2016,11,WA35,"Eiweißstoffe, Klebstoffe, Enzyme",277334000,169603000,446937000
2016,11,WA36,"Sprengstoffe, pyrotechnische Artikel usw.",29647000,36764000,66411000
2016,11,WA37,Photochemische Erzeugnisse,111722000,70949000,182671000
2016,11,WA38,Verschiedene Erzeugnisse der Chemischen Industrie,1909142000,1065809000,2974951000
2016,11,WA39,Kunststoffe und Waren daraus,4787584000,3058447000,7846031000
2016,11,WA40,Kautschuk und Waren daraus,1286043000,1135635000,2421678000
2016,11,WA41,"Häute, Felle, Leder",88942000,76214000,165156000
2016,11,WA42,"Lederwaren, Sattlerwaren",185081000,336774000,521855000
2016,11,WA43,"Pelzfelle, künstliches Pelzwerk",11159000,11490000,22649000
2016,11,WA44,"Holz, Holzwaren, Holzkohle",649911000,631388000,1281299000
2016,11,WA45,"Kork, Korkwaren",2643000,8539000,11182000
2016,11,WA46,"Flechtwaren, Korbmacherwaren",2906000,8400000,11306000
2016,11,WA47,"Halbstoffe aus Holz usw., Papierabfall",98773000,326543000,425316000
2016,11,WA48,"Papier, Pappe und Waren daraus",1487709000,1050777000,2538486000
2016,11,WA49,"Bücher, Zeitungen, Bilddrucke usw.",402076000,241689000,643765000
2016,11,WA50,Seide,3683000,3200000,6883000
2016,11,WA51,"Wolle, feine und grobe Tierhaare",49594000,60013000,109607000
2016,11,WA52,Baumwolle,79581000,84656000,164237000
2016,11,WA53,"Andere pflanzliche Spinnstoffe, Papiergarn",4249000,7125000,11374000
2016,11,WA54,Synthetisches oder künstliches Filament,156977000,126801000,283778000
2016,11,WA55,Synthetische oder künstliche Spinnfaser,144067000,125744000,269811000
2016,11,WA56,"Watte, Filz, Vliesstoff usw., Tauwerk",193404000,107044000,300448000
2016,11,WA57,"Teppiche, Fußbodenbelag aus Spinnstoff",51753000,96693000,148446000
2016,11,WA58,"Spezialgewebe, Spitzen, Tapisserien",46904000,22828000,69732000
2016,11,WA59,"Getränkte, bestrichene usw. Gewebe",200729000,95959000,296688000
2016,11,WA60,Gewirke und Gestricke,68626000,40850000,109476000
2016,11,WA61,"Bekleidung usw. aus Gewirken, Gestricken",607328000,1369880000,1977208000
2016,11,WA62,"Andere Bekleidung, Bekleidungszubehör",579611000,1191125000,1770736000
2016,11,WA63,"Andere Konfektion, Spinnstoffwaren usw.",217163000,314853000,532016000
2016,11,WA64,"Schuhe, Gamaschen, ähnliche Waren",357727000,711452000,1069179000
2016,11,WA65,Kopfbedeckungen und Teile davon,30741000,42000000,72741000
2016,11,WA66,"Schirme, Gehstöcke usw., Peitschen",6247000,13560000,19807000
2016,11,WA67,"Zugerichtete Federn, Daunen, künstliche Blumen",9040000,15697000,24737000
2016,11,WA68,"Waren aus Steinen, Gips, Zement usw.",370488000,250294000,620782000
2016,11,WA69,Keramische Waren,268247000,240323000,508570000
2016,11,WA70,Glas und Glaswaren,526858000,444094000,970952000
2016,11,WA71,"Perlen, Edelsteine, Edelmetalle",1007637000,1267181000,2274818000
2016,11,WA72,Eisen und Stahl,1677602000,1934724000,3612326000
2016,11,WA73,Waren aus Eisen oder Stahl,2300719000,1657958000,3958677000
2016,11,WA74,Kupfer und Waren daraus,852251000,753331000,1605582000
2016,11,WA75,Nickel und Waren daraus,82004000,110230000,192234000
2016,11,WA76,Aluminium und Waren daraus,1195070000,1335075000,2530145000
2016,11,WA78,Blei und Waren daraus,28304000,41451000,69755000
2016,11,WA79,Zink und Waren daraus,52876000,122746000,175622000
2016,11,WA80,Zinn und Waren daraus,10564000,35076000,45640000
2016,11,WA81,"Andere unedle Metalle, Cermets usw.",118817000,136221000,255038000
2016,11,WA82,"Werkzeuge, Schneidwaren, Essbestecke",715047000,412632000,1127679000
2016,11,WA83,Verschiedene Waren aus unedlen Metallen,605726000,379761000,985487000
2016,11,WA84,"Maschinen, Apparate, mechanische Geräte",17894710000,11027955000,28922665000
2016,11,WA85,Elektrotechnische Erzeugnisse,11351628000,11120148000,22471776000
2016,11,WA86,Schienenfahrzeuge,359215000,236014000,595229000
2016,11,WA87,"Kraftfahrzeuge, Landfahrzeuge",20340172000,9439039000,29779211000
2016,11,WA88,"Luftfahrzeuge, Raumfahrzeuge",3750080000,1255595000,5005675000
2016,11,WA89,Wasserfahrzeuge,243520000,205494000,449014000
2016,11,WA90,"Optische, photografische usw. Erzeugnisse",5447241000,3093403000,8540644000
2016,11,WA91,Uhrmacherwaren,179002000,208791000,387793000
2016,11,WA92,Musikinstrumente,61172000,61130000,122302000
2016,11,WA93,Waffen und Munition,48360000,18852000,67212000
2016,11,WA94,"Möbel, Beleuchtungskörper usw.",1396524000,1571048000,2967572000
2016,11,WA95,"Spielzeug, Spiele usw., Sportgeräte",458666000,714932000,1173598000
2016,11,WA96,Verschiedene Waren,328701000,234192000,562893000
2016,11,WA97,"Kunstgegenstände, Sammlungsstücke",55169000,32797000,87966000
2016,11,WA98,Vollständige Fabrikationsanlagen,191494000,38000,191532000
2016,11,WA99,Zusammenstellungen verschiedener Waren,1817011000,984973000,2801984000
2016,12,WA01,Lebende Tiere,106217000,190706000,296923000
2016,12,WA02,Fleisch,676559000,584965000,1261524000
2016,12,WA03,"Fische, Krebs- und Weichtiere",165191000,386278000,551469000
2016,12,WA04,"Milch, Milcherzeugnisse, Eier, Honig",674911000,671110000,1346021000
2016,12,WA05,Andere Waren tierischen Ursprungs,63286000,76248000,139534000
2016,12,WA06,"Pflanzen, Waren des Blumenhandels",59163000,220667000,279830000
2016,12,WA07,"Gemüse, Pflanzen für Ernährung",88910000,530333000,619243000
2016,12,WA08,Genießbare Früchte und Nüsse,165296000,787786000,953082000
2016,12,WA09,"Kaffee, Tee, Mate, Gewürze",233374000,394273000,627647000
2016,12,WA10,Getreide,216863000,209418000,426281000
2016,12,WA11,"Müllereierzeugnisse, Malz usw.",115020000,43266000,158286000
2016,12,WA12,"Ölsamen usw., Heilpflanzen usw.",98527000,413270000,511797000
2016,12,WA13,"Schellack, Gummen, Harz, Pflanzensaft",49240000,41164000,90404000
2016,12,WA14,Flechtstoffe usw. pflanzlichen Ursprungs,374000,2767000,3141000
2016,12,WA15,"Tierische und pflanzliche Fette, Öle, Wachs",229116000,303488000,532604000
2016,12,WA16,"Zubereitungen von Fleisch, Fisch usw.",229927000,224466000,454393000
2016,12,WA17,Zucker und Zuckerwaren,160114000,120546000,280660000
2016,12,WA18,Kakao und Zubereitungen aus Kakao,403869000,367234000,771103000
2016,12,WA19,"Zubereitungen aus Getreide usw., Backwaren",472962000,336040000,809002000
2016,12,WA20,"Zubereitungen von Gemüse, Früchten usw.",224288000,396018000,620306000
2016,12,WA21,Verschiedene Lebensmittelzubereitungen,412471000,249015000,661486000
2016,12,WA22,"Getränke, alkoholhaltige Flüssigkeiten, Essig",446141000,606387000,1052528000
2016,12,WA23,"Rückstände der Lebensmittelindustrie, Futter",339721000,340276000,679997000
2016,12,WA24,Tabak,297834000,148744000,446578000
2016,12,WA25,"Salz, Schwefel, Steine, Erden usw.",139141000,134886000,274027000
2016,12,WA26,"Erze, Schlacken, Aschen",39841000,491194000,531035000
2016,12,WA27,Mineralische Brennstoffe usw.,2014570000,6870431000,8885001000
2016,12,WA28,Anorganische chemische Erzeugnisse,640989000,465270000,1106259000
2016,12,WA29,Organische chemische Erzeugnisse,1830669000,2322623000,4153292000
2016,12,WA30,Pharmazeutische Erzeugnisse,5456600000,3593270000,9049870000
2016,12,WA31,Düngemittel,163000000,102995000,265995000
2016,12,WA32,"Gerb- und Farbstoffe, Farben, Lacke usw.",759491000,427922000,1187413000
2016,12,WA33,"Etherische Öle, Riech-, Schönheitsmittel",701641000,569001000,1270642000
2016,12,WA34,"Seifen, Waschmittel usw.",528868000,321494000,850362000
2016,12,WA35,"Eiweißstoffe, Klebstoffe, Enzyme",240015000,148487000,388502000
2016,12,WA36,"Sprengstoffe, pyrotechnische Artikel usw.",24723000,19564000,44287000
2016,12,WA37,Photochemische Erzeugnisse,105041000,65815000,170856000
2016,12,WA38,Verschiedene Erzeugnisse der Chemischen Industrie,1666274000,1018124000,2684398000
2016,12,WA39,Kunststoffe und Waren daraus,3899596000,2641749000,6541345000
2016,12,WA40,Kautschuk und Waren daraus,992284000,855996000,1848280000
2016,12,WA41,"Häute, Felle, Leder",69264000,58771000,128035000
2016,12,WA42,"Lederwaren, Sattlerwaren",168794000,342797000,511591000
2016,12,WA43,"Pelzfelle, künstliches Pelzwerk",8978000,10095000,19073000
2016,12,WA44,"Holz, Holzwaren, Holzkohle",529244000,526033000,1055277000
2016,12,WA45,"Kork, Korkwaren",2088000,6256000,8344000
2016,12,WA46,"Flechtwaren, Korbmacherwaren",2540000,11218000,13758000
2016,12,WA47,"Halbstoffe aus Holz usw., Papierabfall",94813000,301777000,396590000
2016,12,WA48,"Papier, Pappe und Waren daraus",1339647000,936425000,2276072000
2016,12,WA49,"Bücher, Zeitungen, Bilddrucke usw.",364075000,256936000,621011000
2016,12,WA50,Seide,3433000,3824000,7257000
2016,12,WA51,"Wolle, feine und grobe Tierhaare",34894000,45332000,80226000
2016,12,WA52,Baumwolle,70096000,67400000,137496000
2016,12,WA53,"Andere pflanzliche Spinnstoffe, Papiergarn",3629000,6955000,10584000
2016,12,WA54,Synthetisches oder künstliches Filament,131563000,100621000,232184000
2016,12,WA55,Synthetische oder künstliche Spinnfaser,131101000,97408000,228509000
2016,12,WA56,"Watte, Filz, Vliesstoff usw., Tauwerk",160139000,93529000,253668000
2016,12,WA57,"Teppiche, Fußbodenbelag aus Spinnstoff",40719000,99907000,140626000
2016,12,WA58,"Spezialgewebe, Spitzen, Tapisserien",36181000,20389000,56570000
2016,12,WA59,"Getränkte, bestrichene usw. Gewebe",166119000,84042000,250161000
2016,12,WA60,Gewirke und Gestricke,57131000,33496000,90627000
2016,12,WA61,"Bekleidung usw. aus Gewirken, Gestricken",552960000,1244479000,1797439000
2016,12,WA62,"Andere Bekleidung, Bekleidungszubehör",524794000,1179208000,1704002000
2016,12,WA63,"Andere Konfektion, Spinnstoffwaren usw.",189566000,287895000,477461000
2016,12,WA64,"Schuhe, Gamaschen, ähnliche Waren",353128000,765031000,1118159000
2016,12,WA65,Kopfbedeckungen und Teile davon,26814000,45202000,72016000
2016,12,WA66,"Schirme, Gehstöcke usw., Peitschen",5779000,13022000,18801000
2016,12,WA67,"Zugerichtete Federn, Daunen, künstliche Blumen",8251000,19771000,28022000
2016,12,WA68,"Waren aus Steinen, Gips, Zement usw.",314810000,217359000,532169000
2016,12,WA69,Keramische Waren,266043000,198605000,464648000
2016,12,WA70,Glas und Glaswaren,423112000,367494000,790606000
2016,12,WA71,"Perlen, Edelsteine, Edelmetalle",967053000,1584587000,2551640000
2016,12,WA72,Eisen und Stahl,1528749000,1604899000,3133648000
2016,12,WA73,Waren aus Eisen oder Stahl,1822209000,1394345000,3216554000
2016,12,WA74,Kupfer und Waren daraus,704634000,665546000,1370180000
2016,12,WA75,Nickel und Waren daraus,72543000,87033000,159576000
2016,12,WA76,Aluminium und Waren daraus,967043000,1091095000,2058138000
2016,12,WA78,Blei und Waren daraus,24114000,32767000,56881000
2016,12,WA79,Zink und Waren daraus,50688000,115653000,166341000
2016,12,WA80,Zinn und Waren daraus,9249000,33864000,43113000
2016,12,WA81,"Andere unedle Metalle, Cermets usw.",105168000,121734000,226902000
2016,12,WA82,"Werkzeuge, Schneidwaren, Essbestecke",655256000,384789000,1040045000
2016,12,WA83,Verschiedene Waren aus unedlen Metallen,499577000,327387000,826964000
2016,12,WA84,"Maschinen, Apparate, mechanische Geräte",17595540000,10403742000,27999282000
2016,12,WA85,Elektrotechnische Erzeugnisse,10060891000,9853499000,19914390000
2016,12,WA86,Schienenfahrzeuge,314682000,195559000,510241000
2016,12,WA87,"Kraftfahrzeuge, Landfahrzeuge",15592577000,7717581000,23310158000
2016,12,WA88,"Luftfahrzeuge, Raumfahrzeuge",5128426000,1352434000,6480860000
2016,12,WA89,Wasserfahrzeuge,507144000,344732000,851876000
2016,12,WA90,"Optische, photografische usw. Erzeugnisse",5319861000,2887485000,8207346000
2016,12,WA91,Uhrmacherwaren,179210000,181114000,360324000
2016,12,WA92,Musikinstrumente,52074000,58562000,110636000
2016,12,WA93,Waffen und Munition,39276000,14923000,54199000
2016,12,WA94,"Möbel, Beleuchtungskörper usw.",1203122000,1430662000,2633784000
2016,12,WA95,"Spielzeug, Spiele usw., Sportgeräte",343011000,561843000,904854000
2016,12,WA96,Verschiedene Waren,306681000,216306000,522987000
2016,12,WA97,"Kunstgegenstände, Sammlungsstücke",49358000,35744000,85102000
2016,12,WA98,Vollständige Fabrikationsanlagen,222128000,23000,222151000
2016,12,WA99,Zusammenstellungen verschiedener Waren,1583576000,944163000,2527739000
2017,1,WA01,Lebende Tiere,128850000,162910000,291760000
2017,1,WA02,Fleisch,615760000,526388000,1142148000
2017,1,WA03,"Fische, Krebs- und Weichtiere",117208000,348017000,465225000
2017,1,WA04,"Milch, Milcherzeugnisse, Eier, Honig",763227000,601883000,1365110000
2017,1,WA05,Andere Waren tierischen Ursprungs,65414000,75349000,140763000
2017,1,WA06,"Pflanzen, Waren des Blumenhandels",45014000,193838000,238852000
2017,1,WA07,"Gemüse, Pflanzen für Ernährung",99335000,642359000,741694000
2017,1,WA08,Genießbare Früchte und Nüsse,142807000,760991000,903798000
2017,1,WA09,"Kaffee, Tee, Mate, Gewürze",242452000,408017000,650469000
2017,1,WA10,Getreide,259486000,236509000,495995000
2017,1,WA11,"Müllereierzeugnisse, Malz usw.",126894000,44160000,171054000
2017,1,WA12,"Ölsamen usw., Heilpflanzen usw.",151394000,410177000,561571000
2017,1,WA13,"Schellack, Gummen, Harz, Pflanzensaft",56168000,53787000,109955000
2017,1,WA14,Flechtstoffe usw. pflanzlichen Ursprungs,584000,3925000,4509000
2017,1,WA15,"Tierische und pflanzliche Fette, Öle, Wachs",238600000,322032000,560632000
2017,1,WA16,"Zubereitungen von Fleisch, Fisch usw.",222728000,223750000,446478000
2017,1,WA17,Zucker und Zuckerwaren,153458000,129158000,282616000
2017,1,WA18,Kakao und Zubereitungen aus Kakao,432641000,431357000,863998000
2017,1,WA19,"Zubereitungen aus Getreide usw., Backwaren",457518000,327827000,785345000
2017,1,WA20,"Zubereitungen von Gemüse, Früchten usw.",206374000,413909000,620283000
2017,1,WA21,Verschiedene Lebensmittelzubereitungen,437547000,272551000,710098000
2017,1,WA22,"Getränke, alkoholhaltige Flüssigkeiten, Essig",381048000,488112000,869160000
2017,1,WA23,"Rückstände der Lebensmittelindustrie, Futter",325622000,328432000,654054000
2017,1,WA24,Tabak,351109000,152737000,503846000
2017,1,WA25,"Salz, Schwefel, Steine, Erden usw.",134800000,130075000,264875000
2017,1,WA26,"Erze, Schlacken, Aschen",30299000,625618000,655917000
2017,1,WA27,Mineralische Brennstoffe usw.,2058872000,6983033000,9041905000
2017,1,WA28,Anorganische chemische Erzeugnisse,689714000,530138000,1219852000
2017,1,WA29,Organische chemische Erzeugnisse,2191296000,2506757000,4698053000
2017,1,WA30,Pharmazeutische Erzeugnisse,6245414000,3800488000,10045902000
2017,1,WA31,Düngemittel,180110000,99607000,279717000
2017,1,WA32,"Gerb- und Farbstoffe, Farben, Lacke usw.",896171000,487231000,1383402000
2017,1,WA33,"Etherische Öle, Riech-, Schönheitsmittel",736446000,518971000,1255417000
2017,1,WA34,"Seifen, Waschmittel usw.",634657000,307959000,942616000
2017,1,WA35,"Eiweißstoffe, Klebstoffe, Enzyme",281482000,169053000,450535000
2017,1,WA36,"Sprengstoffe, pyrotechnische Artikel usw.",18744000,13560000,32304000
2017,1,WA37,Photochemische Erzeugnisse,100753000,56908000,157661000
2017,1,WA38,Verschiedene Erzeugnisse der Chemischen Industrie,2002990000,1095827000,3098817000
2017,1,WA39,Kunststoffe und Waren daraus,4910852000,3140731000,8051583000
2017,1,WA40,Kautschuk und Waren daraus,1200949000,1072893000,2273842000
2017,1,WA41,"Häute, Felle, Leder",78139000,63918000,142057000
2017,1,WA42,"Lederwaren, Sattlerwaren",184886000,344335000,529221000
2017,1,WA43,"Pelzfelle, künstliches Pelzwerk",8466000,8994000,17460000
2017,1,WA44,"Holz, Holzwaren, Holzkohle",561819000,601417000,1163236000
2017,1,WA45,"Kork, Korkwaren",2774000,11926000,14700000
2017,1,WA46,"Flechtwaren, Korbmacherwaren",3462000,13262000,16724000
2017,1,WA47,"Halbstoffe aus Holz usw., Papierabfall",113380000,308727000,422107000
2017,1,WA48,"Papier, Pappe und Waren daraus",1451560000,1016408000,2467968000
2017,1,WA49,"Bücher, Zeitungen, Bilddrucke usw.",312930000,217513000,530443000
2017,1,WA50,Seide,3280000,4873000,8153000
2017,1,WA51,"Wolle, feine und grobe Tierhaare",48514000,59152000,107666000
2017,1,WA52,Baumwolle,70046000,82546000,152592000
2017,1,WA53,"Andere pflanzliche Spinnstoffe, Papiergarn",4300000,6660000,10960000
2017,1,WA54,Synthetisches oder künstliches Filament,153097000,132752000,285849000
2017,1,WA55,Synthetische oder künstliche Spinnfaser,155298000,135131000,290429000
2017,1,WA56,"Watte, Filz, Vliesstoff usw., Tauwerk",187286000,113167000,300453000
2017,1,WA57,"Teppiche, Fußbodenbelag aus Spinnstoff",45808000,102959000,148767000
2017,1,WA58,"Spezialgewebe, Spitzen, Tapisserien",42196000,21936000,64132000
2017,1,WA59,"Getränkte, bestrichene usw. Gewebe",198420000,97090000,295510000
2017,1,WA60,Gewirke und Gestricke,66021000,35650000,101671000
2017,1,WA61,"Bekleidung usw. aus Gewirken, Gestricken",734544000,1425629000,2160173000
2017,1,WA62,"Andere Bekleidung, Bekleidungszubehör",806057000,1459448000,2265505000
2017,1,WA63,"Andere Konfektion, Spinnstoffwaren usw.",186754000,316622000,503376000
2017,1,WA64,"Schuhe, Gamaschen, ähnliche Waren",606063000,974732000,1580795000
2017,1,WA65,Kopfbedeckungen und Teile davon,29170000,50597000,79767000
2017,1,WA66,"Schirme, Gehstöcke usw., Peitschen",6524000,25315000,31839000
2017,1,WA67,"Zugerichtete Federn, Daunen, künstliche Blumen",11157000,18453000,29610000
2017,1,WA68,"Waren aus Steinen, Gips, Zement usw.",324470000,239776000,564246000
2017,1,WA69,Keramische Waren,237624000,224394000,462018000
2017,1,WA70,Glas und Glaswaren,504804000,432118000,936922000
2017,1,WA71,"Perlen, Edelsteine, Edelmetalle",852531000,1636083000,2488614000
2017,1,WA72,Eisen und Stahl,1830088000,1981751000,3811839000
2017,1,WA73,Waren aus Eisen oder Stahl,2073034000,1589287000,3662321000
2017,1,WA74,Kupfer und Waren daraus,890184000,836094000,1726278000
2017,1,WA75,Nickel und Waren daraus,75597000,102823000,178420000
2017,1,WA76,Aluminium und Waren daraus,1134868000,1204432000,2339300000
2017,1,WA78,Blei und Waren daraus,33391000,35827000,69218000
2017,1,WA79,Zink und Waren daraus,56216000,116996000,173212000
2017,1,WA80,Zinn und Waren daraus,9541000,47304000,56845000
2017,1,WA81,"Andere unedle Metalle, Cermets usw.",111483000,154066000,265549000
2017,1,WA82,"Werkzeuge, Schneidwaren, Essbestecke",638648000,403043000,1041691000
2017,1,WA83,Verschiedene Waren aus unedlen Metallen,627404000,385673000,1013077000
2017,1,WA84,"Maschinen, Apparate, mechanische Geräte",15950727000,10739020000,26689747000
2017,1,WA85,Elektrotechnische Erzeugnisse,10483893000,10597337000,21081230000
2017,1,WA86,Schienenfahrzeuge,389378000,300246000,689624000
2017,1,WA87,"Kraftfahrzeuge, Landfahrzeuge",16530345000,7900151000,24430496000
2017,1,WA88,"Luftfahrzeuge, Raumfahrzeuge",2608437000,1480359000,4088796000
2017,1,WA89,Wasserfahrzeuge,668320000,272210000,940530000
2017,1,WA90,"Optische, photografische usw. Erzeugnisse",4818020000,2793228000,7611248000
2017,1,WA91,Uhrmacherwaren,128145000,169775000,297920000
2017,1,WA92,Musikinstrumente,44116000,43342000,87458000
2017,1,WA93,Waffen und Munition,30630000,15537000,46167000
2017,1,WA94,"Möbel, Beleuchtungskörper usw.",1159329000,1555652000,2714981000
2017,1,WA95,"Spielzeug, Spiele usw., Sportgeräte",275419000,457105000,732524000
2017,1,WA96,Verschiedene Waren,300567000,227504000,528071000
2017,1,WA97,"Kunstgegenstände, Sammlungsstücke",71487000,74733000,146220000
2017,1,WA98,Vollständige Fabrikationsanlagen,140049000,0,140049000
2017,1,WA99,Zusammenstellungen verschiedener Waren,1362521000,924598000,2287119000
2017,2,WA01,Lebende Tiere,99935000,161804000,261739000
2017,2,WA02,Fleisch,598199000,479851000,1078050000
2017,2,WA03,"Fische, Krebs- und Weichtiere",118403000,326701000,445104000
2017,2,WA04,"Milch, Milcherzeugnisse, Eier, Honig",683722000,597646000,1281368000
2017,2,WA05,Andere Waren tierischen Ursprungs,63425000,74694000,138119000
2017,2,WA06,"Pflanzen, Waren des Blumenhandels",67808000,250930000,318738000
2017,2,WA07,"Gemüse, Pflanzen für Ernährung",92347000,655981000,748328000
2017,2,WA08,Genießbare Früchte und Nüsse,156023000,698225000,854248000
2017,2,WA09,"Kaffee, Tee, Mate, Gewürze",247078000,364109000,611187000
2017,2,WA10,Getreide,190631000,227874000,418505000
2017,2,WA11,"Müllereierzeugnisse, Malz usw.",112944000,41504000,154448000
2017,2,WA12,"Ölsamen usw., Heilpflanzen usw.",191107000,402476000,593583000
2017,2,WA13,"Schellack, Gummen, Harz, Pflanzensaft",51409000,39117000,90526000
2017,2,WA14,Flechtstoffe usw. pflanzlichen Ursprungs,568000,2972000,3540000
2017,2,WA15,"Tierische und pflanzliche Fette, Öle, Wachs",237586000,336169000,573755000
2017,2,WA16,"Zubereitungen von Fleisch, Fisch usw.",218959000,191283000,410242000
2017,2,WA17,Zucker und Zuckerwaren,161717000,136128000,297845000
2017,2,WA18,Kakao und Zubereitungen aus Kakao,415140000,374631000,789771000
2017,2,WA19,"Zubereitungen aus Getreide usw., Backwaren",480143000,322218000,802361000
2017,2,WA20,"Zubereitungen von Gemüse, Früchten usw.",227641000,371460000,599101000
2017,2,WA21,Verschiedene Lebensmittelzubereitungen,431501000,256037000,687538000
2017,2,WA22,"Getränke, alkoholhaltige Flüssigkeiten, Essig",416178000,492405000,908583000
2017,2,WA23,"Rückstände der Lebensmittelindustrie, Futter",296041000,282355000,578396000
2017,2,WA24,Tabak,332216000,145577000,477793000
2017,2,WA25,"Salz, Schwefel, Steine, Erden usw.",163089000,137191000,300280000
2017,2,WA26,"Erze, Schlacken, Aschen",35505000,630472000,665977000
2017,2,WA27,Mineralische Brennstoffe usw.,2075042000,7062721000,9137763000
2017,2,WA28,Anorganische chemische Erzeugnisse,696824000,466531000,1163355000
2017,2,WA29,Organische chemische Erzeugnisse,1938920000,2408808000,4347728000
2017,2,WA30,Pharmazeutische Erzeugnisse,5910678000,3860780000,9771458000
2017,2,WA31,Düngemittel,206898000,121968000,328866000
2017,2,WA32,"Gerb- und Farbstoffe, Farben, Lacke usw.",924031000,427882000,1351913000
2017,2,WA33,"Etherische Öle, Riech-, Schönheitsmittel",734328000,545361000,1279689000
2017,2,WA34,"Seifen, Waschmittel usw.",588854000,307507000,896361000
2017,2,WA35,"Eiweißstoffe, Klebstoffe, Enzyme",258950000,164844000,423794000
2017,2,WA36,"Sprengstoffe, pyrotechnische Artikel usw.",17676000,12344000,30020000
2017,2,WA37,Photochemische Erzeugnisse,100958000,70501000,171459000
2017,2,WA38,Verschiedene Erzeugnisse der Chemischen Industrie,1979041000,1055173000,3034214000
2017,2,WA39,Kunststoffe und Waren daraus,4797838000,3093825000,7891663000
2017,2,WA40,Kautschuk und Waren daraus,1209706000,1110376000,2320082000
2017,2,WA41,"Häute, Felle, Leder",79472000,69428000,148900000
2017,2,WA42,"Lederwaren, Sattlerwaren",173042000,326021000,499063000
2017,2,WA43,"Pelzfelle, künstliches Pelzwerk",13009000,10157000,23166000
2017,2,WA44,"Holz, Holzwaren, Holzkohle",603055000,617498000,1220553000
2017,2,WA45,"Kork, Korkwaren",2314000,8433000,10747000
2017,2,WA46,"Flechtwaren, Korbmacherwaren",4977000,9528000,14505000
2017,2,WA47,"Halbstoffe aus Holz usw., Papierabfall",108262000,286109000,394371000
2017,2,WA48,"Papier, Pappe und Waren daraus",1380608000,962743000,2343351000
2017,2,WA49,"Bücher, Zeitungen, Bilddrucke usw.",329576000,190666000,520242000
2017,2,WA50,Seide,3865000,4231000,8096000
2017,2,WA51,"Wolle, feine und grobe Tierhaare",48221000,54703000,102924000
2017,2,WA52,Baumwolle,68431000,73743000,142174000
2017,2,WA53,"Andere pflanzliche Spinnstoffe, Papiergarn",3012000,5229000,8241000
2017,2,WA54,Synthetisches oder künstliches Filament,157703000,123637000,281340000
2017,2,WA55,Synthetische oder künstliche Spinnfaser,142724000,119305000,262029000
2017,2,WA56,"Watte, Filz, Vliesstoff usw., Tauwerk",200969000,113799000,314768000
2017,2,WA57,"Teppiche, Fußbodenbelag aus Spinnstoff",47775000,87245000,135020000
2017,2,WA58,"Spezialgewebe, Spitzen, Tapisserien",42517000,22021000,64538000
2017,2,WA59,"Getränkte, bestrichene usw. Gewebe",199516000,94347000,293863000
2017,2,WA60,Gewirke und Gestricke,68788000,37338000,106126000
2017,2,WA61,"Bekleidung usw. aus Gewirken, Gestricken",658094000,1294993000,1953087000
2017,2,WA62,"Andere Bekleidung, Bekleidungszubehör",789103000,1410599000,2199702000
2017,2,WA63,"Andere Konfektion, Spinnstoffwaren usw.",191998000,290583000,482581000
2017,2,WA64,"Schuhe, Gamaschen, ähnliche Waren",594575000,996326000,1590901000
2017,2,WA65,Kopfbedeckungen und Teile davon,30595000,49342000,79937000
2017,2,WA66,"Schirme, Gehstöcke usw., Peitschen",8052000,27472000,35524000
2017,2,WA67,"Zugerichtete Federn, Daunen, künstliche Blumen",11106000,14974000,26080000
2017,2,WA68,"Waren aus Steinen, Gips, Zement usw.",354169000,244504000,598673000
2017,2,WA69,Keramische Waren,248407000,212201000,460608000
2017,2,WA70,Glas und Glaswaren,500524000,412483000,913007000
2017,2,WA71,"Perlen, Edelsteine, Edelmetalle",872124000,1361099000,2233223000
2017,2,WA72,Eisen und Stahl,1863813000,2022593000,3886406000
2017,2,WA73,Waren aus Eisen oder Stahl,2132040000,1581050000,3713090000
2017,2,WA74,Kupfer und Waren daraus,994310000,815045000,1809355000
2017,2,WA75,Nickel und Waren daraus,78789000,100948000,179737000
2017,2,WA76,Aluminium und Waren daraus,1131882000,1314447000,2446329000
2017,2,WA78,Blei und Waren daraus,30339000,33581000,63920000
2017,2,WA79,Zink und Waren daraus,56364000,126387000,182751000
2017,2,WA80,Zinn und Waren daraus,10854000,38748000,49602000
2017,2,WA81,"Andere unedle Metalle, Cermets usw.",123405000,156975000,280380000
2017,2,WA82,"Werkzeuge, Schneidwaren, Essbestecke",674097000,386875000,1060972000
2017,2,WA83,Verschiedene Waren aus unedlen Metallen,598910000,374795000,973705000
2017,2,WA84,"Maschinen, Apparate, mechanische Geräte",17284330000,10226862000,27511192000
2017,2,WA85,Elektrotechnische Erzeugnisse,10515302000,9871780000,20387082000
2017,2,WA86,Schienenfahrzeuge,438656000,194621000,633277000
2017,2,WA87,"Kraftfahrzeuge, Landfahrzeuge",18735401000,8901987000,27637388000
2017,2,WA88,"Luftfahrzeuge, Raumfahrzeuge",3160566000,1503612000,4664178000
2017,2,WA89,Wasserfahrzeuge,116279000,182398000,298677000
2017,2,WA90,"Optische, photografische usw. Erzeugnisse",4979780000,2772772000,7752552000
2017,2,WA91,Uhrmacherwaren,126927000,138389000,265316000
2017,2,WA92,Musikinstrumente,40792000,38182000,78974000
2017,2,WA93,Waffen und Munition,43771000,20028000,63799000
2017,2,WA94,"Möbel, Beleuchtungskörper usw.",1208934000,1480826000,2689760000
2017,2,WA95,"Spielzeug, Spiele usw., Sportgeräte",318891000,426002000,744893000
2017,2,WA96,Verschiedene Waren,299538000,217329000,516867000
2017,2,WA97,"Kunstgegenstände, Sammlungsstücke",68688000,29150000,97838000
2017,2,WA98,Vollständige Fabrikationsanlagen,187817000,0,187817000
2017,2,WA99,Zusammenstellungen verschiedener Waren,1712267000,954571000,2666838000
2017,3,WA01,Lebende Tiere,114184000,156574000,270758000
2017,3,WA02,Fleisch,629453000,530587000,1160040000
2017,3,WA03,"Fische, Krebs- und Weichtiere",136050000,342097000,478147000
2017,3,WA04,"Milch, Milcherzeugnisse, Eier, Honig",789426000,670912000,1460338000
2017,3,WA05,Andere Waren tierischen Ursprungs,75343000,77839000,153182000
2017,3,WA06,"Pflanzen, Waren des Blumenhandels",103738000,273588000,377326000
2017,3,WA07,"Gemüse, Pflanzen für Ernährung",105768000,632901000,738669000
2017,3,WA08,Genießbare Früchte und Nüsse,147636000,733950000,881586000
2017,3,WA09,"Kaffee, Tee, Mate, Gewürze",258730000,419589000,678319000
2017,3,WA10,Getreide,303458000,255202000,558660000
2017,3,WA11,"Müllereierzeugnisse, Malz usw.",132190000,44715000,176905000
2017,3,WA12,"Ölsamen usw., Heilpflanzen usw.",165986000,417787000,583773000
2017,3,WA13,"Schellack, Gummen, Harz, Pflanzensaft",64379000,41329000,105708000
2017,3,WA14,Flechtstoffe usw. pflanzlichen Ursprungs,781000,2550000,3331000
2017,3,WA15,"Tierische und pflanzliche Fette, Öle, Wachs",266964000,343848000,610812000
2017,3,WA16,"Zubereitungen von Fleisch, Fisch usw.",212312000,211313000,423625000
2017,3,WA17,Zucker und Zuckerwaren,175051000,135640000,310691000
2017,3,WA18,Kakao und Zubereitungen aus Kakao,374629000,358536000,733165000
2017,3,WA19,"Zubereitungen aus Getreide usw., Backwaren",541942000,311942000,853884000
2017,3,WA20,"Zubereitungen von Gemüse, Früchten usw.",238296000,410707000,649003000
2017,3,WA21,Verschiedene Lebensmittelzubereitungen,499987000,282083000,782070000
2017,3,WA22,"Getränke, alkoholhaltige Flüssigkeiten, Essig",488924000,578962000,1067886000
2017,3,WA23,"Rückstände der Lebensmittelindustrie, Futter",310198000,326120000,636318000
2017,3,WA24,Tabak,356140000,168783000,524923000
2017,3,WA25,"Salz, Schwefel, Steine, Erden usw.",178579000,170034000,348613000
2017,3,WA26,"Erze, Schlacken, Aschen",51943000,781695000,833638000
2017,3,WA27,Mineralische Brennstoffe usw.,2139849000,7377558000,9517407000
2017,3,WA28,Anorganische chemische Erzeugnisse,759595000,700369000,1459964000
2017,3,WA29,Organische chemische Erzeugnisse,2283762000,3499536000,5783298000
2017,3,WA30,Pharmazeutische Erzeugnisse,6912433000,4250884000,11163317000
2017,3,WA31,Düngemittel,220310000,131251000,351561000
2017,3,WA32,"Gerb- und Farbstoffe, Farben, Lacke usw.",1020421000,582213000,1602634000
2017,3,WA33,"Etherische Öle, Riech-, Schönheitsmittel",855974000,585554000,1441528000
2017,3,WA34,"Seifen, Waschmittel usw.",676501000,324602000,1001103000
2017,3,WA35,"Eiweißstoffe, Klebstoffe, Enzyme",289340000,184967000,474307000
2017,3,WA36,"Sprengstoffe, pyrotechnische Artikel usw.",24645000,12010000,36655000
2017,3,WA37,Photochemische Erzeugnisse,113762000,80811000,194573000
2017,3,WA38,Verschiedene Erzeugnisse der Chemischen Industrie,2154103000,1238986000,3393089000
2017,3,WA39,Kunststoffe und Waren daraus,5433814000,3409652000,8843466000
2017,3,WA40,Kautschuk und Waren daraus,1459513000,1332168000,2791681000
2017,3,WA41,"Häute, Felle, Leder",86657000,77306000,163963000
2017,3,WA42,"Lederwaren, Sattlerwaren",192139000,344354000,536493000
2017,3,WA43,"Pelzfelle, künstliches Pelzwerk",10251000,11414000,21665000
2017,3,WA44,"Holz, Holzwaren, Holzkohle",696026000,673729000,1369755000
2017,3,WA45,"Kork, Korkwaren",2634000,9189000,11823000
2017,3,WA46,"Flechtwaren, Korbmacherwaren",4546000,13150000,17696000
2017,3,WA47,"Halbstoffe aus Holz usw., Papierabfall",113244000,324135000,437379000
2017,3,WA48,"Papier, Pappe und Waren daraus",1520487000,1052035000,2572522000
2017,3,WA49,"Bücher, Zeitungen, Bilddrucke usw.",338336000,213451000,551787000
2017,3,WA50,Seide,5406000,4522000,9928000
2017,3,WA51,"Wolle, feine und grobe Tierhaare",50440000,54242000,104682000
2017,3,WA52,Baumwolle,77882000,84418000,162300000
2017,3,WA53,"Andere pflanzliche Spinnstoffe, Papiergarn",3701000,6263000,9964000
2017,3,WA54,Synthetisches oder künstliches Filament,181743000,141802000,323545000
2017,3,WA55,Synthetische oder künstliche Spinnfaser,167192000,130685000,297877000
2017,3,WA56,"Watte, Filz, Vliesstoff usw., Tauwerk",216393000,127757000,344150000
2017,3,WA57,"Teppiche, Fußbodenbelag aus Spinnstoff",46640000,94232000,140872000
2017,3,WA58,"Spezialgewebe, Spitzen, Tapisserien",46630000,23725000,70355000
2017,3,WA59,"Getränkte, bestrichene usw. Gewebe",227820000,107660000,335480000
2017,3,WA60,Gewirke und Gestricke,82686000,46006000,128692000
2017,3,WA61,"Bekleidung usw. aus Gewirken, Gestricken",690437000,1358377000,2048814000
2017,3,WA62,"Andere Bekleidung, Bekleidungszubehör",858648000,1525338000,2383986000
2017,3,WA63,"Andere Konfektion, Spinnstoffwaren usw.",211610000,327291000,538901000
2017,3,WA64,"Schuhe, Gamaschen, ähnliche Waren",634162000,995858000,1630020000
2017,3,WA65,Kopfbedeckungen und Teile davon,34461000,54379000,88840000
2017,3,WA66,"Schirme, Gehstöcke usw., Peitschen",8478000,25896000,34374000
2017,3,WA67,"Zugerichtete Federn, Daunen, künstliche Blumen",11430000,14883000,26313000
2017,3,WA68,"Waren aus Steinen, Gips, Zement usw.",421223000,273410000,694633000
2017,3,WA69,Keramische Waren,278839000,227081000,505920000
2017,3,WA70,Glas und Glaswaren,566409000,460808000,1027217000
2017,3,WA71,"Perlen, Edelsteine, Edelmetalle",1111013000,1586651000,2697664000
2017,3,WA72,Eisen und Stahl,2171102000,2362507000,4533609000
2017,3,WA73,Waren aus Eisen oder Stahl,2431583000,1795232000,4226815000
2017,3,WA74,Kupfer und Waren daraus,971671000,807168000,1778839000
2017,3,WA75,Nickel und Waren daraus,91939000,108440000,200379000
2017,3,WA76,Aluminium und Waren daraus,1305632000,1412394000,2718026000
2017,3,WA78,Blei und Waren daraus,42472000,56285000,98757000
2017,3,WA79,Zink und Waren daraus,68257000,143273000,211530000
2017,3,WA80,Zinn und Waren daraus,11108000,36274000,47382000
2017,3,WA81,"Andere unedle Metalle, Cermets usw.",142221000,170566000,312787000
2017,3,WA82,"Werkzeuge, Schneidwaren, Essbestecke",748998000,425451000,1174449000
2017,3,WA83,Verschiedene Waren aus unedlen Metallen,693307000,414038000,1107345000
2017,3,WA84,"Maschinen, Apparate, mechanische Geräte",20405518000,12126508000,32532026000
2017,3,WA85,Elektrotechnische Erzeugnisse,11700793000,11049509000,22750302000
2017,3,WA86,Schienenfahrzeuge,345157000,257391000,602548000
2017,3,WA87,"Kraftfahrzeuge, Landfahrzeuge",22289222000,10206590000,32495812000
2017,3,WA88,"Luftfahrzeuge, Raumfahrzeuge",3433324000,1681007000,5114331000
2017,3,WA89,Wasserfahrzeuge,1253138000,50352000,1303490000
2017,3,WA90,"Optische, photografische usw. Erzeugnisse",5916490000,3246281000,9162771000
2017,3,WA91,Uhrmacherwaren,145862000,163928000,309790000
2017,3,WA92,Musikinstrumente,52193000,48114000,100307000
2017,3,WA93,Waffen und Munition,40860000,17059000,57919000
2017,3,WA94,"Möbel, Beleuchtungskörper usw.",1363123000,1640853000,3003976000
2017,3,WA95,"Spielzeug, Spiele usw., Sportgeräte",326529000,502287000,828816000
2017,3,WA96,Verschiedene Waren,357636000,259378000,617014000
2017,3,WA97,"Kunstgegenstände, Sammlungsstücke",75540000,37874000,113414000
2017,3,WA98,Vollständige Fabrikationsanlagen,191233000,0,191233000
2017,3,WA99,Zusammenstellungen verschiedener Waren,1559338000,987740000,2547078000
2017,4,WA01,Lebende Tiere,116939000,187053000,303992000
2017,4,WA02,Fleisch,631579000,568108000,1199687000
2017,4,WA03,"Fische, Krebs- und Weichtiere",142787000,343244000,486031000
2017,4,WA04,"Milch, Milcherzeugnisse, Eier, Honig",779358000,670408000,1449766000
2017,4,WA05,Andere Waren tierischen Ursprungs,67909000,73811000,141720000
2017,4,WA06,"Pflanzen, Waren des Blumenhandels",118146000,344614000,462760000
2017,4,WA07,"Gemüse, Pflanzen für Ernährung",111784000,653626000,765410000
2017,4,WA08,Genießbare Früchte und Nüsse,148555000,784426000,932981000
2017,4,WA09,"Kaffee, Tee, Mate, Gewürze",239068000,356757000,595825000
2017,4,WA10,Getreide,228265000,193201000,421466000
2017,4,WA11,"Müllereierzeugnisse, Malz usw.",124304000,43269000,167573000
2017,4,WA12,"Ölsamen usw., Heilpflanzen usw.",97163000,425879000,523042000
2017,4,WA13,"Schellack, Gummen, Harz, Pflanzensaft",54568000,40019000,94587000
2017,4,WA14,Flechtstoffe usw. pflanzlichen Ursprungs,643000,4139000,4782000
2017,4,WA15,"Tierische und pflanzliche Fette, Öle, Wachs",266222000,315174000,581396000
2017,4,WA16,"Zubereitungen von Fleisch, Fisch usw.",250134000,235162000,485296000
2017,4,WA17,Zucker und Zuckerwaren,164702000,134538000,299240000
2017,4,WA18,Kakao und Zubereitungen aus Kakao,343324000,309227000,652551000
2017,4,WA19,"Zubereitungen aus Getreide usw., Backwaren",479665000,376588000,856253000
2017,4,WA20,"Zubereitungen von Gemüse, Früchten usw.",237354000,401166000,638520000
2017,4,WA21,Verschiedene Lebensmittelzubereitungen,450708000,274645000,725353000
2017,4,WA22,"Getränke, alkoholhaltige Flüssigkeiten, Essig",463578000,573255000,1036833000
2017,4,WA23,"Rückstände der Lebensmittelindustrie, Futter",326740000,288324000,615064000
2017,4,WA24,Tabak,352468000,138869000,491337000
2017,4,WA25,"Salz, Schwefel, Steine, Erden usw.",166429000,144314000,310743000
2017,4,WA26,"Erze, Schlacken, Aschen",40489000,620441000,660930000
2017,4,WA27,Mineralische Brennstoffe usw.,1783214000,6723804000,8507018000
2017,4,WA28,Anorganische chemische Erzeugnisse,717169000,486976000,1204145000
2017,4,WA29,Organische chemische Erzeugnisse,2021759000,2391918000,4413677000
2017,4,WA30,Pharmazeutische Erzeugnisse,5586213000,4034130000,9620343000
2017,4,WA31,Düngemittel,178896000,105155000,284051000
2017,4,WA32,"Gerb- und Farbstoffe, Farben, Lacke usw.",944063000,498111000,1442174000
2017,4,WA33,"Etherische Öle, Riech-, Schönheitsmittel",716788000,554951000,1271739000
2017,4,WA34,"Seifen, Waschmittel usw.",579115000,286871000,865986000
2017,4,WA35,"Eiweißstoffe, Klebstoffe, Enzyme",271139000,160697000,431836000
2017,4,WA36,"Sprengstoffe, pyrotechnische Artikel usw.",17629000,13109000,30738000
2017,4,WA37,Photochemische Erzeugnisse,95659000,58029000,153688000
2017,4,WA38,Verschiedene Erzeugnisse der Chemischen Industrie,1814277000,1069846000,2884123000
2017,4,WA39,Kunststoffe und Waren daraus,4871444000,3216122000,8087566000
2017,4,WA40,Kautschuk und Waren daraus,1285605000,1158399000,2444004000
2017,4,WA41,"Häute, Felle, Leder",77552000,65865000,143417000
2017,4,WA42,"Lederwaren, Sattlerwaren",176698000,293821000,470519000
2017,4,WA43,"Pelzfelle, künstliches Pelzwerk",8406000,9296000,17702000
2017,4,WA44,"Holz, Holzwaren, Holzkohle",622365000,659442000,1281807000
2017,4,WA45,"Kork, Korkwaren",2509000,10925000,13434000
2017,4,WA46,"Flechtwaren, Korbmacherwaren",4752000,9425000,14177000
2017,4,WA47,"Halbstoffe aus Holz usw., Papierabfall",91854000,302451000,394305000
2017,4,WA48,"Papier, Pappe und Waren daraus",1423295000,987942000,2411237000
2017,4,WA49,"Bücher, Zeitungen, Bilddrucke usw.",320063000,189013000,509076000
2017,4,WA50,Seide,3662000,3602000,7264000
2017,4,WA51,"Wolle, feine und grobe Tierhaare",47468000,62207000,109675000
2017,4,WA52,Baumwolle,73400000,81725000,155125000
2017,4,WA53,"Andere pflanzliche Spinnstoffe, Papiergarn",2499000,5335000,7834000
2017,4,WA54,Synthetisches oder künstliches Filament,154832000,131545000,286377000
2017,4,WA55,Synthetische oder künstliche Spinnfaser,149739000,132883000,282622000
2017,4,WA56,"Watte, Filz, Vliesstoff usw., Tauwerk",203255000,118379000,321634000
2017,4,WA57,"Teppiche, Fußbodenbelag aus Spinnstoff",42981000,92727000,135708000
2017,4,WA58,"Spezialgewebe, Spitzen, Tapisserien",43331000,22532000,65863000
2017,4,WA59,"Getränkte, bestrichene usw. Gewebe",204680000,93797000,298477000
2017,4,WA60,Gewirke und Gestricke,79837000,47720000,127557000
2017,4,WA61,"Bekleidung usw. aus Gewirken, Gestricken",596535000,1148890000,1745425000
2017,4,WA62,"Andere Bekleidung, Bekleidungszubehör",667846000,1192926000,1860772000
2017,4,WA63,"Andere Konfektion, Spinnstoffwaren usw.",191344000,300076000,491420000
2017,4,WA64,"Schuhe, Gamaschen, ähnliche Waren",463686000,770276000,1233962000
2017,4,WA65,Kopfbedeckungen und Teile davon,33929000,42923000,76852000
2017,4,WA66,"Schirme, Gehstöcke usw., Peitschen",8942000,21401000,30343000
2017,4,WA67,"Zugerichtete Federn, Daunen, künstliche Blumen",8862000,10967000,19829000
2017,4,WA68,"Waren aus Steinen, Gips, Zement usw.",382184000,254530000,636714000
2017,4,WA69,Keramische Waren,263431000,234996000,498427000
2017,4,WA70,Glas und Glaswaren,504626000,409240000,913866000
2017,4,WA71,"Perlen, Edelsteine, Edelmetalle",1018175000,1160252000,2178427000
2017,4,WA72,Eisen und Stahl,1933507000,2040680000,3974187000
2017,4,WA73,Waren aus Eisen oder Stahl,2363674000,1622511000,3986185000
2017,4,WA74,Kupfer und Waren daraus,924934000,817600000,1742534000
2017,4,WA75,Nickel und Waren daraus,79087000,106883000,185970000
2017,4,WA76,Aluminium und Waren daraus,1188205000,1333746000,2521951000
2017,4,WA78,Blei und Waren daraus,37929000,45581000,83510000
2017,4,WA79,Zink und Waren daraus,64753000,141189000,205942000
2017,4,WA80,Zinn und Waren daraus,8764000,40367000,49131000
2017,4,WA81,"Andere unedle Metalle, Cermets usw.",123390000,159001000,282391000
2017,4,WA82,"Werkzeuge, Schneidwaren, Essbestecke",664692000,409865000,1074557000
2017,4,WA83,Verschiedene Waren aus unedlen Metallen,572536000,353244000,925780000
2017,4,WA84,"Maschinen, Apparate, mechanische Geräte",17223387000,10528581000,27751968000
2017,4,WA85,Elektrotechnische Erzeugnisse,10296978000,10052937000,20349915000
2017,4,WA86,Schienenfahrzeuge,345550000,182682000,528232000
2017,4,WA87,"Kraftfahrzeuge, Landfahrzeuge",17678478000,9070116000,26748594000
2017,4,WA88,"Luftfahrzeuge, Raumfahrzeuge",2657722000,1107525000,3765247000
2017,4,WA89,Wasserfahrzeuge,247809000,438177000,685986000
2017,4,WA90,"Optische, photografische usw. Erzeugnisse",4794728000,2784891000,7579619000
2017,4,WA91,Uhrmacherwaren,126246000,157523000,283769000
2017,4,WA92,Musikinstrumente,45532000,42116000,87648000
2017,4,WA93,Waffen und Munition,44938000,18457000,63395000
2017,4,WA94,"Möbel, Beleuchtungskörper usw.",1183868000,1504935000,2688803000
2017,4,WA95,"Spielzeug, Spiele usw., Sportgeräte",291570000,436145000,727715000
2017,4,WA96,Verschiedene Waren,329554000,228006000,557560000
2017,4,WA97,"Kunstgegenstände, Sammlungsstücke",57255000,44340000,101595000
2017,4,WA98,Vollständige Fabrikationsanlagen,184422000,0,184422000
2017,4,WA99,Zusammenstellungen verschiedener Waren,2129166000,991777000,3120943000
2017,5,WA01,Lebende Tiere,114321000,167044000,281365000
2017,5,WA02,Fleisch,668525000,575953000,1244478000
2017,5,WA03,"Fische, Krebs- und Weichtiere",148430000,339775000,488205000
2017,5,WA04,"Milch, Milcherzeugnisse, Eier, Honig",802923000,668440000,1471363000
2017,5,WA05,Andere Waren tierischen Ursprungs,83987000,88577000,172564000
2017,5,WA06,"Pflanzen, Waren des Blumenhandels",124864000,380439000,505303000
2017,5,WA07,"Gemüse, Pflanzen für Ernährung",90978000,556307000,647285000
2017,5,WA08,Genießbare Früchte und Nüsse,168738000,858607000,1027345000
2017,5,WA09,"Kaffee, Tee, Mate, Gewürze",239882000,410527000,650409000
2017,5,WA10,Getreide,221238000,202894000,424132000
2017,5,WA11,"Müllereierzeugnisse, Malz usw.",133982000,47098000,181080000
2017,5,WA12,"Ölsamen usw., Heilpflanzen usw.",83554000,443254000,526808000
2017,5,WA13,"Schellack, Gummen, Harz, Pflanzensaft",55886000,40982000,96868000
2017,5,WA14,Flechtstoffe usw. pflanzlichen Ursprungs,723000,3778000,4501000
2017,5,WA15,"Tierische und pflanzliche Fette, Öle, Wachs",259449000,376787000,636236000
2017,5,WA16,"Zubereitungen von Fleisch, Fisch usw.",235634000,234527000,470161000
2017,5,WA17,Zucker und Zuckerwaren,178483000,156188000,334671000
2017,5,WA18,Kakao und Zubereitungen aus Kakao,349548000,356378000,705926000
2017,5,WA19,"Zubereitungen aus Getreide usw., Backwaren",539591000,355959000,895550000
2017,5,WA20,"Zubereitungen von Gemüse, Früchten usw.",240953000,418254000,659207000
2017,5,WA21,Verschiedene Lebensmittelzubereitungen,509220000,309518000,818738000
2017,5,WA22,"Getränke, alkoholhaltige Flüssigkeiten, Essig",542819000,593330000,1136149000
2017,5,WA23,"Rückstände der Lebensmittelindustrie, Futter",312666000,331245000,643911000
2017,5,WA24,Tabak,369680000,212713000,582393000
2017,5,WA25,"Salz, Schwefel, Steine, Erden usw.",178507000,166543000,345050000
2017,5,WA26,"Erze, Schlacken, Aschen",43717000,663547000,707264000
2017,5,WA27,Mineralische Brennstoffe usw.,1781263000,6750446000,8531709000
2017,5,WA28,Anorganische chemische Erzeugnisse,741047000,631410000,1372457000
2017,5,WA29,Organische chemische Erzeugnisse,2109154000,2942535000,5051689000
2017,5,WA30,Pharmazeutische Erzeugnisse,6248769000,3802931000,10051700000
2017,5,WA31,Düngemittel,169736000,71431000,241167000
2017,5,WA32,"Gerb- und Farbstoffe, Farben, Lacke usw.",1022521000,554145000,1576666000
2017,5,WA33,"Etherische Öle, Riech-, Schönheitsmittel",819573000,568727000,1388300000
2017,5,WA34,"Seifen, Waschmittel usw.",641300000,324972000,966272000
2017,5,WA35,"Eiweißstoffe, Klebstoffe, Enzyme",307107000,184575000,491682000
2017,5,WA36,"Sprengstoffe, pyrotechnische Artikel usw.",18844000,16414000,35258000
2017,5,WA37,Photochemische Erzeugnisse,114576000,84297000,198873000
2017,5,WA38,Verschiedene Erzeugnisse der Chemischen Industrie,1880396000,1169021000,3049417000
2017,5,WA39,Kunststoffe und Waren daraus,5309026000,3501835000,8810861000
2017,5,WA40,Kautschuk und Waren daraus,1356995000,1259741000,2616736000
2017,5,WA41,"Häute, Felle, Leder",87486000,79215000,166701000
2017,5,WA42,"Lederwaren, Sattlerwaren",180706000,359014000,539720000
2017,5,WA43,"Pelzfelle, künstliches Pelzwerk",9179000,14701000,23880000
2017,5,WA44,"Holz, Holzwaren, Holzkohle",697774000,711135000,1408909000
2017,5,WA45,"Kork, Korkwaren",2678000,9169000,11847000
2017,5,WA46,"Flechtwaren, Korbmacherwaren",4455000,10492000,14947000
2017,5,WA47,"Halbstoffe aus Holz usw., Papierabfall",113295000,331525000,444820000
2017,5,WA48,"Papier, Pappe und Waren daraus",1533480000,1041087000,2574567000
2017,5,WA49,"Bücher, Zeitungen, Bilddrucke usw.",338553000,207073000,545626000
2017,5,WA50,Seide,4293000,5123000,9416000
2017,5,WA51,"Wolle, feine und grobe Tierhaare",45963000,60135000,106098000
2017,5,WA52,Baumwolle,75318000,93396000,168714000
2017,5,WA53,"Andere pflanzliche Spinnstoffe, Papiergarn",2791000,5610000,8401000
2017,5,WA54,Synthetisches oder künstliches Filament,172404000,147050000,319454000
2017,5,WA55,Synthetische oder künstliche Spinnfaser,173935000,137780000,311715000
2017,5,WA56,"Watte, Filz, Vliesstoff usw., Tauwerk",215411000,136059000,351470000
2017,5,WA57,"Teppiche, Fußbodenbelag aus Spinnstoff",47179000,90543000,137722000
2017,5,WA58,"Spezialgewebe, Spitzen, Tapisserien",47024000,23603000,70627000
2017,5,WA59,"Getränkte, bestrichene usw. Gewebe",224484000,100551000,325035000
2017,5,WA60,Gewirke und Gestricke,84471000,49833000,134304000
2017,5,WA61,"Bekleidung usw. aus Gewirken, Gestricken",612688000,1248255000,1860943000
2017,5,WA62,"Andere Bekleidung, Bekleidungszubehör",652483000,1254192000,1906675000
2017,5,WA63,"Andere Konfektion, Spinnstoffwaren usw.",224093000,359262000,583355000
2017,5,WA64,"Schuhe, Gamaschen, ähnliche Waren",467412000,885000000,1352412000
2017,5,WA65,Kopfbedeckungen und Teile davon,29599000,43290000,72889000
2017,5,WA66,"Schirme, Gehstöcke usw., Peitschen",8719000,22693000,31412000
2017,5,WA67,"Zugerichtete Federn, Daunen, künstliche Blumen",8584000,14129000,22713000
2017,5,WA68,"Waren aus Steinen, Gips, Zement usw.",406290000,289953000,696243000
2017,5,WA69,Keramische Waren,274573000,247560000,522133000
2017,5,WA70,Glas und Glaswaren,546235000,456997000,1003232000
2017,5,WA71,"Perlen, Edelsteine, Edelmetalle",1038889000,1302169000,2341058000
2017,5,WA72,Eisen und Stahl,1994440000,2306339000,4300779000
2017,5,WA73,Waren aus Eisen oder Stahl,2352608000,1794028000,4146636000
2017,5,WA74,Kupfer und Waren daraus,943988000,794349000,1738337000
2017,5,WA75,Nickel und Waren daraus,99606000,118911000,218517000
2017,5,WA76,Aluminium und Waren daraus,1277963000,1495092000,2773055000
2017,5,WA78,Blei und Waren daraus,42809000,42903000,85712000
2017,5,WA79,Zink und Waren daraus,68818000,143136000,211954000
2017,5,WA80,Zinn und Waren daraus,9912000,40879000,50791000
2017,5,WA81,"Andere unedle Metalle, Cermets usw.",131107000,168274000,299381000
2017,5,WA82,"Werkzeuge, Schneidwaren, Essbestecke",692462000,443102000,1135564000
2017,5,WA83,Verschiedene Waren aus unedlen Metallen,649921000,405851000,1055772000
2017,5,WA84,"Maschinen, Apparate, mechanische Geräte",19058540000,11230384000,30288924000
2017,5,WA85,Elektrotechnische Erzeugnisse,11101356000,10977312000,22078668000
2017,5,WA86,Schienenfahrzeuge,378978000,223437000,602415000
2017,5,WA87,"Kraftfahrzeuge, Landfahrzeuge",20439043000,9925319000,30364362000
2017,5,WA88,"Luftfahrzeuge, Raumfahrzeuge",3858876000,1077275000,4936151000
2017,5,WA89,Wasserfahrzeuge,324841000,79030000,403871000
2017,5,WA90,"Optische, photografische usw. Erzeugnisse",5480177000,3050294000,8530471000
2017,5,WA91,Uhrmacherwaren,144166000,166409000,310575000
2017,5,WA92,Musikinstrumente,46942000,47297000,94239000
2017,5,WA93,Waffen und Munition,41113000,24739000,65852000
2017,5,WA94,"Möbel, Beleuchtungskörper usw.",1333130000,1567145000,2900275000
2017,5,WA95,"Spielzeug, Spiele usw., Sportgeräte",319806000,469225000,789031000
2017,5,WA96,Verschiedene Waren,333981000,231039000,565020000
2017,5,WA97,"Kunstgegenstände, Sammlungsstücke",52391000,35286000,87677000
2017,5,WA98,Vollständige Fabrikationsanlagen,149874000,12000,149886000
2017,5,WA99,Zusammenstellungen verschiedener Waren,1576967000,1014815000,2591782000
2017,6,WA01,Lebende Tiere,134892000,197232000,332124000
2017,6,WA02,Fleisch,702988000,571289000,1274277000
2017,6,WA03,"Fische, Krebs- und Weichtiere",132987000,311506000,444493000
2017,6,WA04,"Milch, Milcherzeugnisse, Eier, Honig",825096000,672447000,1497543000
2017,6,WA05,Andere Waren tierischen Ursprungs,78733000,91130000,169863000
2017,6,WA06,"Pflanzen, Waren des Blumenhandels",69367000,227144000,296511000
2017,6,WA07,"Gemüse, Pflanzen für Ernährung",82002000,452316000,534318000
2017,6,WA08,Genießbare Früchte und Nüsse,166074000,874136000,1040210000
2017,6,WA09,"Kaffee, Tee, Mate, Gewürze",229817000,333514000,563331000
2017,6,WA10,Getreide,170424000,167923000,338347000
2017,6,WA11,"Müllereierzeugnisse, Malz usw.",123322000,45283000,168605000
2017,6,WA12,"Ölsamen usw., Heilpflanzen usw.",90763000,411116000,501879000
2017,6,WA13,"Schellack, Gummen, Harz, Pflanzensaft",56467000,41830000,98297000
2017,6,WA14,Flechtstoffe usw. pflanzlichen Ursprungs,593000,3245000,3838000
2017,6,WA15,"Tierische und pflanzliche Fette, Öle, Wachs",246323000,362279000,608602000
2017,6,WA16,"Zubereitungen von Fleisch, Fisch usw.",245295000,228322000,473617000
2017,6,WA17,Zucker und Zuckerwaren,167650000,130176000,297826000
2017,6,WA18,Kakao und Zubereitungen aus Kakao,327376000,332346000,659722000
2017,6,WA19,"Zubereitungen aus Getreide usw., Backwaren",510667000,324277000,834944000
2017,6,WA20,"Zubereitungen von Gemüse, Früchten usw.",254576000,409317000,663893000
2017,6,WA21,Verschiedene Lebensmittelzubereitungen,505825000,279990000,785815000
2017,6,WA22,"Getränke, alkoholhaltige Flüssigkeiten, Essig",550726000,614157000,1164883000
2017,6,WA23,"Rückstände der Lebensmittelindustrie, Futter",315090000,311330000,626420000
2017,6,WA24,Tabak,337901000,195157000,533058000
2017,6,WA25,"Salz, Schwefel, Steine, Erden usw.",175594000,153442000,329036000
2017,6,WA26,"Erze, Schlacken, Aschen",40884000,598473000,639357000
2017,6,WA27,Mineralische Brennstoffe usw.,1666344000,6034038000,7700382000
2017,6,WA28,Anorganische chemische Erzeugnisse,750020000,547967000,1297987000
2017,6,WA29,Organische chemische Erzeugnisse,1979377000,2391638000,4371015000
2017,6,WA30,Pharmazeutische Erzeugnisse,5824522000,3818049000,9642571000
2017,6,WA31,Düngemittel,140832000,71371000,212203000
2017,6,WA32,"Gerb- und Farbstoffe, Farben, Lacke usw.",1031997000,505823000,1537820000
2017,6,WA33,"Etherische Öle, Riech-, Schönheitsmittel",761801000,620196000,1381997000
2017,6,WA34,"Seifen, Waschmittel usw.",642030000,314000000,956030000
2017,6,WA35,"Eiweißstoffe, Klebstoffe, Enzyme",293865000,172631000,466496000
2017,6,WA36,"Sprengstoffe, pyrotechnische Artikel usw.",17399000,20886000,38285000
2017,6,WA37,Photochemische Erzeugnisse,105608000,75999000,181607000
2017,6,WA38,Verschiedene Erzeugnisse der Chemischen Industrie,1875190000,1127591000,3002781000
2017,6,WA39,Kunststoffe und Waren daraus,5255691000,3372170000,8627861000
2017,6,WA40,Kautschuk und Waren daraus,1247433000,1167929000,2415362000
2017,6,WA41,"Häute, Felle, Leder",75547000,64153000,139700000
2017,6,WA42,"Lederwaren, Sattlerwaren",190776000,376341000,567117000
2017,6,WA43,"Pelzfelle, künstliches Pelzwerk",12314000,14806000,27120000
2017,6,WA44,"Holz, Holzwaren, Holzkohle",680847000,669762000,1350609000
2017,6,WA45,"Kork, Korkwaren",2216000,8824000,11040000
2017,6,WA46,"Flechtwaren, Korbmacherwaren",3342000,9440000,12782000
2017,6,WA47,"Halbstoffe aus Holz usw., Papierabfall",103500000,330794000,434294000
2017,6,WA48,"Papier, Pappe und Waren daraus",1507438000,990126000,2497564000
2017,6,WA49,"Bücher, Zeitungen, Bilddrucke usw.",322335000,210813000,533148000
2017,6,WA50,Seide,3987000,5124000,9111000
2017,6,WA51,"Wolle, feine und grobe Tierhaare",48048000,59182000,107230000
2017,6,WA52,Baumwolle,79263000,78131000,157394000
2017,6,WA53,"Andere pflanzliche Spinnstoffe, Papiergarn",2888000,5049000,7937000
2017,6,WA54,Synthetisches oder künstliches Filament,164527000,136258000,300785000
2017,6,WA55,Synthetische oder künstliche Spinnfaser,157514000,130828000,288342000
2017,6,WA56,"Watte, Filz, Vliesstoff usw., Tauwerk",210810000,120438000,331248000
2017,6,WA57,"Teppiche, Fußbodenbelag aus Spinnstoff",45704000,81541000,127245000
2017,6,WA58,"Spezialgewebe, Spitzen, Tapisserien",44562000,22258000,66820000
2017,6,WA59,"Getränkte, bestrichene usw. Gewebe",218115000,101597000,319712000
2017,6,WA60,Gewirke und Gestricke,77841000,42461000,120302000
2017,6,WA61,"Bekleidung usw. aus Gewirken, Gestricken",665983000,1331955000,1997938000
2017,6,WA62,"Andere Bekleidung, Bekleidungszubehör",648446000,1241915000,1890361000
2017,6,WA63,"Andere Konfektion, Spinnstoffwaren usw.",212760000,343003000,555763000
2017,6,WA64,"Schuhe, Gamaschen, ähnliche Waren",496406000,877914000,1374320000
2017,6,WA65,Kopfbedeckungen und Teile davon,32877000,44770000,77647000
2017,6,WA66,"Schirme, Gehstöcke usw., Peitschen",9933000,16041000,25974000
2017,6,WA67,"Zugerichtete Federn, Daunen, künstliche Blumen",8773000,15139000,23912000
2017,6,WA68,"Waren aus Steinen, Gips, Zement usw.",403578000,275880000,679458000
2017,6,WA69,Keramische Waren,291791000,258378000,550169000
2017,6,WA70,Glas und Glaswaren,539986000,432814000,972800000
2017,6,WA71,"Perlen, Edelsteine, Edelmetalle",877767000,1214472000,2092239000
2017,6,WA72,Eisen und Stahl,2050629000,2183619000,4234248000
2017,6,WA73,Waren aus Eisen oder Stahl,2341637000,1747002000,4088639000
2017,6,WA74,Kupfer und Waren daraus,903873000,776303000,1680176000
2017,6,WA75,Nickel und Waren daraus,100864000,103545000,204409000
2017,6,WA76,Aluminium und Waren daraus,1268227000,1394254000,2662481000
2017,6,WA78,Blei und Waren daraus,40054000,44686000,84740000
2017,6,WA79,Zink und Waren daraus,62130000,130116000,192246000
2017,6,WA80,Zinn und Waren daraus,9850000,32427000,42277000
2017,6,WA81,"Andere unedle Metalle, Cermets usw.",128839000,163231000,292070000
2017,6,WA82,"Werkzeuge, Schneidwaren, Essbestecke",718377000,433995000,1152372000
2017,6,WA83,Verschiedene Waren aus unedlen Metallen,662441000,399649000,1062090000
2017,6,WA84,"Maschinen, Apparate, mechanische Geräte",19114550000,11108496000,30223046000
2017,6,WA85,Elektrotechnische Erzeugnisse,11337933000,10412788000,21750721000
2017,6,WA86,Schienenfahrzeuge,370911000,228648000,599559000
2017,6,WA87,"Kraftfahrzeuge, Landfahrzeuge",18928161000,9571230000,28499391000
2017,6,WA88,"Luftfahrzeuge, Raumfahrzeuge",3043799000,1319535000,4363334000
2017,6,WA89,Wasserfahrzeuge,302766000,153766000,456532000
2017,6,WA90,"Optische, photografische usw. Erzeugnisse",5611792000,3045913000,8657705000
2017,6,WA91,Uhrmacherwaren,136748000,156964000,293712000
2017,6,WA92,Musikinstrumente,48027000,46389000,94416000
2017,6,WA93,Waffen und Munition,45653000,22981000,68634000
2017,6,WA94,"Möbel, Beleuchtungskörper usw.",1307687000,1467789000,2775476000
2017,6,WA95,"Spielzeug, Spiele usw., Sportgeräte",351978000,536876000,888854000
2017,6,WA96,Verschiedene Waren,339284000,243553000,582837000
2017,6,WA97,"Kunstgegenstände, Sammlungsstücke",55712000,37577000,93289000
2017,6,WA98,Vollständige Fabrikationsanlagen,141170000,1918000,143088000
2017,6,WA99,Zusammenstellungen verschiedener Waren,1494103000,980022000,2474125000
2017,7,WA01,Lebende Tiere,121146000,166589000,287735000
2017,7,WA02,Fleisch,654723000,540226000,1194949000
2017,7,WA03,"Fische, Krebs- und Weichtiere",130008000,322910000,452918000
2017,7,WA04,"Milch, Milcherzeugnisse, Eier, Honig",773020000,633008000,1406028000
2017,7,WA05,Andere Waren tierischen Ursprungs,72741000,84041000,156782000
2017,7,WA06,"Pflanzen, Waren des Blumenhandels",49975000,167166000,217141000
2017,7,WA07,"Gemüse, Pflanzen für Ernährung",83475000,446204000,529679000
2017,7,WA08,Genießbare Früchte und Nüsse,157661000,918555000,1076216000
2017,7,WA09,"Kaffee, Tee, Mate, Gewürze",224412000,324168000,548580000
2017,7,WA10,Getreide,140194000,162871000,303065000
2017,7,WA11,"Müllereierzeugnisse, Malz usw.",116536000,48414000,164950000
2017,7,WA12,"Ölsamen usw., Heilpflanzen usw.",107917000,360773000,468690000
2017,7,WA13,"Schellack, Gummen, Harz, Pflanzensaft",48779000,43453000,92232000
2017,7,WA14,Flechtstoffe usw. pflanzlichen Ursprungs,730000,3696000,4426000
2017,7,WA15,"Tierische und pflanzliche Fette, Öle, Wachs",221873000,347433000,569306000
2017,7,WA16,"Zubereitungen von Fleisch, Fisch usw.",240939000,221480000,462419000
2017,7,WA17,Zucker und Zuckerwaren,181847000,148330000,330177000
2017,7,WA18,Kakao und Zubereitungen aus Kakao,369200000,308910000,678110000
2017,7,WA19,"Zubereitungen aus Getreide usw., Backwaren",508751000,356825000,865576000
2017,7,WA20,"Zubereitungen von Gemüse, Früchten usw.",227721000,431149000,658870000
2017,7,WA21,Verschiedene Lebensmittelzubereitungen,476845000,289497000,766342000
2017,7,WA22,"Getränke, alkoholhaltige Flüssigkeiten, Essig",532408000,641498000,1173906000
2017,7,WA23,"Rückstände der Lebensmittelindustrie, Futter",323049000,334580000,657629000
2017,7,WA24,Tabak,333624000,186848000,520472000
2017,7,WA25,"Salz, Schwefel, Steine, Erden usw.",172290000,161403000,333693000
2017,7,WA26,"Erze, Schlacken, Aschen",44567000,725656000,770223000
2017,7,WA27,Mineralische Brennstoffe usw.,1677574000,6154187000,7831761000
2017,7,WA28,Anorganische chemische Erzeugnisse,684007000,537945000,1221952000
2017,7,WA29,Organische chemische Erzeugnisse,2037681000,2313518000,4351199000
2017,7,WA30,Pharmazeutische Erzeugnisse,6360229000,3907223000,10267452000
2017,7,WA31,Düngemittel,145714000,80471000,226185000
2017,7,WA32,"Gerb- und Farbstoffe, Farben, Lacke usw.",955972000,488551000,1444523000
2017,7,WA33,"Etherische Öle, Riech-, Schönheitsmittel",753349000,628444000,1381793000
2017,7,WA34,"Seifen, Waschmittel usw.",627110000,331469000,958579000
2017,7,WA35,"Eiweißstoffe, Klebstoffe, Enzyme",280655000,190628000,471283000
2017,7,WA36,"Sprengstoffe, pyrotechnische Artikel usw.",17518000,24443000,41961000
2017,7,WA37,Photochemische Erzeugnisse,104195000,87646000,191841000
2017,7,WA38,Verschiedene Erzeugnisse der Chemischen Industrie,1707668000,1095938000,2803606000
2017,7,WA39,Kunststoffe und Waren daraus,5020837000,3367845000,8388682000
2017,7,WA40,Kautschuk und Waren daraus,1259687000,1196063000,2455750000
2017,7,WA41,"Häute, Felle, Leder",87269000,68822000,156091000
2017,7,WA42,"Lederwaren, Sattlerwaren",197337000,375273000,572610000
2017,7,WA43,"Pelzfelle, künstliches Pelzwerk",10255000,16496000,26751000
2017,7,WA44,"Holz, Holzwaren, Holzkohle",679538000,647029000,1326567000
2017,7,WA45,"Kork, Korkwaren",2718000,8472000,11190000
2017,7,WA46,"Flechtwaren, Korbmacherwaren",3463000,9012000,12475000
2017,7,WA47,"Halbstoffe aus Holz usw., Papierabfall",105010000,330260000,435270000
2017,7,WA48,"Papier, Pappe und Waren daraus",1495923000,1000672000,2496595000
2017,7,WA49,"Bücher, Zeitungen, Bilddrucke usw.",333104000,211923000,545027000
2017,7,WA50,Seide,3386000,3098000,6484000
2017,7,WA51,"Wolle, feine und grobe Tierhaare",36353000,50168000,86521000
2017,7,WA52,Baumwolle,63816000,69230000,133046000
2017,7,WA53,"Andere pflanzliche Spinnstoffe, Papiergarn",2304000,4678000,6982000
2017,7,WA54,Synthetisches oder künstliches Filament,151307000,126740000,278047000
2017,7,WA55,Synthetische oder künstliche Spinnfaser,146309000,117328000,263637000
2017,7,WA56,"Watte, Filz, Vliesstoff usw., Tauwerk",201532000,122529000,324061000
2017,7,WA57,"Teppiche, Fußbodenbelag aus Spinnstoff",40577000,83633000,124210000
2017,7,WA58,"Spezialgewebe, Spitzen, Tapisserien",43275000,21846000,65121000
2017,7,WA59,"Getränkte, bestrichene usw. Gewebe",203789000,97777000,301566000
2017,7,WA60,Gewirke und Gestricke,65818000,37965000,103783000
2017,7,WA61,"Bekleidung usw. aus Gewirken, Gestricken",718134000,1483839000,2201973000
2017,7,WA62,"Andere Bekleidung, Bekleidungszubehör",733868000,1414694000,2148562000
2017,7,WA63,"Andere Konfektion, Spinnstoffwaren usw.",210441000,325567000,536008000
2017,7,WA64,"Schuhe, Gamaschen, ähnliche Waren",583564000,1002718000,1586282000
2017,7,WA65,Kopfbedeckungen und Teile davon,34782000,50123000,84905000
2017,7,WA66,"Schirme, Gehstöcke usw., Peitschen",8036000,17673000,25709000
2017,7,WA67,"Zugerichtete Federn, Daunen, künstliche Blumen",8278000,19156000,27434000
2017,7,WA68,"Waren aus Steinen, Gips, Zement usw.",402811000,278242000,681053000
2017,7,WA69,Keramische Waren,267101000,216461000,483562000
2017,7,WA70,Glas und Glaswaren,527964000,424656000,952620000
2017,7,WA71,"Perlen, Edelsteine, Edelmetalle",807214000,1541148000,2348362000
2017,7,WA72,Eisen und Stahl,1738364000,2192745000,3931109000
2017,7,WA73,Waren aus Eisen oder Stahl,2224781000,1756645000,3981426000
2017,7,WA74,Kupfer und Waren daraus,811042000,849278000,1660320000
2017,7,WA75,Nickel und Waren daraus,95879000,95074000,190953000
2017,7,WA76,Aluminium und Waren daraus,1189078000,1306880000,2495958000
2017,7,WA78,Blei und Waren daraus,26096000,40039000,66135000
2017,7,WA79,Zink und Waren daraus,70154000,139731000,209885000
2017,7,WA80,Zinn und Waren daraus,8715000,40353000,49068000
2017,7,WA81,"Andere unedle Metalle, Cermets usw.",126775000,167416000,294191000
2017,7,WA82,"Werkzeuge, Schneidwaren, Essbestecke",695302000,427494000,1122796000
2017,7,WA83,Verschiedene Waren aus unedlen Metallen,616255000,379407000,995662000
2017,7,WA84,"Maschinen, Apparate, mechanische Geräte",18169132000,10824993000,28994125000
2017,7,WA85,Elektrotechnische Erzeugnisse,10564732000,10361188000,20925920000
2017,7,WA86,Schienenfahrzeuge,424625000,250753000,675378000
2017,7,WA87,"Kraftfahrzeuge, Landfahrzeuge",18271898000,8334784000,26606682000
2017,7,WA88,"Luftfahrzeuge, Raumfahrzeuge",2508092000,1547508000,4055600000
2017,7,WA89,Wasserfahrzeuge,426543000,154336000,580879000
2017,7,WA90,"Optische, photografische usw. Erzeugnisse",5210371000,2893599000,8103970000
2017,7,WA91,Uhrmacherwaren,132768000,175133000,307901000
2017,7,WA92,Musikinstrumente,48807000,46582000,95389000
2017,7,WA93,Waffen und Munition,36285000,21261000,57546000
2017,7,WA94,"Möbel, Beleuchtungskörper usw.",1218487000,1356281000,2574768000
2017,7,WA95,"Spielzeug, Spiele usw., Sportgeräte",348914000,467746000,816660000
2017,7,WA96,Verschiedene Waren,324813000,232287000,557100000
2017,7,WA97,"Kunstgegenstände, Sammlungsstücke",50906000,37670000,88576000
2017,7,WA98,Vollständige Fabrikationsanlagen,162282000,24543000,186825000
2017,7,WA99,Zusammenstellungen verschiedener Waren,1499383000,1015924000,2515307000
2017,8,WA01,Lebende Tiere,128471000,164656000,293127000
2017,8,WA02,Fleisch,687085000,540547000,1227632000
2017,8,WA03,"Fische, Krebs- und Weichtiere",132550000,328434000,460984000
2017,8,WA04,"Milch, Milcherzeugnisse, Eier, Honig",800617000,696716000,1497333000
2017,8,WA05,Andere Waren tierischen Ursprungs,74708000,92211000,166919000
2017,8,WA06,"Pflanzen, Waren des Blumenhandels",58253000,184115000,242368000
2017,8,WA07,"Gemüse, Pflanzen für Ernährung",79352000,355701000,435053000
2017,8,WA08,Genießbare Früchte und Nüsse,156770000,828485000,985255000
2017,8,WA09,"Kaffee, Tee, Mate, Gewürze",250619000,303036000,553655000
2017,8,WA10,Getreide,154472000,182254000,336726000
2017,8,WA11,"Müllereierzeugnisse, Malz usw.",114225000,47649000,161874000
2017,8,WA12,"Ölsamen usw., Heilpflanzen usw.",109977000,440239000,550216000
2017,8,WA13,"Schellack, Gummen, Harz, Pflanzensaft",48706000,42708000,91414000
2017,8,WA14,Flechtstoffe usw. pflanzlichen Ursprungs,638000,3535000,4173000
2017,8,WA15,"Tierische und pflanzliche Fette, Öle, Wachs",242372000,313885000,556257000
2017,8,WA16,"Zubereitungen von Fleisch, Fisch usw.",238738000,205339000,444077000
2017,8,WA17,Zucker und Zuckerwaren,172098000,143649000,315747000
2017,8,WA18,Kakao und Zubereitungen aus Kakao,449785000,416520000,866305000
2017,8,WA19,"Zubereitungen aus Getreide usw., Backwaren",553795000,315572000,869367000
2017,8,WA20,"Zubereitungen von Gemüse, Früchten usw.",213546000,393082000,606628000
2017,8,WA21,Verschiedene Lebensmittelzubereitungen,433838000,237834000,671672000
2017,8,WA22,"Getränke, alkoholhaltige Flüssigkeiten, Essig",519376000,600451000,1119827000
2017,8,WA23,"Rückstände der Lebensmittelindustrie, Futter",314739000,272709000,587448000
2017,8,WA24,Tabak,335312000,205340000,540652000
2017,8,WA25,"Salz, Schwefel, Steine, Erden usw.",152039000,147203000,299242000
2017,8,WA26,"Erze, Schlacken, Aschen",30498000,574702000,605200000
2017,8,WA27,Mineralische Brennstoffe usw.,1768744000,6219403000,7988147000
2017,8,WA28,Anorganische chemische Erzeugnisse,723830000,488749000,1212579000
2017,8,WA29,Organische chemische Erzeugnisse,2037270000,2426204000,4463474000
2017,8,WA30,Pharmazeutische Erzeugnisse,6413815000,3838889000,10252704000
2017,8,WA31,Düngemittel,144454000,74963000,219417000
2017,8,WA32,"Gerb- und Farbstoffe, Farben, Lacke usw.",943305000,532293000,1475598000
2017,8,WA33,"Etherische Öle, Riech-, Schönheitsmittel",821876000,634420000,1456296000
2017,8,WA34,"Seifen, Waschmittel usw.",612783000,335004000,947787000
2017,8,WA35,"Eiweißstoffe, Klebstoffe, Enzyme",289221000,176735000,465956000
2017,8,WA36,"Sprengstoffe, pyrotechnische Artikel usw.",18884000,27146000,46030000
2017,8,WA37,Photochemische Erzeugnisse,86088000,61779000,147867000
2017,8,WA38,Verschiedene Erzeugnisse der Chemischen Industrie,1709382000,1050424000,2759806000
2017,8,WA39,Kunststoffe und Waren daraus,4948841000,3363032000,8311873000
2017,8,WA40,Kautschuk und Waren daraus,1218413000,1264124000,2482537000
2017,8,WA41,"Häute, Felle, Leder",63439000,56003000,119442000
2017,8,WA42,"Lederwaren, Sattlerwaren",199355000,347258000,546613000
2017,8,WA43,"Pelzfelle, künstliches Pelzwerk",14116000,16318000,30434000
2017,8,WA44,"Holz, Holzwaren, Holzkohle",607357000,631117000,1238474000
2017,8,WA45,"Kork, Korkwaren",2488000,5493000,7981000
2017,8,WA46,"Flechtwaren, Korbmacherwaren",2968000,9052000,12020000
2017,8,WA47,"Halbstoffe aus Holz usw., Papierabfall",104775000,348791000,453566000
2017,8,WA48,"Papier, Pappe und Waren daraus",1411881000,1043493000,2455374000
2017,8,WA49,"Bücher, Zeitungen, Bilddrucke usw.",352239000,211652000,563891000
2017,8,WA50,Seide,2602000,3564000,6166000
2017,8,WA51,"Wolle, feine und grobe Tierhaare",32689000,43066000,75755000
2017,8,WA52,Baumwolle,53676000,66975000,120651000
2017,8,WA53,"Andere pflanzliche Spinnstoffe, Papiergarn",2081000,5109000,7190000
2017,8,WA54,Synthetisches oder künstliches Filament,144485000,118940000,263425000
2017,8,WA55,Synthetische oder künstliche Spinnfaser,126034000,111742000,237776000
2017,8,WA56,"Watte, Filz, Vliesstoff usw., Tauwerk",201161000,121514000,322675000
2017,8,WA57,"Teppiche, Fußbodenbelag aus Spinnstoff",41460000,81628000,123088000
2017,8,WA58,"Spezialgewebe, Spitzen, Tapisserien",41926000,20647000,62573000
2017,8,WA59,"Getränkte, bestrichene usw. Gewebe",198475000,89538000,288013000
2017,8,WA60,Gewirke und Gestricke,57420000,31925000,89345000
2017,8,WA61,"Bekleidung usw. aus Gewirken, Gestricken",816304000,1683610000,2499914000
2017,8,WA62,"Andere Bekleidung, Bekleidungszubehör",899208000,1631085000,2530293000
2017,8,WA63,"Andere Konfektion, Spinnstoffwaren usw.",204784000,324325000,529109000
2017,8,WA64,"Schuhe, Gamaschen, ähnliche Waren",693652000,1094311000,1787963000
2017,8,WA65,Kopfbedeckungen und Teile davon,40961000,58584000,99545000
2017,8,WA66,"Schirme, Gehstöcke usw., Peitschen",6814000,12913000,19727000
2017,8,WA67,"Zugerichtete Federn, Daunen, künstliche Blumen",11512000,20426000,31938000
2017,8,WA68,"Waren aus Steinen, Gips, Zement usw.",376648000,275770000,652418000
2017,8,WA69,Keramische Waren,263076000,238592000,501668000
2017,8,WA70,Glas und Glaswaren,511186000,428401000,939587000
2017,8,WA71,"Perlen, Edelsteine, Edelmetalle",864191000,1311918000,2176109000
2017,8,WA72,Eisen und Stahl,1836939000,2000946000,3837885000
2017,8,WA73,Waren aus Eisen oder Stahl,2145902000,1636961000,3782863000
2017,8,WA74,Kupfer und Waren daraus,846813000,797734000,1644547000
2017,8,WA75,Nickel und Waren daraus,89046000,113099000,202145000
2017,8,WA76,Aluminium und Waren daraus,1170005000,1321092000,2491097000
2017,8,WA78,Blei und Waren daraus,31740000,34981000,66721000
2017,8,WA79,Zink und Waren daraus,54582000,138037000,192619000
2017,8,WA80,Zinn und Waren daraus,9088000,30376000,39464000
2017,8,WA81,"Andere unedle Metalle, Cermets usw.",120206000,156866000,277072000
2017,8,WA82,"Werkzeuge, Schneidwaren, Essbestecke",684822000,417144000,1101966000
2017,8,WA83,Verschiedene Waren aus unedlen Metallen,613713000,392112000,1005825000
2017,8,WA84,"Maschinen, Apparate, mechanische Geräte",17800353000,10344167000,28144520000
2017,8,WA85,Elektrotechnische Erzeugnisse,10799070000,10437009000,21236079000
2017,8,WA86,Schienenfahrzeuge,362868000,183466000,546334000
2017,8,WA87,"Kraftfahrzeuge, Landfahrzeuge",17482941000,7570347000,25053288000
2017,8,WA88,"Luftfahrzeuge, Raumfahrzeuge",3013247000,1353481000,4366728000
2017,8,WA89,Wasserfahrzeuge,282931000,581768000,864699000
2017,8,WA90,"Optische, photografische usw. Erzeugnisse",5380608000,2836875000,8217483000
2017,8,WA91,Uhrmacherwaren,131167000,155306000,286473000
2017,8,WA92,Musikinstrumente,38990000,48401000,87391000
2017,8,WA93,Waffen und Munition,35837000,18973000,54810000
2017,8,WA94,"Möbel, Beleuchtungskörper usw.",1211212000,1428721000,2639933000
2017,8,WA95,"Spielzeug, Spiele usw., Sportgeräte",372604000,518942000,891546000
2017,8,WA96,Verschiedene Waren,326930000,224895000,551825000
2017,8,WA97,"Kunstgegenstände, Sammlungsstücke",46027000,28652000,74679000
2017,8,WA98,Vollständige Fabrikationsanlagen,114144000,0,114144000
2017,8,WA99,Zusammenstellungen verschiedener Waren,1413118000,950135000,2363253000
2017,9,WA01,Lebende Tiere,130686000,162416000,293102000
2017,9,WA02,Fleisch,715327000,587542000,1302869000
2017,9,WA03,"Fische, Krebs- und Weichtiere",146128000,342212000,488340000
2017,9,WA04,"Milch, Milcherzeugnisse, Eier, Honig",765214000,721654000,1486868000
2017,9,WA05,Andere Waren tierischen Ursprungs,69656000,79885000,149541000
2017,9,WA06,"Pflanzen, Waren des Blumenhandels",87119000,205132000,292251000
2017,9,WA07,"Gemüse, Pflanzen für Ernährung",105851000,401052000,506903000
2017,9,WA08,Genießbare Früchte und Nüsse,148472000,848151000,996623000
2017,9,WA09,"Kaffee, Tee, Mate, Gewürze",247787000,333451000,581238000
2017,9,WA10,Getreide,147070000,204192000,351262000
2017,9,WA11,"Müllereierzeugnisse, Malz usw.",128943000,46234000,175177000
2017,9,WA12,"Ölsamen usw., Heilpflanzen usw.",79197000,612277000,691474000
2017,9,WA13,"Schellack, Gummen, Harz, Pflanzensaft",44780000,36540000,81320000
2017,9,WA14,Flechtstoffe usw. pflanzlichen Ursprungs,543000,3113000,3656000
2017,9,WA15,"Tierische und pflanzliche Fette, Öle, Wachs",254252000,328450000,582702000
2017,9,WA16,"Zubereitungen von Fleisch, Fisch usw.",244801000,258885000,503686000
2017,9,WA17,Zucker und Zuckerwaren,186328000,142629000,328957000
2017,9,WA18,Kakao und Zubereitungen aus Kakao,526170000,396789000,922959000
2017,9,WA19,"Zubereitungen aus Getreide usw., Backwaren",551869000,407565000,959434000
2017,9,WA20,"Zubereitungen von Gemüse, Früchten usw.",242423000,425569000,667992000
2017,9,WA21,Verschiedene Lebensmittelzubereitungen,498867000,294825000,793692000
2017,9,WA22,"Getränke, alkoholhaltige Flüssigkeiten, Essig",490858000,602724000,1093582000
2017,9,WA23,"Rückstände der Lebensmittelindustrie, Futter",346587000,353044000,699631000
2017,9,WA24,Tabak,309836000,186643000,496479000
2017,9,WA25,"Salz, Schwefel, Steine, Erden usw.",176920000,162821000,339741000
2017,9,WA26,"Erze, Schlacken, Aschen",50042000,666351000,716393000
2017,9,WA27,Mineralische Brennstoffe usw.,1812895000,6458670000,8271565000
2017,9,WA28,Anorganische chemische Erzeugnisse,701234000,505674000,1206908000
2017,9,WA29,Organische chemische Erzeugnisse,1967845000,2107267000,4075112000
2017,9,WA30,Pharmazeutische Erzeugnisse,6038450000,3953888000,9992338000
2017,9,WA31,Düngemittel,162993000,81615000,244608000
2017,9,WA32,"Gerb- und Farbstoffe, Farben, Lacke usw.",969518000,526538000,1496056000
2017,9,WA33,"Etherische Öle, Riech-, Schönheitsmittel",804287000,634593000,1438880000
2017,9,WA34,"Seifen, Waschmittel usw.",657273000,368029000,1025302000
2017,9,WA35,"Eiweißstoffe, Klebstoffe, Enzyme",299201000,178886000,478087000
2017,9,WA36,"Sprengstoffe, pyrotechnische Artikel usw.",24431000,29869000,54300000
2017,9,WA37,Photochemische Erzeugnisse,94221000,73106000,167327000
2017,9,WA38,Verschiedene Erzeugnisse der Chemischen Industrie,1713579000,1009629000,2723208000
2017,9,WA39,Kunststoffe und Waren daraus,5140451000,3337392000,8477843000
2017,9,WA40,Kautschuk und Waren daraus,1280727000,1231435000,2512162000
2017,9,WA41,"Häute, Felle, Leder",86455000,57174000,143629000
2017,9,WA42,"Lederwaren, Sattlerwaren",189824000,326003000,515827000
2017,9,WA43,"Pelzfelle, künstliches Pelzwerk",12269000,11556000,23825000
2017,9,WA44,"Holz, Holzwaren, Holzkohle",681754000,650494000,1332248000
2017,9,WA45,"Kork, Korkwaren",2222000,8428000,10650000
2017,9,WA46,"Flechtwaren, Korbmacherwaren",3921000,8333000,12254000
2017,9,WA47,"Halbstoffe aus Holz usw., Papierabfall",100073000,330186000,430259000
2017,9,WA48,"Papier, Pappe und Waren daraus",1610230000,1059835000,2670065000
2017,9,WA49,"Bücher, Zeitungen, Bilddrucke usw.",363863000,212689000,576552000
2017,9,WA50,Seide,3778000,4136000,7914000
2017,9,WA51,"Wolle, feine und grobe Tierhaare",43374000,52491000,95865000
2017,9,WA52,Baumwolle,71517000,71802000,143319000
2017,9,WA53,"Andere pflanzliche Spinnstoffe, Papiergarn",2676000,5094000,7770000
2017,9,WA54,Synthetisches oder künstliches Filament,165756000,129409000,295165000
2017,9,WA55,Synthetische oder künstliche Spinnfaser,148874000,113597000,262471000
2017,9,WA56,"Watte, Filz, Vliesstoff usw., Tauwerk",212416000,117040000,329456000
2017,9,WA57,"Teppiche, Fußbodenbelag aus Spinnstoff",51062000,90289000,141351000
2017,9,WA58,"Spezialgewebe, Spitzen, Tapisserien",43451000,20693000,64144000
2017,9,WA59,"Getränkte, bestrichene usw. Gewebe",206877000,95888000,302765000
2017,9,WA60,Gewirke und Gestricke,64505000,33469000,97974000
2017,9,WA61,"Bekleidung usw. aus Gewirken, Gestricken",847243000,1550444000,2397687000
2017,9,WA62,"Andere Bekleidung, Bekleidungszubehör",930112000,1528476000,2458588000
2017,9,WA63,"Andere Konfektion, Spinnstoffwaren usw.",212518000,330411000,542929000
2017,9,WA64,"Schuhe, Gamaschen, ähnliche Waren",643152000,965135000,1608287000
2017,9,WA65,Kopfbedeckungen und Teile davon,44684000,61450000,106134000
2017,9,WA66,"Schirme, Gehstöcke usw., Peitschen",8810000,12201000,21011000
2017,9,WA67,"Zugerichtete Federn, Daunen, künstliche Blumen",13658000,17282000,30940000
2017,9,WA68,"Waren aus Steinen, Gips, Zement usw.",398703000,271632000,670335000
2017,9,WA69,Keramische Waren,268845000,244547000,513392000
2017,9,WA70,Glas und Glaswaren,549549000,451941000,1001490000
2017,9,WA71,"Perlen, Edelsteine, Edelmetalle",927128000,1320259000,2247387000
2017,9,WA72,Eisen und Stahl,1980127000,2130257000,4110384000
2017,9,WA73,Waren aus Eisen oder Stahl,2335494000,1703385000,4038879000
2017,9,WA74,Kupfer und Waren daraus,946155000,786892000,1733047000
2017,9,WA75,Nickel und Waren daraus,95893000,109767000,205660000
2017,9,WA76,Aluminium und Waren daraus,1242335000,1353278000,2595613000
2017,9,WA78,Blei und Waren daraus,36686000,38994000,75680000
2017,9,WA79,Zink und Waren daraus,78962000,143276000,222238000
2017,9,WA80,Zinn und Waren daraus,9417000,40793000,50210000
2017,9,WA81,"Andere unedle Metalle, Cermets usw.",120420000,162602000,283022000
2017,9,WA82,"Werkzeuge, Schneidwaren, Essbestecke",691973000,417713000,1109686000
2017,9,WA83,Verschiedene Waren aus unedlen Metallen,637418000,420451000,1057869000
2017,9,WA84,"Maschinen, Apparate, mechanische Geräte",19002223000,11180502000,30182725000
2017,9,WA85,Elektrotechnische Erzeugnisse,11581560000,11000491000,22582051000
2017,9,WA86,Schienenfahrzeuge,339601000,242538000,582139000
2017,9,WA87,"Kraftfahrzeuge, Landfahrzeuge",19968066000,9125129000,29093195000
2017,9,WA88,"Luftfahrzeuge, Raumfahrzeuge",2859116000,933778000,3792894000
2017,9,WA89,Wasserfahrzeuge,1564406000,147894000,1712300000
2017,9,WA90,"Optische, photografische usw. Erzeugnisse",5608847000,3005986000,8614833000
2017,9,WA91,Uhrmacherwaren,158948000,166621000,325569000
2017,9,WA92,Musikinstrumente,61312000,51412000,112724000
2017,9,WA93,Waffen und Munition,41680000,20511000,62191000
2017,9,WA94,"Möbel, Beleuchtungskörper usw.",1345046000,1576856000,2921902000
2017,9,WA95,"Spielzeug, Spiele usw., Sportgeräte",487483000,724056000,1211539000
2017,9,WA96,Verschiedene Waren,323606000,227795000,551401000
2017,9,WA97,"Kunstgegenstände, Sammlungsstücke",76020000,35970000,111990000
2017,9,WA98,Vollständige Fabrikationsanlagen,123322000,9576000,132898000
2017,9,WA99,Zusammenstellungen verschiedener Waren,1357114000,888796000,2245910000
2017,10,WA01,Lebende Tiere,134618000,140297000,274915000
2017,10,WA02,Fleisch,671709000,607654000,1279363000
2017,10,WA03,"Fische, Krebs- und Weichtiere",140488000,369733000,510221000
2017,10,WA04,"Milch, Milcherzeugnisse, Eier, Honig",742170000,727708000,1469878000
2017,10,WA05,Andere Waren tierischen Ursprungs,76602000,85980000,162582000
2017,10,WA06,"Pflanzen, Waren des Blumenhandels",75545000,183151000,258696000
2017,10,WA07,"Gemüse, Pflanzen für Ernährung",88828000,418160000,506988000
2017,10,WA08,Genießbare Früchte und Nüsse,164666000,901259000,1065925000
2017,10,WA09,"Kaffee, Tee, Mate, Gewürze",252004000,348408000,600412000
2017,10,WA10,Getreide,112109000,189636000,301745000
2017,10,WA11,"Müllereierzeugnisse, Malz usw.",136598000,52019000,188617000
2017,10,WA12,"Ölsamen usw., Heilpflanzen usw.",78138000,546619000,624757000
2017,10,WA13,"Schellack, Gummen, Harz, Pflanzensaft",46245000,40593000,86838000
2017,10,WA14,Flechtstoffe usw. pflanzlichen Ursprungs,617000,3413000,4030000
2017,10,WA15,"Tierische und pflanzliche Fette, Öle, Wachs",218548000,302299000,520847000
2017,10,WA16,"Zubereitungen von Fleisch, Fisch usw.",265602000,250431000,516033000
2017,10,WA17,Zucker und Zuckerwaren,237636000,131354000,368990000
2017,10,WA18,Kakao und Zubereitungen aus Kakao,570497000,383031000,953528000
2017,10,WA19,"Zubereitungen aus Getreide usw., Backwaren",589601000,354503000,944104000
2017,10,WA20,"Zubereitungen von Gemüse, Früchten usw.",240689000,424765000,665454000
2017,10,WA21,Verschiedene Lebensmittelzubereitungen,442920000,241674000,684594000
2017,10,WA22,"Getränke, alkoholhaltige Flüssigkeiten, Essig",485527000,633089000,1118616000
2017,10,WA23,"Rückstände der Lebensmittelindustrie, Futter",340088000,316423000,656511000
2017,10,WA24,Tabak,302923000,198051000,500974000
2017,10,WA25,"Salz, Schwefel, Steine, Erden usw.",184456000,161118000,345574000
2017,10,WA26,"Erze, Schlacken, Aschen",39351000,608753000,648104000
2017,10,WA27,Mineralische Brennstoffe usw.,2046809000,6831089000,8877898000
2017,10,WA28,Anorganische chemische Erzeugnisse,740854000,505730000,1246584000
2017,10,WA29,Organische chemische Erzeugnisse,1892564000,2253345000,4145909000
2017,10,WA30,Pharmazeutische Erzeugnisse,5779155000,3924468000,9703623000
2017,10,WA31,Düngemittel,166346000,90796000,257142000
2017,10,WA32,"Gerb- und Farbstoffe, Farben, Lacke usw.",957419000,535981000,1493400000
2017,10,WA33,"Etherische Öle, Riech-, Schönheitsmittel",793582000,613775000,1407357000
2017,10,WA34,"Seifen, Waschmittel usw.",626590000,368256000,994846000
2017,10,WA35,"Eiweißstoffe, Klebstoffe, Enzyme",293776000,176016000,469792000
2017,10,WA36,"Sprengstoffe, pyrotechnische Artikel usw.",25808000,19088000,44896000
2017,10,WA37,Photochemische Erzeugnisse,104474000,72684000,177158000
2017,10,WA38,Verschiedene Erzeugnisse der Chemischen Industrie,1769945000,1090987000,2860932000
2017,10,WA39,Kunststoffe und Waren daraus,5050707000,3347046000,8397753000
2017,10,WA40,Kautschuk und Waren daraus,1329908000,1274614000,2604522000
2017,10,WA41,"Häute, Felle, Leder",80422000,67491000,147913000
2017,10,WA42,"Lederwaren, Sattlerwaren",181114000,330861000,511975000
2017,10,WA43,"Pelzfelle, künstliches Pelzwerk",11298000,12885000,24183000
2017,10,WA44,"Holz, Holzwaren, Holzkohle",724009000,675874000,1399883000
2017,10,WA45,"Kork, Korkwaren",2535000,6979000,9514000
2017,10,WA46,"Flechtwaren, Korbmacherwaren",3614000,8546000,12160000
2017,10,WA47,"Halbstoffe aus Holz usw., Papierabfall",95616000,335263000,430879000
2017,10,WA48,"Papier, Pappe und Waren daraus",1562063000,1047686000,2609749000
2017,10,WA49,"Bücher, Zeitungen, Bilddrucke usw.",366725000,221201000,587926000
2017,10,WA50,Seide,4222000,3926000,8148000
2017,10,WA51,"Wolle, feine und grobe Tierhaare",41717000,56607000,98324000
2017,10,WA52,Baumwolle,76643000,81027000,157670000
2017,10,WA53,"Andere pflanzliche Spinnstoffe, Papiergarn",3910000,6034000,9944000
2017,10,WA54,Synthetisches oder künstliches Filament,160562000,128970000,289532000
2017,10,WA55,Synthetische oder künstliche Spinnfaser,146113000,129144000,275257000
2017,10,WA56,"Watte, Filz, Vliesstoff usw., Tauwerk",207504000,119183000,326687000
2017,10,WA57,"Teppiche, Fußbodenbelag aus Spinnstoff",50480000,98235000,148715000
2017,10,WA58,"Spezialgewebe, Spitzen, Tapisserien",47916000,23531000,71447000
2017,10,WA59,"Getränkte, bestrichene usw. Gewebe",211177000,91590000,302767000
2017,10,WA60,Gewirke und Gestricke,61285000,40440000,101725000
2017,10,WA61,"Bekleidung usw. aus Gewirken, Gestricken",819638000,1443414000,2263052000
2017,10,WA62,"Andere Bekleidung, Bekleidungszubehör",885356000,1271512000,2156868000
2017,10,WA63,"Andere Konfektion, Spinnstoffwaren usw.",217571000,321759000,539330000
2017,10,WA64,"Schuhe, Gamaschen, ähnliche Waren",475169000,805294000,1280463000
2017,10,WA65,Kopfbedeckungen und Teile davon,41505000,52101000,93606000
2017,10,WA66,"Schirme, Gehstöcke usw., Peitschen",7025000,10718000,17743000
2017,10,WA67,"Zugerichtete Federn, Daunen, künstliche Blumen",10773000,16470000,27243000
2017,10,WA68,"Waren aus Steinen, Gips, Zement usw.",402431000,273252000,675683000
2017,10,WA69,Keramische Waren,294003000,228399000,522402000
2017,10,WA70,Glas und Glaswaren,552516000,445346000,997862000
2017,10,WA71,"Perlen, Edelsteine, Edelmetalle",1131056000,1388288000,2519344000
2017,10,WA72,Eisen und Stahl,2068222000,2208085000,4276307000
2017,10,WA73,Waren aus Eisen oder Stahl,2295221000,1785810000,4081031000
2017,10,WA74,Kupfer und Waren daraus,944888000,833111000,1777999000
2017,10,WA75,Nickel und Waren daraus,84434000,117820000,202254000
2017,10,WA76,Aluminium und Waren daraus,1268597000,1387489000,2656086000
2017,10,WA78,Blei und Waren daraus,38303000,40022000,78325000
2017,10,WA79,Zink und Waren daraus,68178000,142339000,210517000
2017,10,WA80,Zinn und Waren daraus,10540000,42785000,53325000
2017,10,WA81,"Andere unedle Metalle, Cermets usw.",122774000,158132000,280906000
2017,10,WA82,"Werkzeuge, Schneidwaren, Essbestecke",702820000,416981000,1119801000
2017,10,WA83,Verschiedene Waren aus unedlen Metallen,628192000,406871000,1035063000
2017,10,WA84,"Maschinen, Apparate, mechanische Geräte",18315724000,11475797000,29791521000
2017,10,WA85,Elektrotechnische Erzeugnisse,11321786000,11510768000,22832554000
2017,10,WA86,Schienenfahrzeuge,385896000,223188000,609084000
2017,10,WA87,"Kraftfahrzeuge, Landfahrzeuge",19545773000,9427141000,28972914000
2017,10,WA88,"Luftfahrzeuge, Raumfahrzeuge",2933325000,1882356000,4815681000
2017,10,WA89,Wasserfahrzeuge,405909000,392614000,798523000
2017,10,WA90,"Optische, photografische usw. Erzeugnisse",5355047000,3046278000,8401325000
2017,10,WA91,Uhrmacherwaren,157426000,175510000,332936000
2017,10,WA92,Musikinstrumente,51506000,56814000,108320000
2017,10,WA93,Waffen und Munition,37650000,19225000,56875000
2017,10,WA94,"Möbel, Beleuchtungskörper usw.",1362186000,1594627000,2956813000
2017,10,WA95,"Spielzeug, Spiele usw., Sportgeräte",612347000,827325000,1439672000
2017,10,WA96,Verschiedene Waren,327995000,232461000,560456000
2017,10,WA97,"Kunstgegenstände, Sammlungsstücke",84373000,46230000,130603000
2017,10,WA98,Vollständige Fabrikationsanlagen,115463000,2000,115465000
2017,10,WA99,Zusammenstellungen verschiedener Waren,1641159000,951221000,2592380000
2017,11,WA01,Lebende Tiere,120845000,145842000,266687000
2017,11,WA02,Fleisch,699856000,627352000,1327208000
2017,11,WA03,"Fische, Krebs- und Weichtiere",146985000,396627000,543612000
2017,11,WA04,"Milch, Milcherzeugnisse, Eier, Honig",749205000,784587000,1533792000
2017,11,WA05,Andere Waren tierischen Ursprungs,78268000,86609000,164877000
2017,11,WA06,"Pflanzen, Waren des Blumenhandels",62836000,191563000,254399000
2017,11,WA07,"Gemüse, Pflanzen für Ernährung",72345000,442062000,514407000
2017,11,WA08,Genießbare Früchte und Nüsse,170094000,888142000,1058236000
2017,11,WA09,"Kaffee, Tee, Mate, Gewürze",287684000,391163000,678847000
2017,11,WA10,Getreide,128638000,211675000,340313000
2017,11,WA11,"Müllereierzeugnisse, Malz usw.",129080000,49742000,178822000
2017,11,WA12,"Ölsamen usw., Heilpflanzen usw.",117727000,451871000,569598000
2017,11,WA13,"Schellack, Gummen, Harz, Pflanzensaft",50653000,41934000,92587000
2017,11,WA14,Flechtstoffe usw. pflanzlichen Ursprungs,627000,3307000,3934000
2017,11,WA15,"Tierische und pflanzliche Fette, Öle, Wachs",214557000,331863000,546420000
2017,11,WA16,"Zubereitungen von Fleisch, Fisch usw.",251830000,245607000,497437000
2017,11,WA17,Zucker und Zuckerwaren,248388000,136325000,384713000
2017,11,WA18,Kakao und Zubereitungen aus Kakao,524683000,417525000,942208000
2017,11,WA19,"Zubereitungen aus Getreide usw., Backwaren",570282000,406044000,976326000
2017,11,WA20,"Zubereitungen von Gemüse, Früchten usw.",234801000,458882000,693683000
2017,11,WA21,Verschiedene Lebensmittelzubereitungen,479028000,300121000,779149000
2017,11,WA22,"Getränke, alkoholhaltige Flüssigkeiten, Essig",526612000,687952000,1214564000
2017,11,WA23,"Rückstände der Lebensmittelindustrie, Futter",354777000,320117000,674894000
2017,11,WA24,Tabak,316678000,224057000,540735000
2017,11,WA25,"Salz, Schwefel, Steine, Erden usw.",173033000,158142000,331175000
2017,11,WA26,"Erze, Schlacken, Aschen",45457000,644351000,689808000
2017,11,WA27,Mineralische Brennstoffe usw.,2085655000,7401319000,9486974000
2017,11,WA28,Anorganische chemische Erzeugnisse,818248000,531388000,1349636000
2017,11,WA29,Organische chemische Erzeugnisse,2192343000,2545168000,4737511000
2017,11,WA30,Pharmazeutische Erzeugnisse,6725997000,4377137000,11103134000
2017,11,WA31,Düngemittel,188075000,102746000,290821000
2017,11,WA32,"Gerb- und Farbstoffe, Farben, Lacke usw.",931975000,519175000,1451150000
2017,11,WA33,"Etherische Öle, Riech-, Schönheitsmittel",866610000,666189000,1532799000
2017,11,WA34,"Seifen, Waschmittel usw.",669913000,373866000,1043779000
2017,11,WA35,"Eiweißstoffe, Klebstoffe, Enzyme",311975000,193252000,505227000
2017,11,WA36,"Sprengstoffe, pyrotechnische Artikel usw.",28438000,27416000,55854000
2017,11,WA37,Photochemische Erzeugnisse,104186000,74422000,178608000
2017,11,WA38,Verschiedene Erzeugnisse der Chemischen Industrie,1906796000,1135099000,3041895000
2017,11,WA39,Kunststoffe und Waren daraus,5325040000,3353606000,8678646000
2017,11,WA40,Kautschuk und Waren daraus,1363724000,1220787000,2584511000
2017,11,WA41,"Häute, Felle, Leder",94955000,78499000,173454000
2017,11,WA42,"Lederwaren, Sattlerwaren",205589000,370082000,575671000
2017,11,WA43,"Pelzfelle, künstliches Pelzwerk",9281000,12589000,21870000
2017,11,WA44,"Holz, Holzwaren, Holzkohle",710403000,650552000,1360955000
2017,11,WA45,"Kork, Korkwaren",2465000,7553000,10018000
2017,11,WA46,"Flechtwaren, Korbmacherwaren",3015000,8342000,11357000
2017,11,WA47,"Halbstoffe aus Holz usw., Papierabfall",108653000,354703000,463356000
2017,11,WA48,"Papier, Pappe und Waren daraus",1597609000,1121639000,2719248000
2017,11,WA49,"Bücher, Zeitungen, Bilddrucke usw.",423669000,230574000,654243000
2017,11,WA50,Seide,3078000,4112000,7190000
2017,11,WA51,"Wolle, feine und grobe Tierhaare",28507000,50100000,78607000
2017,11,WA52,Baumwolle,81826000,89810000,171636000
2017,11,WA53,"Andere pflanzliche Spinnstoffe, Papiergarn",4282000,7523000,11805000
2017,11,WA54,Synthetisches oder künstliches Filament,171715000,135720000,307435000
2017,11,WA55,Synthetische oder künstliche Spinnfaser,154061000,125288000,279349000
2017,11,WA56,"Watte, Filz, Vliesstoff usw., Tauwerk",218537000,117079000,335616000
2017,11,WA57,"Teppiche, Fußbodenbelag aus Spinnstoff",51147000,98585000,149732000
2017,11,WA58,"Spezialgewebe, Spitzen, Tapisserien",49222000,23757000,72979000
2017,11,WA59,"Getränkte, bestrichene usw. Gewebe",224332000,99666000,323998000
2017,11,WA60,Gewirke und Gestricke,69798000,40148000,109946000
2017,11,WA61,"Bekleidung usw. aus Gewirken, Gestricken",806203000,1562342000,2368545000
2017,11,WA62,"Andere Bekleidung, Bekleidungszubehör",807566000,1311565000,2119131000
2017,11,WA63,"Andere Konfektion, Spinnstoffwaren usw.",227310000,326561000,553871000
2017,11,WA64,"Schuhe, Gamaschen, ähnliche Waren",503743000,879461000,1383204000
2017,11,WA65,Kopfbedeckungen und Teile davon,37095000,47653000,84748000
2017,11,WA66,"Schirme, Gehstöcke usw., Peitschen",6382000,12211000,18593000
2017,11,WA67,"Zugerichtete Federn, Daunen, künstliche Blumen",9416000,16927000,26343000
2017,11,WA68,"Waren aus Steinen, Gips, Zement usw.",414802000,262406000,677208000
2017,11,WA69,Keramische Waren,299868000,254433000,554301000
2017,11,WA70,Glas und Glaswaren,579903000,467272000,1047175000
2017,11,WA71,"Perlen, Edelsteine, Edelmetalle",1086918000,1458821000,2545739000
2017,11,WA72,Eisen und Stahl,2114506000,2304450000,4418956000
2017,11,WA73,Waren aus Eisen oder Stahl,2427043000,1841982000,4269025000
2017,11,WA74,Kupfer und Waren daraus,1013868000,908774000,1922642000
2017,11,WA75,Nickel und Waren daraus,90950000,121739000,212689000
2017,11,WA76,Aluminium und Waren daraus,1243879000,1427680000,2671559000
2017,11,WA78,Blei und Waren daraus,43777000,42106000,85883000
2017,11,WA79,Zink und Waren daraus,73649000,148676000,222325000
2017,11,WA80,Zinn und Waren daraus,10180000,35521000,45701000
2017,11,WA81,"Andere unedle Metalle, Cermets usw.",134385000,176828000,311213000
2017,11,WA82,"Werkzeuge, Schneidwaren, Essbestecke",763196000,440496000,1203692000
2017,11,WA83,Verschiedene Waren aus unedlen Metallen,661005000,415349000,1076354000
2017,11,WA84,"Maschinen, Apparate, mechanische Geräte",20092153000,12087185000,32179338000
2017,11,WA85,Elektrotechnische Erzeugnisse,12405963000,12257965000,24663928000
2017,11,WA86,Schienenfahrzeuge,548064000,204207000,752271000
2017,11,WA87,"Kraftfahrzeuge, Landfahrzeuge",21247368000,9762305000,31009673000
2017,11,WA88,"Luftfahrzeuge, Raumfahrzeuge",3589271000,1000050000,4589321000
2017,11,WA89,Wasserfahrzeuge,145276000,35215000,180491000
2017,11,WA90,"Optische, photografische usw. Erzeugnisse",6086394000,3259416000,9345810000
2017,11,WA91,Uhrmacherwaren,189577000,203827000,393404000
2017,11,WA92,Musikinstrumente,65034000,65276000,130310000
2017,11,WA93,Waffen und Munition,40050000,21368000,61418000
2017,11,WA94,"Möbel, Beleuchtungskörper usw.",1469849000,1646007000,3115856000
2017,11,WA95,"Spielzeug, Spiele usw., Sportgeräte",584033000,878031000,1462064000
2017,11,WA96,Verschiedene Waren,339954000,242564000,582518000
2017,11,WA97,"Kunstgegenstände, Sammlungsstücke",75627000,37954000,113581000
2017,11,WA98,Vollständige Fabrikationsanlagen,131805000,14000,131819000
2017,11,WA99,Zusammenstellungen verschiedener Waren,1425528000,1079738000,2505266000
2017,12,WA01,Lebende Tiere,131289000,135373000,266662000
2017,12,WA02,Fleisch,664872000,617870000,1282742000
2017,12,WA03,"Fische, Krebs- und Weichtiere",150966000,352406000,503372000
2017,12,WA04,"Milch, Milcherzeugnisse, Eier, Honig",724042000,787031000,1511073000
2017,12,WA05,Andere Waren tierischen Ursprungs,70527000,88740000,159267000
2017,12,WA06,"Pflanzen, Waren des Blumenhandels",48714000,201360000,250074000
2017,12,WA07,"Gemüse, Pflanzen für Ernährung",81526000,542995000,624521000
2017,12,WA08,Genießbare Früchte und Nüsse,156067000,876893000,1032960000
2017,12,WA09,"Kaffee, Tee, Mate, Gewürze",225870000,295938000,521808000
2017,12,WA10,Getreide,131323000,203992000,335315000
2017,12,WA11,"Müllereierzeugnisse, Malz usw.",131993000,47492000,179485000
2017,12,WA12,"Ölsamen usw., Heilpflanzen usw.",98076000,320935000,419011000
2017,12,WA13,"Schellack, Gummen, Harz, Pflanzensaft",45913000,34855000,80768000
2017,12,WA14,Flechtstoffe usw. pflanzlichen Ursprungs,406000,3259000,3665000
2017,12,WA15,"Tierische und pflanzliche Fette, Öle, Wachs",206621000,293262000,499883000
2017,12,WA16,"Zubereitungen von Fleisch, Fisch usw.",234466000,252891000,487357000
2017,12,WA17,Zucker und Zuckerwaren,208087000,119919000,328006000
2017,12,WA18,Kakao und Zubereitungen aus Kakao,415561000,369174000,784735000
2017,12,WA19,"Zubereitungen aus Getreide usw., Backwaren",495235000,350619000,845854000
2017,12,WA20,"Zubereitungen von Gemüse, Früchten usw.",225253000,419761000,645014000
2017,12,WA21,Verschiedene Lebensmittelzubereitungen,406270000,249190000,655460000
2017,12,WA22,"Getränke, alkoholhaltige Flüssigkeiten, Essig",427932000,607937000,1035869000
2017,12,WA23,"Rückstände der Lebensmittelindustrie, Futter",370559000,335040000,705599000
2017,12,WA24,Tabak,253381000,154295000,407676000
2017,12,WA25,"Salz, Schwefel, Steine, Erden usw.",137508000,133425000,270933000
2017,12,WA26,"Erze, Schlacken, Aschen",38182000,557181000,595363000
2017,12,WA27,Mineralische Brennstoffe usw.,2354176000,7972261000,10326437000
2017,12,WA28,Anorganische chemische Erzeugnisse,680501000,454547000,1135048000
2017,12,WA29,Organische chemische Erzeugnisse,1972052000,2806935000,4778987000
2017,12,WA30,Pharmazeutische Erzeugnisse,6122058000,3704325000,9826383000
2017,12,WA31,Düngemittel,179288000,90448000,269736000
2017,12,WA32,"Gerb- und Farbstoffe, Farben, Lacke usw.",806719000,439229000,1245948000
2017,12,WA33,"Etherische Öle, Riech-, Schönheitsmittel",708049000,617483000,1325532000
2017,12,WA34,"Seifen, Waschmittel usw.",525603000,330452000,856055000
2017,12,WA35,"Eiweißstoffe, Klebstoffe, Enzyme",253269000,151278000,404547000
2017,12,WA36,"Sprengstoffe, pyrotechnische Artikel usw.",35547000,32388000,67935000
2017,12,WA37,Photochemische Erzeugnisse,90850000,78936000,169786000
2017,12,WA38,Verschiedene Erzeugnisse der Chemischen Industrie,1688839000,1063143000,2751982000
2017,12,WA39,Kunststoffe und Waren daraus,4095039000,2857496000,6952535000
2017,12,WA40,Kautschuk und Waren daraus,1020261000,902742000,1923003000
2017,12,WA41,"Häute, Felle, Leder",64526000,54756000,119282000
2017,12,WA42,"Lederwaren, Sattlerwaren",177423000,330343000,507766000
2017,12,WA43,"Pelzfelle, künstliches Pelzwerk",7139000,8063000,15202000
2017,12,WA44,"Holz, Holzwaren, Holzkohle",565493000,529786000,1095279000
2017,12,WA45,"Kork, Korkwaren",2058000,7251000,9309000
2017,12,WA46,"Flechtwaren, Korbmacherwaren",2599000,8893000,11492000
2017,12,WA47,"Halbstoffe aus Holz usw., Papierabfall",95873000,324551000,420424000
2017,12,WA48,"Papier, Pappe und Waren daraus",1312032000,944456000,2256488000
2017,12,WA49,"Bücher, Zeitungen, Bilddrucke usw.",376717000,252641000,629358000
2017,12,WA50,Seide,2979000,3787000,6766000
2017,12,WA51,"Wolle, feine und grobe Tierhaare",36137000,57104000,93241000
2017,12,WA52,Baumwolle,62758000,65578000,128336000
2017,12,WA53,"Andere pflanzliche Spinnstoffe, Papiergarn",3598000,5614000,9212000
2017,12,WA54,Synthetisches oder künstliches Filament,125026000,101060000,226086000
2017,12,WA55,Synthetische oder künstliche Spinnfaser,131112000,100949000,232061000
2017,12,WA56,"Watte, Filz, Vliesstoff usw., Tauwerk",161204000,96785000,257989000
2017,12,WA57,"Teppiche, Fußbodenbelag aus Spinnstoff",38088000,96274000,134362000
2017,12,WA58,"Spezialgewebe, Spitzen, Tapisserien",36423000,18459000,54882000
2017,12,WA59,"Getränkte, bestrichene usw. Gewebe",174400000,78810000,253210000
2017,12,WA60,Gewirke und Gestricke,52440000,33286000,85726000
2017,12,WA61,"Bekleidung usw. aus Gewirken, Gestricken",672785000,1290966000,1963751000
2017,12,WA62,"Andere Bekleidung, Bekleidungszubehör",634107000,1137547000,1771654000
2017,12,WA63,"Andere Konfektion, Spinnstoffwaren usw.",189060000,277545000,466605000
2017,12,WA64,"Schuhe, Gamaschen, ähnliche Waren",439014000,830287000,1269301000
2017,12,WA65,Kopfbedeckungen und Teile davon,35932000,45466000,81398000
2017,12,WA66,"Schirme, Gehstöcke usw., Peitschen",5579000,14134000,19713000
2017,12,WA67,"Zugerichtete Federn, Daunen, künstliche Blumen",7844000,19606000,27450000
2017,12,WA68,"Waren aus Steinen, Gips, Zement usw.",322388000,228035000,550423000
2017,12,WA69,Keramische Waren,253599000,197462000,451061000
2017,12,WA70,Glas und Glaswaren,430131000,362863000,792994000
2017,12,WA71,"Perlen, Edelsteine, Edelmetalle",945517000,1515484000,2461001000
2017,12,WA72,Eisen und Stahl,1685082000,1875547000,3560629000
2017,12,WA73,Waren aus Eisen oder Stahl,2069344000,1480124000,3549468000
2017,12,WA74,Kupfer und Waren daraus,690177000,610548000,1300725000
2017,12,WA75,Nickel und Waren daraus,90746000,100955000,191701000
2017,12,WA76,Aluminium und Waren daraus,1122600000,1102669000,2225269000
2017,12,WA78,Blei und Waren daraus,38758000,44515000,83273000
2017,12,WA79,Zink und Waren daraus,53070000,119143000,172213000
2017,12,WA80,Zinn und Waren daraus,8192000,27676000,35868000
2017,12,WA81,"Andere unedle Metalle, Cermets usw.",99596000,145286000,244882000
2017,12,WA82,"Werkzeuge, Schneidwaren, Essbestecke",651659000,404573000,1056232000
2017,12,WA83,Verschiedene Waren aus unedlen Metallen,492189000,328992000,821181000
2017,12,WA84,"Maschinen, Apparate, mechanische Geräte",18739302000,10746171000,29485473000
2017,12,WA85,Elektrotechnische Erzeugnisse,10436654000,10583297000,21019951000
2017,12,WA86,Schienenfahrzeuge,322395000,232943000,555338000
2017,12,WA87,"Kraftfahrzeuge, Landfahrzeuge",16427018000,8003405000,24430423000
2017,12,WA88,"Luftfahrzeuge, Raumfahrzeuge",3834984000,841279000,4676263000
2017,12,WA89,Wasserfahrzeuge,490626000,123383000,614009000
2017,12,WA90,"Optische, photografische usw. Erzeugnisse",5595285000,2957432000,8552717000
2017,12,WA91,Uhrmacherwaren,151782000,160103000,311885000
2017,12,WA92,Musikinstrumente,60167000,58568000,118735000
2017,12,WA93,Waffen und Munition,35287000,14929000,50216000
2017,12,WA94,"Möbel, Beleuchtungskörper usw.",1155109000,1388014000,2543123000
2017,12,WA95,"Spielzeug, Spiele usw., Sportgeräte",439713000,635225000,1074938000
2017,12,WA96,Verschiedene Waren,306225000,207575000,513800000
2017,12,WA97,"Kunstgegenstände, Sammlungsstücke",56258000,31466000,87724000
2017,12,WA98,Vollständige Fabrikationsanlagen,113792000,10495000,124287000
2017,12,WA99,Zusammenstellungen verschiedener Waren,1391699000,983939000,2375638000
2018,1,WA01,Lebende Tiere,104905000,143418000,248323000
2018,1,WA02,Fleisch,604895000,552872000,1157767000
2018,1,WA03,"Fische, Krebs- und Weichtiere",125756000,347456000,473212000
2018,1,WA04,"Milch, Milcherzeugnisse, Eier, Honig",765510000,633495000,1399005000
2018,1,WA05,Andere Waren tierischen Ursprungs,74150000,80259000,154409000
2018,1,WA06,"Pflanzen, Waren des Blumenhandels",49515000,198267000,247782000
2018,1,WA07,"Gemüse, Pflanzen für Ernährung",77223000,582778000,660001000
2018,1,WA08,Genießbare Früchte und Nüsse,156840000,833491000,990331000
2018,1,WA09,"Kaffee, Tee, Mate, Gewürze",231896000,365746000,597642000
2018,1,WA10,Getreide,183841000,233355000,417196000
2018,1,WA11,"Müllereierzeugnisse, Malz usw.",139842000,47224000,187066000
2018,1,WA12,"Ölsamen usw., Heilpflanzen usw.",150231000,464441000,614672000
2018,1,WA13,"Schellack, Gummen, Harz, Pflanzensaft",56966000,46496000,103462000
2018,1,WA14,Flechtstoffe usw. pflanzlichen Ursprungs,512000,4040000,4552000
2018,1,WA15,"Tierische und pflanzliche Fette, Öle, Wachs",209917000,315773000,525690000
2018,1,WA16,"Zubereitungen von Fleisch, Fisch usw.",219080000,248162000,467242000
2018,1,WA17,Zucker und Zuckerwaren,198600000,126257000,324857000
2018,1,WA18,Kakao und Zubereitungen aus Kakao,395702000,333576000,729278000
2018,1,WA19,"Zubereitungen aus Getreide usw., Backwaren",509808000,343131000,852939000
2018,1,WA20,"Zubereitungen von Gemüse, Früchten usw.",236633000,421961000,658594000
2018,1,WA21,Verschiedene Lebensmittelzubereitungen,466891000,260772000,727663000
2018,1,WA22,"Getränke, alkoholhaltige Flüssigkeiten, Essig",422745000,529438000,952183000
2018,1,WA23,"Rückstände der Lebensmittelindustrie, Futter",330874000,324586000,655460000
2018,1,WA24,Tabak,270633000,179170000,449803000
2018,1,WA25,"Salz, Schwefel, Steine, Erden usw.",158259000,139847000,298106000
2018,1,WA26,"Erze, Schlacken, Aschen",38523000,487715000,526238000
2018,1,WA27,Mineralische Brennstoffe usw.,2532549000,7968005000,10500554000
2018,1,WA28,Anorganische chemische Erzeugnisse,831203000,540706000,1371909000
2018,1,WA29,Organische chemische Erzeugnisse,2433471000,3371514000,5804985000
2018,1,WA30,Pharmazeutische Erzeugnisse,6406909000,3704186000,10111095000
2018,1,WA31,Düngemittel,187768000,90083000,277851000
2018,1,WA32,"Gerb- und Farbstoffe, Farben, Lacke usw.",1033009000,510595000,1543604000
2018,1,WA33,"Etherische Öle, Riech-, Schönheitsmittel",821374000,599138000,1420512000
2018,1,WA34,"Seifen, Waschmittel usw.",673594000,330357000,1003951000
2018,1,WA35,"Eiweißstoffe, Klebstoffe, Enzyme",298675000,182341000,481016000
2018,1,WA36,"Sprengstoffe, pyrotechnische Artikel usw.",22412000,11928000,34340000
2018,1,WA37,Photochemische Erzeugnisse,103350000,74671000,178021000
2018,1,WA38,Verschiedene Erzeugnisse der Chemischen Industrie,2105018000,1185982000,3291000000
2018,1,WA39,Kunststoffe und Waren daraus,5333155000,3381704000,8714859000
2018,1,WA40,Kautschuk und Waren daraus,1246286000,1156232000,2402518000
2018,1,WA41,"Häute, Felle, Leder",74945000,59112000,134057000
2018,1,WA42,"Lederwaren, Sattlerwaren",198278000,377203000,575481000
2018,1,WA43,"Pelzfelle, künstliches Pelzwerk",8291000,11206000,19497000
2018,1,WA44,"Holz, Holzwaren, Holzkohle",671723000,656555000,1328278000
2018,1,WA45,"Kork, Korkwaren",2538000,7622000,10160000
2018,1,WA46,"Flechtwaren, Korbmacherwaren",3868000,10671000,14539000
2018,1,WA47,"Halbstoffe aus Holz usw., Papierabfall",102202000,337127000,439329000
2018,1,WA48,"Papier, Pappe und Waren daraus",1551112000,1080238000,2631350000
2018,1,WA49,"Bücher, Zeitungen, Bilddrucke usw.",343489000,221677000,565166000
2018,1,WA50,Seide,4534000,4511000,9045000
2018,1,WA51,"Wolle, feine und grobe Tierhaare",45702000,59407000,105109000
2018,1,WA52,Baumwolle,70722000,79054000,149776000
2018,1,WA53,"Andere pflanzliche Spinnstoffe, Papiergarn",4117000,6096000,10213000
2018,1,WA54,Synthetisches oder künstliches Filament,169064000,146459000,315523000
2018,1,WA55,Synthetische oder künstliche Spinnfaser,154811000,123560000,278371000
2018,1,WA56,"Watte, Filz, Vliesstoff usw., Tauwerk",206148000,130199000,336347000
2018,1,WA57,"Teppiche, Fußbodenbelag aus Spinnstoff",47543000,109656000,157199000
2018,1,WA58,"Spezialgewebe, Spitzen, Tapisserien",44134000,23068000,67202000
2018,1,WA59,"Getränkte, bestrichene usw. Gewebe",222777000,95192000,317969000
2018,1,WA60,Gewirke und Gestricke,62774000,36139000,98913000
2018,1,WA61,"Bekleidung usw. aus Gewirken, Gestricken",821051000,1537304000,2358355000
2018,1,WA62,"Andere Bekleidung, Bekleidungszubehör",895722000,1532568000,2428290000
2018,1,WA63,"Andere Konfektion, Spinnstoffwaren usw.",206208000,347854000,554062000
2018,1,WA64,"Schuhe, Gamaschen, ähnliche Waren",669187000,1035670000,1704857000
2018,1,WA65,Kopfbedeckungen und Teile davon,30777000,53095000,83872000
2018,1,WA66,"Schirme, Gehstöcke usw., Peitschen",6231000,28077000,34308000
2018,1,WA67,"Zugerichtete Federn, Daunen, künstliche Blumen",12996000,19341000,32337000
2018,1,WA68,"Waren aus Steinen, Gips, Zement usw.",395432000,240396000,635828000
2018,1,WA69,Keramische Waren,271610000,241152000,512762000
2018,1,WA70,Glas und Glaswaren,563558000,445761000,1009319000
2018,1,WA71,"Perlen, Edelsteine, Edelmetalle",1008865000,1358284000,2367149000
2018,1,WA72,Eisen und Stahl,2062666000,2269642000,4332308000
2018,1,WA73,Waren aus Eisen oder Stahl,2329912000,1738940000,4068852000
2018,1,WA74,Kupfer und Waren daraus,1059138000,963966000,2023104000
2018,1,WA75,Nickel und Waren daraus,107932000,125203000,233135000
2018,1,WA76,Aluminium und Waren daraus,1188219000,1361551000,2549770000
2018,1,WA78,Blei und Waren daraus,36082000,43672000,79754000
2018,1,WA79,Zink und Waren daraus,73646000,129560000,203206000
2018,1,WA80,Zinn und Waren daraus,8889000,30168000,39057000
2018,1,WA81,"Andere unedle Metalle, Cermets usw.",130953000,170310000,301263000
2018,1,WA82,"Werkzeuge, Schneidwaren, Essbestecke",703944000,446703000,1150647000
2018,1,WA83,Verschiedene Waren aus unedlen Metallen,660560000,436008000,1096568000
2018,1,WA84,"Maschinen, Apparate, mechanische Geräte",17822840000,11768252000,29591092000
2018,1,WA85,Elektrotechnische Erzeugnisse,11549618000,11586780000,23136398000
2018,1,WA86,Schienenfahrzeuge,354440000,175983000,530423000
2018,1,WA87,"Kraftfahrzeuge, Landfahrzeuge",18508460000,8588667000,27097127000
2018,1,WA88,"Luftfahrzeuge, Raumfahrzeuge",2267441000,1050914000,3318355000
2018,1,WA89,Wasserfahrzeuge,404357000,115936000,520293000
2018,1,WA90,"Optische, photografische usw. Erzeugnisse",5291717000,3059275000,8350992000
2018,1,WA91,Uhrmacherwaren,118834000,151054000,269888000
2018,1,WA92,Musikinstrumente,47792000,53578000,101370000
2018,1,WA93,Waffen und Munition,24873000,16913000,41786000
2018,1,WA94,"Möbel, Beleuchtungskörper usw.",1232720000,1642261000,2874981000
2018,1,WA95,"Spielzeug, Spiele usw., Sportgeräte",357405000,549296000,906701000
2018,1,WA96,Verschiedene Waren,328235000,249264000,577499000
2018,1,WA97,"Kunstgegenstände, Sammlungsstücke",64446000,57669000,122115000
2018,1,WA98,Vollständige Fabrikationsanlagen,88953000,3004000,91957000
2018,1,WA99,Zusammenstellungen verschiedener Waren,1189418000,992650000,2182068000
2018,2,WA01,Lebende Tiere,114376000,136194000,250570000
2018,2,WA02,Fleisch,584031000,502651000,1086682000
2018,2,WA03,"Fische, Krebs- und Weichtiere",120736000,290119000,410855000
2018,2,WA04,"Milch, Milcherzeugnisse, Eier, Honig",677208000,640836000,1318044000
2018,2,WA05,Andere Waren tierischen Ursprungs,71016000,79869000,150885000
2018,2,WA06,"Pflanzen, Waren des Blumenhandels",70733000,283959000,354692000
2018,2,WA07,"Gemüse, Pflanzen für Ernährung",79247000,582574000,661821000
2018,2,WA08,Genießbare Früchte und Nüsse,156881000,792517000,949398000
2018,2,WA09,"Kaffee, Tee, Mate, Gewürze",216220000,309992000,526212000
2018,2,WA10,Getreide,156480000,228797000,385277000
2018,2,WA11,"Müllereierzeugnisse, Malz usw.",127202000,49085000,176287000
2018,2,WA12,"Ölsamen usw., Heilpflanzen usw.",202516000,430013000,632529000
2018,2,WA13,"Schellack, Gummen, Harz, Pflanzensaft",51539000,47955000,99494000
2018,2,WA14,Flechtstoffe usw. pflanzlichen Ursprungs,728000,3868000,4596000
2018,2,WA15,"Tierische und pflanzliche Fette, Öle, Wachs",196561000,293536000,490097000
2018,2,WA16,"Zubereitungen von Fleisch, Fisch usw.",239313000,242340000,481653000
2018,2,WA17,Zucker und Zuckerwaren,167183000,130820000,298003000
2018,2,WA18,Kakao und Zubereitungen aus Kakao,486280000,379551000,865831000
2018,2,WA19,"Zubereitungen aus Getreide usw., Backwaren",504609000,339824000,844433000
2018,2,WA20,"Zubereitungen von Gemüse, Früchten usw.",225815000,383480000,609295000
2018,2,WA21,Verschiedene Lebensmittelzubereitungen,451100000,275187000,726287000
2018,2,WA22,"Getränke, alkoholhaltige Flüssigkeiten, Essig",419035000,506217000,925252000
2018,2,WA23,"Rückstände der Lebensmittelindustrie, Futter",325483000,292790000,618273000
2018,2,WA24,Tabak,344919000,155511000,500430000
2018,2,WA25,"Salz, Schwefel, Steine, Erden usw.",155340000,155934000,311274000
2018,2,WA26,"Erze, Schlacken, Aschen",42430000,817200000,859630000
2018,2,WA27,Mineralische Brennstoffe usw.,2355611000,7741385000,10096996000
2018,2,WA28,Anorganische chemische Erzeugnisse,740353000,628310000,1368663000
2018,2,WA29,Organische chemische Erzeugnisse,2159904000,2937440000,5097344000
2018,2,WA30,Pharmazeutische Erzeugnisse,6654040000,3940132000,10594172000
2018,2,WA31,Düngemittel,181844000,96735000,278579000
2018,2,WA32,"Gerb- und Farbstoffe, Farben, Lacke usw.",965954000,462437000,1428391000
2018,2,WA33,"Etherische Öle, Riech-, Schönheitsmittel",776504000,569437000,1345941000
2018,2,WA34,"Seifen, Waschmittel usw.",632559000,328779000,961338000
2018,2,WA35,"Eiweißstoffe, Klebstoffe, Enzyme",280420000,175330000,455750000
2018,2,WA36,"Sprengstoffe, pyrotechnische Artikel usw.",23115000,13607000,36722000
2018,2,WA37,Photochemische Erzeugnisse,97768000,77048000,174816000
2018,2,WA38,Verschiedene Erzeugnisse der Chemischen Industrie,2002456000,1110079000,3112535000
2018,2,WA39,Kunststoffe und Waren daraus,5125608000,3401023000,8526631000
2018,2,WA40,Kautschuk und Waren daraus,1222011000,1179962000,2401973000
2018,2,WA41,"Häute, Felle, Leder",76645000,60181000,136826000
2018,2,WA42,"Lederwaren, Sattlerwaren",182779000,324446000,507225000
2018,2,WA43,"Pelzfelle, künstliches Pelzwerk",11342000,11685000,23027000
2018,2,WA44,"Holz, Holzwaren, Holzkohle",650255000,648754000,1299009000
2018,2,WA45,"Kork, Korkwaren",2362000,8681000,11043000
2018,2,WA46,"Flechtwaren, Korbmacherwaren",4184000,9575000,13759000
2018,2,WA47,"Halbstoffe aus Holz usw., Papierabfall",95788000,325356000,421144000
2018,2,WA48,"Papier, Pappe und Waren daraus",1532561000,1012331000,2544892000
2018,2,WA49,"Bücher, Zeitungen, Bilddrucke usw.",339366000,195777000,535143000
2018,2,WA50,Seide,3596000,3965000,7561000
2018,2,WA51,"Wolle, feine und grobe Tierhaare",43697000,49250000,92947000
2018,2,WA52,Baumwolle,68852000,76555000,145407000
2018,2,WA53,"Andere pflanzliche Spinnstoffe, Papiergarn",3259000,5761000,9020000
2018,2,WA54,Synthetisches oder künstliches Filament,161391000,126561000,287952000
2018,2,WA55,Synthetische oder künstliche Spinnfaser,148614000,120751000,269365000
2018,2,WA56,"Watte, Filz, Vliesstoff usw., Tauwerk",211113000,120555000,331668000
2018,2,WA57,"Teppiche, Fußbodenbelag aus Spinnstoff",48224000,91970000,140194000
2018,2,WA58,"Spezialgewebe, Spitzen, Tapisserien",44172000,21987000,66159000
2018,2,WA59,"Getränkte, bestrichene usw. Gewebe",215598000,95030000,310628000
2018,2,WA60,Gewirke und Gestricke,63121000,36884000,100005000
2018,2,WA61,"Bekleidung usw. aus Gewirken, Gestricken",764137000,1297616000,2061753000
2018,2,WA62,"Andere Bekleidung, Bekleidungszubehör",902026000,1412549000,2314575000
2018,2,WA63,"Andere Konfektion, Spinnstoffwaren usw.",204457000,317259000,521716000
2018,2,WA64,"Schuhe, Gamaschen, ähnliche Waren",647961000,1055300000,1703261000
2018,2,WA65,Kopfbedeckungen und Teile davon,44297000,51411000,95708000
2018,2,WA66,"Schirme, Gehstöcke usw., Peitschen",9410000,30041000,39451000
2018,2,WA67,"Zugerichtete Federn, Daunen, künstliche Blumen",12210000,16766000,28976000
2018,2,WA68,"Waren aus Steinen, Gips, Zement usw.",387884000,263754000,651638000
2018,2,WA69,Keramische Waren,267576000,234776000,502352000
2018,2,WA70,Glas und Glaswaren,530103000,433121000,963224000
2018,2,WA71,"Perlen, Edelsteine, Edelmetalle",901119000,1140052000,2041171000
2018,2,WA72,Eisen und Stahl,2065760000,2379412000,4445172000
2018,2,WA73,Waren aus Eisen oder Stahl,2347460000,1743508000,4090968000
2018,2,WA74,Kupfer und Waren daraus,891664000,857249000,1748913000
2018,2,WA75,Nickel und Waren daraus,95862000,130439000,226301000
2018,2,WA76,Aluminium und Waren daraus,1253885000,1399588000,2653473000
2018,2,WA78,Blei und Waren daraus,41955000,41833000,83788000
2018,2,WA79,Zink und Waren daraus,72548000,122500000,195048000
2018,2,WA80,Zinn und Waren daraus,11489000,34879000,46368000
2018,2,WA81,"Andere unedle Metalle, Cermets usw.",134960000,172008000,306968000
2018,2,WA82,"Werkzeuge, Schneidwaren, Essbestecke",700281000,423521000,1123802000
2018,2,WA83,Verschiedene Waren aus unedlen Metallen,638710000,408967000,1047677000
2018,2,WA84,"Maschinen, Apparate, mechanische Geräte",18226537000,10726256000,28952793000
2018,2,WA85,Elektrotechnische Erzeugnisse,10572795000,10083476000,20656271000
2018,2,WA86,Schienenfahrzeuge,404499000,239178000,643677000
2018,2,WA87,"Kraftfahrzeuge, Landfahrzeuge",18745304000,8895680000,27640984000
2018,2,WA88,"Luftfahrzeuge, Raumfahrzeuge",1612269000,1222110000,2834379000
2018,2,WA89,Wasserfahrzeuge,192297000,225180000,417477000
2018,2,WA90,"Optische, photografische usw. Erzeugnisse",5113829000,2882161000,7995990000
2018,2,WA91,Uhrmacherwaren,129992000,147605000,277597000
2018,2,WA92,Musikinstrumente,48948000,46324000,95272000
2018,2,WA93,Waffen und Munition,37235000,17531000,54766000
2018,2,WA94,"Möbel, Beleuchtungskörper usw.",1278300000,1614370000,2892670000
2018,2,WA95,"Spielzeug, Spiele usw., Sportgeräte",335432000,491111000,826543000
2018,2,WA96,Verschiedene Waren,320960000,223613000,544573000
2018,2,WA97,"Kunstgegenstände, Sammlungsstücke",76771000,39475000,116246000
2018,2,WA98,Vollständige Fabrikationsanlagen,100186000,76000,100262000
2018,2,WA99,Zusammenstellungen verschiedener Waren,1287878000,926969000,2214847000
2018,3,WA01,Lebende Tiere,103693000,143056000,246749000
2018,3,WA02,Fleisch,636148000,581710000,1217858000
2018,3,WA03,"Fische, Krebs- und Weichtiere",128886000,352178000,481064000
2018,3,WA04,"Milch, Milcherzeugnisse, Eier, Honig",777481000,727473000,1504954000
2018,3,WA05,Andere Waren tierischen Ursprungs,77965000,85473000,163438000
2018,3,WA06,"Pflanzen, Waren des Blumenhandels",105416000,310821000,416237000
2018,3,WA07,"Gemüse, Pflanzen für Ernährung",96407000,594406000,690813000
2018,3,WA08,Genießbare Früchte und Nüsse,145207000,840625000,985832000
2018,3,WA09,"Kaffee, Tee, Mate, Gewürze",244136000,305081000,549217000
2018,3,WA10,Getreide,182193000,227662000,409855000
2018,3,WA11,"Müllereierzeugnisse, Malz usw.",126745000,47996000,174741000
2018,3,WA12,"Ölsamen usw., Heilpflanzen usw.",168986000,431326000,600312000
2018,3,WA13,"Schellack, Gummen, Harz, Pflanzensaft",65749000,60284000,126033000
2018,3,WA14,Flechtstoffe usw. pflanzlichen Ursprungs,786000,3858000,4644000
2018,3,WA15,"Tierische und pflanzliche Fette, Öle, Wachs",248366000,322535000,570901000
2018,3,WA16,"Zubereitungen von Fleisch, Fisch usw.",243799000,240917000,484716000
2018,3,WA17,Zucker und Zuckerwaren,175405000,116145000,291550000
2018,3,WA18,Kakao und Zubereitungen aus Kakao,379052000,332317000,711369000
2018,3,WA19,"Zubereitungen aus Getreide usw., Backwaren",550012000,339140000,889152000
2018,3,WA20,"Zubereitungen von Gemüse, Früchten usw.",241788000,400710000,642498000
2018,3,WA21,Verschiedene Lebensmittelzubereitungen,478463000,280705000,759168000
2018,3,WA22,"Getränke, alkoholhaltige Flüssigkeiten, Essig",478270000,564898000,1043168000
2018,3,WA23,"Rückstände der Lebensmittelindustrie, Futter",340614000,288546000,629160000
2018,3,WA24,Tabak,318808000,181535000,500343000
2018,3,WA25,"Salz, Schwefel, Steine, Erden usw.",164575000,166091000,330666000
2018,3,WA26,"Erze, Schlacken, Aschen",42936000,603614000,646550000
2018,3,WA27,Mineralische Brennstoffe usw.,2582394000,8254804000,10837198000
2018,3,WA28,Anorganische chemische Erzeugnisse,744415000,544982000,1289397000
2018,3,WA29,Organische chemische Erzeugnisse,2239288000,2852198000,5091486000
2018,3,WA30,Pharmazeutische Erzeugnisse,7404312000,3935008000,11339320000
2018,3,WA31,Düngemittel,186097000,90856000,276953000
2018,3,WA32,"Gerb- und Farbstoffe, Farben, Lacke usw.",982318000,516896000,1499214000
2018,3,WA33,"Etherische Öle, Riech-, Schönheitsmittel",861098000,619819000,1480917000
2018,3,WA34,"Seifen, Waschmittel usw.",663368000,336905000,1000273000
2018,3,WA35,"Eiweißstoffe, Klebstoffe, Enzyme",294795000,175704000,470499000
2018,3,WA36,"Sprengstoffe, pyrotechnische Artikel usw.",24100000,12093000,36193000
2018,3,WA37,Photochemische Erzeugnisse,107782000,70127000,177909000
2018,3,WA38,Verschiedene Erzeugnisse der Chemischen Industrie,2041150000,1243037000,3284187000
2018,3,WA39,Kunststoffe und Waren daraus,5379802000,3497492000,8877294000
2018,3,WA40,Kautschuk und Waren daraus,1343968000,1292576000,2636544000
2018,3,WA41,"Häute, Felle, Leder",86927000,73126000,160053000
2018,3,WA42,"Lederwaren, Sattlerwaren",183645000,299229000,482874000
2018,3,WA43,"Pelzfelle, künstliches Pelzwerk",10494000,12749000,23243000
2018,3,WA44,"Holz, Holzwaren, Holzkohle",700238000,707785000,1408023000
2018,3,WA45,"Kork, Korkwaren",2414000,8675000,11089000
2018,3,WA46,"Flechtwaren, Korbmacherwaren",4369000,9722000,14091000
2018,3,WA47,"Halbstoffe aus Holz usw., Papierabfall",91416000,336784000,428200000
2018,3,WA48,"Papier, Pappe und Waren daraus",1544467000,1074683000,2619150000
2018,3,WA49,"Bücher, Zeitungen, Bilddrucke usw.",350690000,229583000,580273000
2018,3,WA50,Seide,5718000,5583000,11301000
2018,3,WA51,"Wolle, feine und grobe Tierhaare",45881000,51974000,97855000
2018,3,WA52,Baumwolle,70525000,74656000,145181000
2018,3,WA53,"Andere pflanzliche Spinnstoffe, Papiergarn",3078000,5214000,8292000
2018,3,WA54,Synthetisches oder künstliches Filament,170767000,142161000,312928000
2018,3,WA55,Synthetische oder künstliche Spinnfaser,159990000,134555000,294545000
2018,3,WA56,"Watte, Filz, Vliesstoff usw., Tauwerk",210337000,129653000,339990000
2018,3,WA57,"Teppiche, Fußbodenbelag aus Spinnstoff",47707000,93425000,141132000
2018,3,WA58,"Spezialgewebe, Spitzen, Tapisserien",44172000,23215000,67387000
2018,3,WA59,"Getränkte, bestrichene usw. Gewebe",232566000,97022000,329588000
2018,3,WA60,Gewirke und Gestricke,71641000,46315000,117956000
2018,3,WA61,"Bekleidung usw. aus Gewirken, Gestricken",709008000,1229431000,1938439000
2018,3,WA62,"Andere Bekleidung, Bekleidungszubehör",913034000,1378883000,2291917000
2018,3,WA63,"Andere Konfektion, Spinnstoffwaren usw.",214256000,308064000,522320000
2018,3,WA64,"Schuhe, Gamaschen, ähnliche Waren",627258000,855466000,1482724000
2018,3,WA65,Kopfbedeckungen und Teile davon,38741000,49277000,88018000
2018,3,WA66,"Schirme, Gehstöcke usw., Peitschen",10704000,29279000,39983000
2018,3,WA67,"Zugerichtete Federn, Daunen, künstliche Blumen",11435000,15289000,26724000
2018,3,WA68,"Waren aus Steinen, Gips, Zement usw.",406296000,280480000,686776000
2018,3,WA69,Keramische Waren,292623000,244398000,537021000
2018,3,WA70,Glas und Glaswaren,559732000,462702000,1022434000
2018,3,WA71,"Perlen, Edelsteine, Edelmetalle",1063924000,1444403000,2508327000
2018,3,WA72,Eisen und Stahl,2158049000,2422362000,4580411000
2018,3,WA73,Waren aus Eisen oder Stahl,2434614000,1859852000,4294466000
2018,3,WA74,Kupfer und Waren daraus,1035049000,860479000,1895528000
2018,3,WA75,Nickel und Waren daraus,111007000,134477000,245484000
2018,3,WA76,Aluminium und Waren daraus,1334304000,1413145000,2747449000
2018,3,WA78,Blei und Waren daraus,28853000,39087000,67940000
2018,3,WA79,Zink und Waren daraus,65550000,152476000,218026000
2018,3,WA80,Zinn und Waren daraus,9456000,41385000,50841000
2018,3,WA81,"Andere unedle Metalle, Cermets usw.",126740000,185479000,312219000
2018,3,WA82,"Werkzeuge, Schneidwaren, Essbestecke",759830000,443166000,1202996000
2018,3,WA83,Verschiedene Waren aus unedlen Metallen,647940000,433521000,1081461000
2018,3,WA84,"Maschinen, Apparate, mechanische Geräte",20414750000,11736209000,32150959000
2018,3,WA85,Elektrotechnische Erzeugnisse,11646429000,10925583000,22572012000
2018,3,WA86,Schienenfahrzeuge,315238000,172753000,487991000
2018,3,WA87,"Kraftfahrzeuge, Landfahrzeuge",20947396000,10411334000,31358730000
2018,3,WA88,"Luftfahrzeuge, Raumfahrzeuge",3075947000,1145894000,4221841000
2018,3,WA89,Wasserfahrzeuge,1055341000,52158000,1107499000
2018,3,WA90,"Optische, photografische usw. Erzeugnisse",5843838000,3138524000,8982362000
2018,3,WA91,Uhrmacherwaren,128174000,144608000,272782000
2018,3,WA92,Musikinstrumente,52766000,50865000,103631000
2018,3,WA93,Waffen und Munition,40473000,21248000,61721000
2018,3,WA94,"Möbel, Beleuchtungskörper usw.",1341422000,1614746000,2956168000
2018,3,WA95,"Spielzeug, Spiele usw., Sportgeräte",339958000,511664000,851622000
2018,3,WA96,Verschiedene Waren,340313000,243257000,583570000
2018,3,WA97,"Kunstgegenstände, Sammlungsstücke",76648000,57810000,134458000
2018,3,WA98,Vollständige Fabrikationsanlagen,118147000,4143000,122290000
2018,3,WA99,Zusammenstellungen verschiedener Waren,1379412000,1001579000,2380991000
2018,4,WA01,Lebende Tiere,121305000,152463000,273768000
2018,4,WA02,Fleisch,591521000,597455000,1188976000
2018,4,WA03,"Fische, Krebs- und Weichtiere",129182000,302212000,431394000
2018,4,WA04,"Milch, Milcherzeugnisse, Eier, Honig",729098000,655891000,1384989000
2018,4,WA05,Andere Waren tierischen Ursprungs,73868000,79394000,153262000
2018,4,WA06,"Pflanzen, Waren des Blumenhandels",135674000,340817000,476491000
2018,4,WA07,"Gemüse, Pflanzen für Ernährung",92798000,622647000,715445000
2018,4,WA08,Genießbare Früchte und Nüsse,159734000,841649000,1001383000
2018,4,WA09,"Kaffee, Tee, Mate, Gewürze",220361000,345501000,565862000
2018,4,WA10,Getreide,149785000,178065000,327850000
2018,4,WA11,"Müllereierzeugnisse, Malz usw.",131833000,50535000,182368000
2018,4,WA12,"Ölsamen usw., Heilpflanzen usw.",95710000,374944000,470654000
2018,4,WA13,"Schellack, Gummen, Harz, Pflanzensaft",59741000,48860000,108601000
2018,4,WA14,Flechtstoffe usw. pflanzlichen Ursprungs,853000,3182000,4035000
2018,4,WA15,"Tierische und pflanzliche Fette, Öle, Wachs",200340000,293924000,494264000
2018,4,WA16,"Zubereitungen von Fleisch, Fisch usw.",256130000,230607000,486737000
2018,4,WA17,Zucker und Zuckerwaren,174850000,134578000,309428000
2018,4,WA18,Kakao und Zubereitungen aus Kakao,349477000,336139000,685616000
2018,4,WA19,"Zubereitungen aus Getreide usw., Backwaren",504102000,354348000,858450000
2018,4,WA20,"Zubereitungen von Gemüse, Früchten usw.",261600000,433331000,694931000
2018,4,WA21,Verschiedene Lebensmittelzubereitungen,484161000,301834000,785995000
2018,4,WA22,"Getränke, alkoholhaltige Flüssigkeiten, Essig",491139000,609425000,1100564000
2018,4,WA23,"Rückstände der Lebensmittelindustrie, Futter",331951000,322437000,654388000
2018,4,WA24,Tabak,252831000,193406000,446237000
2018,4,WA25,"Salz, Schwefel, Steine, Erden usw.",171270000,159174000,330444000
2018,4,WA26,"Erze, Schlacken, Aschen",46779000,667827000,714606000
2018,4,WA27,Mineralische Brennstoffe usw.,2025211000,7396294000,9421505000
2018,4,WA28,Anorganische chemische Erzeugnisse,772396000,605808000,1378204000
2018,4,WA29,Organische chemische Erzeugnisse,2044034000,3131024000,5175058000
2018,4,WA30,Pharmazeutische Erzeugnisse,6645884000,4022840000,10668724000
2018,4,WA31,Düngemittel,192354000,68399000,260753000
2018,4,WA32,"Gerb- und Farbstoffe, Farben, Lacke usw.",982808000,563877000,1546685000
2018,4,WA33,"Etherische Öle, Riech-, Schönheitsmittel",790984000,578644000,1369628000
2018,4,WA34,"Seifen, Waschmittel usw.",642016000,341576000,983592000
2018,4,WA35,"Eiweißstoffe, Klebstoffe, Enzyme",290495000,173270000,463765000
2018,4,WA36,"Sprengstoffe, pyrotechnische Artikel usw.",22497000,11329000,33826000
2018,4,WA37,Photochemische Erzeugnisse,108875000,91852000,200727000
2018,4,WA38,Verschiedene Erzeugnisse der Chemischen Industrie,1941912000,1167717000,3109629000
2018,4,WA39,Kunststoffe und Waren daraus,5245649000,3507168000,8752817000
2018,4,WA40,Kautschuk und Waren daraus,1317525000,1255073000,2572598000
2018,4,WA41,"Häute, Felle, Leder",85169000,70178000,155347000
2018,4,WA42,"Lederwaren, Sattlerwaren",184672000,313299000,497971000
2018,4,WA43,"Pelzfelle, künstliches Pelzwerk",10918000,11684000,22602000
2018,4,WA44,"Holz, Holzwaren, Holzkohle",705433000,686550000,1391983000
2018,4,WA45,"Kork, Korkwaren",3275000,9924000,13199000
2018,4,WA46,"Flechtwaren, Korbmacherwaren",3869000,9891000,13760000
2018,4,WA47,"Halbstoffe aus Holz usw., Papierabfall",93166000,338827000,431993000
2018,4,WA48,"Papier, Pappe und Waren daraus",1554635000,1060863000,2615498000
2018,4,WA49,"Bücher, Zeitungen, Bilddrucke usw.",345429000,204870000,550299000
2018,4,WA50,Seide,2805000,4270000,7075000
2018,4,WA51,"Wolle, feine und grobe Tierhaare",47845000,66391000,114236000
2018,4,WA52,Baumwolle,70604000,80914000,151518000
2018,4,WA53,"Andere pflanzliche Spinnstoffe, Papiergarn",2860000,4913000,7773000
2018,4,WA54,Synthetisches oder künstliches Filament,158722000,136234000,294956000
2018,4,WA55,Synthetische oder künstliche Spinnfaser,151891000,136036000,287927000
2018,4,WA56,"Watte, Filz, Vliesstoff usw., Tauwerk",209570000,129520000,339090000
2018,4,WA57,"Teppiche, Fußbodenbelag aus Spinnstoff",47097000,83490000,130587000
2018,4,WA58,"Spezialgewebe, Spitzen, Tapisserien",45170000,22371000,67541000
2018,4,WA59,"Getränkte, bestrichene usw. Gewebe",223844000,100408000,324252000
2018,4,WA60,Gewirke und Gestricke,72403000,44604000,117007000
2018,4,WA61,"Bekleidung usw. aus Gewirken, Gestricken",697895000,1263411000,1961306000
2018,4,WA62,"Andere Bekleidung, Bekleidungszubehör",825594000,1277503000,2103097000
2018,4,WA63,"Andere Konfektion, Spinnstoffwaren usw.",216381000,316683000,533064000
2018,4,WA64,"Schuhe, Gamaschen, ähnliche Waren",514932000,871603000,1386535000
2018,4,WA65,Kopfbedeckungen und Teile davon,39361000,40717000,80078000
2018,4,WA66,"Schirme, Gehstöcke usw., Peitschen",9718000,20169000,29887000
2018,4,WA67,"Zugerichtete Federn, Daunen, künstliche Blumen",10125000,11348000,21473000
2018,4,WA68,"Waren aus Steinen, Gips, Zement usw.",424866000,292841000,717707000
2018,4,WA69,Keramische Waren,284003000,234544000,518547000
2018,4,WA70,Glas und Glaswaren,582568000,459683000,1042251000
2018,4,WA71,"Perlen, Edelsteine, Edelmetalle",916242000,1214105000,2130347000
2018,4,WA72,Eisen und Stahl,2126901000,2477177000,4604078000
2018,4,WA73,Waren aus Eisen oder Stahl,2419215000,1817744000,4236959000
2018,4,WA74,Kupfer und Waren daraus,931382000,1024880000,1956262000
2018,4,WA75,Nickel und Waren daraus,111682000,128699000,240381000
2018,4,WA76,Aluminium und Waren daraus,1260248000,1377048000,2637296000
2018,4,WA78,Blei und Waren daraus,34322000,55792000,90114000
2018,4,WA79,Zink und Waren daraus,61334000,150309000,211643000
2018,4,WA80,Zinn und Waren daraus,10876000,39745000,50621000
2018,4,WA81,"Andere unedle Metalle, Cermets usw.",126563000,178466000,305029000
2018,4,WA82,"Werkzeuge, Schneidwaren, Essbestecke",724675000,432538000,1157213000
2018,4,WA83,Verschiedene Waren aus unedlen Metallen,625747000,391129000,1016876000
2018,4,WA84,"Maschinen, Apparate, mechanische Geräte",19230112000,11608855000,30838967000
2018,4,WA85,Elektrotechnische Erzeugnisse,11188142000,10874656000,22062798000
2018,4,WA86,Schienenfahrzeuge,395146000,223890000,619036000
2018,4,WA87,"Kraftfahrzeuge, Landfahrzeuge",20302013000,9937611000,30239624000
2018,4,WA88,"Luftfahrzeuge, Raumfahrzeuge",3092540000,1318405000,4410945000
2018,4,WA89,Wasserfahrzeuge,764223000,216510000,980733000
2018,4,WA90,"Optische, photografische usw. Erzeugnisse",5371738000,3051564000,8423302000
2018,4,WA91,Uhrmacherwaren,125777000,152145000,277922000
2018,4,WA92,Musikinstrumente,51685000,53039000,104724000
2018,4,WA93,Waffen und Munition,41941000,20883000,62824000
2018,4,WA94,"Möbel, Beleuchtungskörper usw.",1299212000,1515444000,2814656000
2018,4,WA95,"Spielzeug, Spiele usw., Sportgeräte",360368000,479447000,839815000
2018,4,WA96,Verschiedene Waren,346297000,231217000,577514000
2018,4,WA97,"Kunstgegenstände, Sammlungsstücke",96023000,43776000,139799000
2018,4,WA98,Vollständige Fabrikationsanlagen,135357000,102000,135459000
2018,4,WA99,Zusammenstellungen verschiedener Waren,1330106000,1003012000,2333118000
2018,5,WA01,Lebende Tiere,116945000,140619000,257564000
2018,5,WA02,Fleisch,567695000,553718000,1121413000
2018,5,WA03,"Fische, Krebs- und Weichtiere",122442000,316255000,438697000
2018,5,WA04,"Milch, Milcherzeugnisse, Eier, Honig",767973000,683607000,1451580000
2018,5,WA05,Andere Waren tierischen Ursprungs,81487000,83874000,165361000
2018,5,WA06,"Pflanzen, Waren des Blumenhandels",127817000,336259000,464076000
2018,5,WA07,"Gemüse, Pflanzen für Ernährung",85646000,559787000,645433000
2018,5,WA08,Genießbare Früchte und Nüsse,156903000,921142000,1078045000
2018,5,WA09,"Kaffee, Tee, Mate, Gewürze",221086000,290460000,511546000
2018,5,WA10,Getreide,159688000,190130000,349818000
2018,5,WA11,"Müllereierzeugnisse, Malz usw.",126156000,62133000,188289000
2018,5,WA12,"Ölsamen usw., Heilpflanzen usw.",84027000,448340000,532367000
2018,5,WA13,"Schellack, Gummen, Harz, Pflanzensaft",52860000,42897000,95757000
2018,5,WA14,Flechtstoffe usw. pflanzlichen Ursprungs,955000,3419000,4374000
2018,5,WA15,"Tierische und pflanzliche Fette, Öle, Wachs",227653000,286135000,513788000
2018,5,WA16,"Zubereitungen von Fleisch, Fisch usw.",260381000,245195000,505576000
2018,5,WA17,Zucker und Zuckerwaren,190786000,125249000,316035000
2018,5,WA18,Kakao und Zubereitungen aus Kakao,356610000,296095000,652705000
2018,5,WA19,"Zubereitungen aus Getreide usw., Backwaren",535388000,342197000,877585000
2018,5,WA20,"Zubereitungen von Gemüse, Früchten usw.",242926000,402019000,644945000
2018,5,WA21,Verschiedene Lebensmittelzubereitungen,489858000,292308000,782166000
2018,5,WA22,"Getränke, alkoholhaltige Flüssigkeiten, Essig",531400000,602913000,1134313000
2018,5,WA23,"Rückstände der Lebensmittelindustrie, Futter",336025000,302137000,638162000
2018,5,WA24,Tabak,342568000,195681000,538249000
2018,5,WA25,"Salz, Schwefel, Steine, Erden usw.",166524000,161723000,328247000
2018,5,WA26,"Erze, Schlacken, Aschen",31332000,638584000,669916000
2018,5,WA27,Mineralische Brennstoffe usw.,2082377000,7912131000,9994508000
2018,5,WA28,Anorganische chemische Erzeugnisse,797915000,585627000,1383542000
2018,5,WA29,Organische chemische Erzeugnisse,2050092000,3141406000,5191498000
2018,5,WA30,Pharmazeutische Erzeugnisse,6547355000,3748435000,10295790000
2018,5,WA31,Düngemittel,155802000,77808000,233610000
2018,5,WA32,"Gerb- und Farbstoffe, Farben, Lacke usw.",970391000,511996000,1482387000
2018,5,WA33,"Etherische Öle, Riech-, Schönheitsmittel",810475000,584000000,1394475000
2018,5,WA34,"Seifen, Waschmittel usw.",630570000,324796000,955366000
2018,5,WA35,"Eiweißstoffe, Klebstoffe, Enzyme",293895000,176624000,470519000
2018,5,WA36,"Sprengstoffe, pyrotechnische Artikel usw.",20678000,12633000,33311000
2018,5,WA37,Photochemische Erzeugnisse,100172000,71860000,172032000
2018,5,WA38,Verschiedene Erzeugnisse der Chemischen Industrie,1825931000,1169766000,2995697000
2018,5,WA39,Kunststoffe und Waren daraus,5174809000,3448324000,8623133000
2018,5,WA40,Kautschuk und Waren daraus,1259438000,1172052000,2431490000
2018,5,WA41,"Häute, Felle, Leder",78414000,61346000,139760000
2018,5,WA42,"Lederwaren, Sattlerwaren",173286000,332788000,506074000
2018,5,WA43,"Pelzfelle, künstliches Pelzwerk",12274000,13887000,26161000
2018,5,WA44,"Holz, Holzwaren, Holzkohle",714475000,687473000,1401948000
2018,5,WA45,"Kork, Korkwaren",2235000,6086000,8321000
2018,5,WA46,"Flechtwaren, Korbmacherwaren",3855000,8611000,12466000
2018,5,WA47,"Halbstoffe aus Holz usw., Papierabfall",100117000,353732000,453849000
2018,5,WA48,"Papier, Pappe und Waren daraus",1546541000,1007070000,2553611000
2018,5,WA49,"Bücher, Zeitungen, Bilddrucke usw.",320528000,206704000,527232000
2018,5,WA50,Seide,5607000,4225000,9832000
2018,5,WA51,"Wolle, feine und grobe Tierhaare",45899000,61762000,107661000
2018,5,WA52,Baumwolle,72273000,77045000,149318000
2018,5,WA53,"Andere pflanzliche Spinnstoffe, Papiergarn",2595000,5033000,7628000
2018,5,WA54,Synthetisches oder künstliches Filament,164027000,135339000,299366000
2018,5,WA55,Synthetische oder künstliche Spinnfaser,156090000,128252000,284342000
2018,5,WA56,"Watte, Filz, Vliesstoff usw., Tauwerk",212128000,124330000,336458000
2018,5,WA57,"Teppiche, Fußbodenbelag aus Spinnstoff",40491000,79436000,119927000
2018,5,WA58,"Spezialgewebe, Spitzen, Tapisserien",45968000,22553000,68521000
2018,5,WA59,"Getränkte, bestrichene usw. Gewebe",216754000,94875000,311629000
2018,5,WA60,Gewirke und Gestricke,72149000,41785000,113934000
2018,5,WA61,"Bekleidung usw. aus Gewirken, Gestricken",673618000,1224330000,1897948000
2018,5,WA62,"Andere Bekleidung, Bekleidungszubehör",741693000,1207367000,1949060000
2018,5,WA63,"Andere Konfektion, Spinnstoffwaren usw.",228053000,339479000,567532000
2018,5,WA64,"Schuhe, Gamaschen, ähnliche Waren",469043000,867279000,1336322000
2018,5,WA65,Kopfbedeckungen und Teile davon,34250000,39828000,74078000
2018,5,WA66,"Schirme, Gehstöcke usw., Peitschen",9330000,21901000,31231000
2018,5,WA67,"Zugerichtete Federn, Daunen, künstliche Blumen",9567000,12553000,22120000
2018,5,WA68,"Waren aus Steinen, Gips, Zement usw.",413003000,276688000,689691000
2018,5,WA69,Keramische Waren,291830000,241899000,533729000
2018,5,WA70,Glas und Glaswaren,585793000,417270000,1003063000
2018,5,WA71,"Perlen, Edelsteine, Edelmetalle",982683000,1122789000,2105472000
2018,5,WA72,Eisen und Stahl,2090063000,2399634000,4489697000
2018,5,WA73,Waren aus Eisen oder Stahl,2492303000,1794899000,4287202000
2018,5,WA74,Kupfer und Waren daraus,954044000,903270000,1857314000
2018,5,WA75,Nickel und Waren daraus,101319000,138168000,239487000
2018,5,WA76,Aluminium und Waren daraus,1292237000,1380324000,2672561000
2018,5,WA78,Blei und Waren daraus,35536000,36163000,71699000
2018,5,WA79,Zink und Waren daraus,69285000,135699000,204984000
2018,5,WA80,Zinn und Waren daraus,8279000,37580000,45859000
2018,5,WA81,"Andere unedle Metalle, Cermets usw.",136156000,172207000,308363000
2018,5,WA82,"Werkzeuge, Schneidwaren, Essbestecke",700114000,416417000,1116531000
2018,5,WA83,Verschiedene Waren aus unedlen Metallen,638806000,397344000,1036150000
2018,5,WA84,"Maschinen, Apparate, mechanische Geräte",18943015000,11150240000,30093255000
2018,5,WA85,Elektrotechnische Erzeugnisse,11238070000,10660317000,21898387000
2018,5,WA86,Schienenfahrzeuge,335268000,203354000,538622000
2018,5,WA87,"Kraftfahrzeuge, Landfahrzeuge",19152488000,9998267000,29150755000
2018,5,WA88,"Luftfahrzeuge, Raumfahrzeuge",2424538000,1904629000,4329167000
2018,5,WA89,Wasserfahrzeuge,1598033000,138257000,1736290000
2018,5,WA90,"Optische, photografische usw. Erzeugnisse",5487908000,3003190000,8491098000
2018,5,WA91,Uhrmacherwaren,152372000,155566000,307938000
2018,5,WA92,Musikinstrumente,50240000,45271000,95511000
2018,5,WA93,Waffen und Munition,39223000,18346000,57569000
2018,5,WA94,"Möbel, Beleuchtungskörper usw.",1270391000,1445683000,2716074000
2018,5,WA95,"Spielzeug, Spiele usw., Sportgeräte",332203000,503039000,835242000
2018,5,WA96,Verschiedene Waren,334461000,234018000,568479000
2018,5,WA97,"Kunstgegenstände, Sammlungsstücke",94217000,51060000,145277000
2018,5,WA98,Vollständige Fabrikationsanlagen,184343000,0,184343000
2018,5,WA99,Zusammenstellungen verschiedener Waren,1381610000,1035079000,2416689000
2018,6,WA01,Lebende Tiere,118321000,148643000,266964000
2018,6,WA02,Fleisch,565843000,536821000,1102664000
2018,6,WA03,"Fische, Krebs- und Weichtiere",135441000,315352000,450793000
2018,6,WA04,"Milch, Milcherzeugnisse, Eier, Honig",776093000,648191000,1424284000
2018,6,WA05,Andere Waren tierischen Ursprungs,87996000,80547000,168543000
2018,6,WA06,"Pflanzen, Waren des Blumenhandels",65908000,235911000,301819000
2018,6,WA07,"Gemüse, Pflanzen für Ernährung",96071000,448851000,544922000
2018,6,WA08,Genießbare Früchte und Nüsse,165557000,919870000,1085427000
2018,6,WA09,"Kaffee, Tee, Mate, Gewürze",221408000,300906000,522314000
2018,6,WA10,Getreide,146041000,182351000,328392000
2018,6,WA11,"Müllereierzeugnisse, Malz usw.",131285000,53378000,184663000
2018,6,WA12,"Ölsamen usw., Heilpflanzen usw.",87835000,363287000,451122000
2018,6,WA13,"Schellack, Gummen, Harz, Pflanzensaft",52171000,50377000,102548000
2018,6,WA14,Flechtstoffe usw. pflanzlichen Ursprungs,865000,3728000,4593000
2018,6,WA15,"Tierische und pflanzliche Fette, Öle, Wachs",231851000,317879000,549730000
2018,6,WA16,"Zubereitungen von Fleisch, Fisch usw.",219265000,226331000,445596000
2018,6,WA17,Zucker und Zuckerwaren,180418000,127354000,307772000
2018,6,WA18,Kakao und Zubereitungen aus Kakao,364639000,355872000,720511000
2018,6,WA19,"Zubereitungen aus Getreide usw., Backwaren",518514000,314706000,833220000
2018,6,WA20,"Zubereitungen von Gemüse, Früchten usw.",255942000,392528000,648470000
2018,6,WA21,Verschiedene Lebensmittelzubereitungen,536703000,295595000,832298000
2018,6,WA22,"Getränke, alkoholhaltige Flüssigkeiten, Essig",552077000,653589000,1205666000
2018,6,WA23,"Rückstände der Lebensmittelindustrie, Futter",339320000,356641000,695961000
2018,6,WA24,Tabak,274584000,214532000,489116000
2018,6,WA25,"Salz, Schwefel, Steine, Erden usw.",182112000,179670000,361782000
2018,6,WA26,"Erze, Schlacken, Aschen",46870000,758189000,805059000
2018,6,WA27,Mineralische Brennstoffe usw.,2230356000,7987140000,10217496000
2018,6,WA28,Anorganische chemische Erzeugnisse,781310000,613532000,1394842000
2018,6,WA29,Organische chemische Erzeugnisse,2085702000,3895319000,5981021000
2018,6,WA30,Pharmazeutische Erzeugnisse,7551965000,3966943000,11518908000
2018,6,WA31,Düngemittel,162884000,75628000,238512000
2018,6,WA32,"Gerb- und Farbstoffe, Farben, Lacke usw.",1007366000,516557000,1523923000
2018,6,WA33,"Etherische Öle, Riech-, Schönheitsmittel",812638000,595039000,1407677000
2018,6,WA34,"Seifen, Waschmittel usw.",660722000,345619000,1006341000
2018,6,WA35,"Eiweißstoffe, Klebstoffe, Enzyme",293675000,174049000,467724000
2018,6,WA36,"Sprengstoffe, pyrotechnische Artikel usw.",27345000,19659000,47004000
2018,6,WA37,Photochemische Erzeugnisse,109253000,78804000,188057000
2018,6,WA38,Verschiedene Erzeugnisse der Chemischen Industrie,1917272000,1226958000,3144230000
2018,6,WA39,Kunststoffe und Waren daraus,5525324000,3610548000,9135872000
2018,6,WA40,Kautschuk und Waren daraus,1358042000,1231579000,2589621000
2018,6,WA41,"Häute, Felle, Leder",81630000,64405000,146035000
2018,6,WA42,"Lederwaren, Sattlerwaren",208293000,354441000,562734000
2018,6,WA43,"Pelzfelle, künstliches Pelzwerk",10517000,14696000,25213000
2018,6,WA44,"Holz, Holzwaren, Holzkohle",760716000,718157000,1478873000
2018,6,WA45,"Kork, Korkwaren",2782000,9095000,11877000
2018,6,WA46,"Flechtwaren, Korbmacherwaren",4099000,10034000,14133000
2018,6,WA47,"Halbstoffe aus Holz usw., Papierabfall",100853000,344704000,445557000
2018,6,WA48,"Papier, Pappe und Waren daraus",1652144000,1033348000,2685492000
2018,6,WA49,"Bücher, Zeitungen, Bilddrucke usw.",337395000,199984000,537379000
2018,6,WA50,Seide,4142000,5231000,9373000
2018,6,WA51,"Wolle, feine und grobe Tierhaare",44960000,54154000,99114000
2018,6,WA52,Baumwolle,69379000,73185000,142564000
2018,6,WA53,"Andere pflanzliche Spinnstoffe, Papiergarn",2436000,4634000,7070000
2018,6,WA54,Synthetisches oder künstliches Filament,166259000,131606000,297865000
2018,6,WA55,Synthetische oder künstliche Spinnfaser,164195000,127472000,291667000
2018,6,WA56,"Watte, Filz, Vliesstoff usw., Tauwerk",216358000,119946000,336304000
2018,6,WA57,"Teppiche, Fußbodenbelag aus Spinnstoff",46072000,81449000,127521000
2018,6,WA58,"Spezialgewebe, Spitzen, Tapisserien",47029000,21556000,68585000
2018,6,WA59,"Getränkte, bestrichene usw. Gewebe",218469000,101052000,319521000
2018,6,WA60,Gewirke und Gestricke,69727000,40864000,110591000
2018,6,WA61,"Bekleidung usw. aus Gewirken, Gestricken",723443000,1304731000,2028174000
2018,6,WA62,"Andere Bekleidung, Bekleidungszubehör",766663000,1264586000,2031249000
2018,6,WA63,"Andere Konfektion, Spinnstoffwaren usw.",227141000,337116000,564257000
2018,6,WA64,"Schuhe, Gamaschen, ähnliche Waren",665724000,939482000,1605206000
2018,6,WA65,Kopfbedeckungen und Teile davon,31221000,42535000,73756000
2018,6,WA66,"Schirme, Gehstöcke usw., Peitschen",9492000,17981000,27473000
2018,6,WA67,"Zugerichtete Federn, Daunen, künstliche Blumen",9551000,16268000,25819000
2018,6,WA68,"Waren aus Steinen, Gips, Zement usw.",445176000,292567000,737743000
2018,6,WA69,Keramische Waren,287778000,253592000,541370000
2018,6,WA70,Glas und Glaswaren,611057000,475224000,1086281000
2018,6,WA71,"Perlen, Edelsteine, Edelmetalle",948520000,1379658000,2328178000
2018,6,WA72,Eisen und Stahl,2177105000,2510527000,4687632000
2018,6,WA73,Waren aus Eisen oder Stahl,2523320000,1904018000,4427338000
2018,6,WA74,Kupfer und Waren daraus,990260000,949775000,1940035000
2018,6,WA75,Nickel und Waren daraus,111723000,152008000,263731000
2018,6,WA76,Aluminium und Waren daraus,1325470000,1524049000,2849519000
2018,6,WA78,Blei und Waren daraus,44127000,34992000,79119000
2018,6,WA79,Zink und Waren daraus,68463000,146987000,215450000
2018,6,WA80,Zinn und Waren daraus,10097000,31873000,41970000
2018,6,WA81,"Andere unedle Metalle, Cermets usw.",142344000,187668000,330012000
2018,6,WA82,"Werkzeuge, Schneidwaren, Essbestecke",726694000,445942000,1172636000
2018,6,WA83,Verschiedene Waren aus unedlen Metallen,663932000,424482000,1088414000
2018,6,WA84,"Maschinen, Apparate, mechanische Geräte",20306337000,12029592000,32335929000
2018,6,WA85,Elektrotechnische Erzeugnisse,11853218000,11296372000,23149590000
2018,6,WA86,Schienenfahrzeuge,282184000,209326000,491510000
2018,6,WA87,"Kraftfahrzeuge, Landfahrzeuge",19881421000,10645741000,30527162000
2018,6,WA88,"Luftfahrzeuge, Raumfahrzeuge",3650621000,1243380000,4894001000
2018,6,WA89,Wasserfahrzeuge,674463000,146045000,820508000
2018,6,WA90,"Optische, photografische usw. Erzeugnisse",5951248000,3114127000,9065375000
2018,6,WA91,Uhrmacherwaren,143566000,157797000,301363000
2018,6,WA92,Musikinstrumente,55130000,48537000,103667000
2018,6,WA93,Waffen und Munition,41205000,20639000,61844000
2018,6,WA94,"Möbel, Beleuchtungskörper usw.",1384836000,1557765000,2942601000
2018,6,WA95,"Spielzeug, Spiele usw., Sportgeräte",383474000,543502000,926976000
2018,6,WA96,Verschiedene Waren,345901000,248128000,594029000
2018,6,WA97,"Kunstgegenstände, Sammlungsstücke",111206000,51320000,162526000
2018,6,WA98,Vollständige Fabrikationsanlagen,187824000,1482000,189306000
2018,6,WA99,Zusammenstellungen verschiedener Waren,1473131000,1093250000,2566381000
2018,7,WA01,Lebende Tiere,121155000,135706000,256861000
2018,7,WA02,Fleisch,614456000,567004000,1181460000
2018,7,WA03,"Fische, Krebs- und Weichtiere",144227000,331093000,475320000
2018,7,WA04,"Milch, Milcherzeugnisse, Eier, Honig",756477000,666053000,1422530000
2018,7,WA05,Andere Waren tierischen Ursprungs,72774000,90701000,163475000
2018,7,WA06,"Pflanzen, Waren des Blumenhandels",53409000,184824000,238233000
2018,7,WA07,"Gemüse, Pflanzen für Ernährung",81758000,464942000,546700000
2018,7,WA08,Genießbare Früchte und Nüsse,163397000,950631000,1114028000
2018,7,WA09,"Kaffee, Tee, Mate, Gewürze",230507000,323520000,554027000
2018,7,WA10,Getreide,130059000,185630000,315689000
2018,7,WA11,"Müllereierzeugnisse, Malz usw.",128683000,59831000,188514000
2018,7,WA12,"Ölsamen usw., Heilpflanzen usw.",109569000,383466000,493035000
2018,7,WA13,"Schellack, Gummen, Harz, Pflanzensaft",54335000,50672000,105007000
2018,7,WA14,Flechtstoffe usw. pflanzlichen Ursprungs,806000,4081000,4887000
2018,7,WA15,"Tierische und pflanzliche Fette, Öle, Wachs",206342000,327822000,534164000
2018,7,WA16,"Zubereitungen von Fleisch, Fisch usw.",293335000,277666000,571001000
2018,7,WA17,Zucker und Zuckerwaren,201153000,147313000,348466000
2018,7,WA18,Kakao und Zubereitungen aus Kakao,387829000,355122000,742951000
2018,7,WA19,"Zubereitungen aus Getreide usw., Backwaren",549719000,391044000,940763000
2018,7,WA20,"Zubereitungen von Gemüse, Früchten usw.",256023000,448626000,704649000
2018,7,WA21,Verschiedene Lebensmittelzubereitungen,487981000,307962000,795943000
2018,7,WA22,"Getränke, alkoholhaltige Flüssigkeiten, Essig",551077000,694080000,1245157000
2018,7,WA23,"Rückstände der Lebensmittelindustrie, Futter",354788000,365152000,719940000
2018,7,WA24,Tabak,319412000,209118000,528530000
2018,7,WA25,"Salz, Schwefel, Steine, Erden usw.",179230000,182309000,361539000
2018,7,WA26,"Erze, Schlacken, Aschen",34167000,723428000,757595000
2018,7,WA27,Mineralische Brennstoffe usw.,2384224000,8361201000,10745425000
2018,7,WA28,Anorganische chemische Erzeugnisse,755515000,567741000,1323256000
2018,7,WA29,Organische chemische Erzeugnisse,2138431000,3724655000,5863086000
2018,7,WA30,Pharmazeutische Erzeugnisse,7425600000,4417268000,11842868000
2018,7,WA31,Düngemittel,145572000,72726000,218298000
2018,7,WA32,"Gerb- und Farbstoffe, Farben, Lacke usw.",1005985000,524209000,1530194000
2018,7,WA33,"Etherische Öle, Riech-, Schönheitsmittel",833820000,647531000,1481351000
2018,7,WA34,"Seifen, Waschmittel usw.",669854000,360598000,1030452000
2018,7,WA35,"Eiweißstoffe, Klebstoffe, Enzyme",298442000,183108000,481550000
2018,7,WA36,"Sprengstoffe, pyrotechnische Artikel usw.",21411000,32479000,53890000
2018,7,WA37,Photochemische Erzeugnisse,112543000,82486000,195029000
2018,7,WA38,Verschiedene Erzeugnisse der Chemischen Industrie,1850170000,1224248000,3074418000
2018,7,WA39,Kunststoffe und Waren daraus,5289358000,3695694000,8985052000
2018,7,WA40,Kautschuk und Waren daraus,1273516000,1205086000,2478602000
2018,7,WA41,"Häute, Felle, Leder",75518000,59125000,134643000
2018,7,WA42,"Lederwaren, Sattlerwaren",214346000,396470000,610816000
2018,7,WA43,"Pelzfelle, künstliches Pelzwerk",10098000,14218000,24316000
2018,7,WA44,"Holz, Holzwaren, Holzkohle",743691000,705138000,1448829000
2018,7,WA45,"Kork, Korkwaren",2508000,9090000,11598000
2018,7,WA46,"Flechtwaren, Korbmacherwaren",3130000,10180000,13310000
2018,7,WA47,"Halbstoffe aus Holz usw., Papierabfall",109226000,351687000,460913000
2018,7,WA48,"Papier, Pappe und Waren daraus",1650378000,1122256000,2772634000
2018,7,WA49,"Bücher, Zeitungen, Bilddrucke usw.",340480000,226470000,566950000
2018,7,WA50,Seide,3400000,3819000,7219000
2018,7,WA51,"Wolle, feine und grobe Tierhaare",37979000,53365000,91344000
2018,7,WA52,Baumwolle,59124000,70301000,129425000
2018,7,WA53,"Andere pflanzliche Spinnstoffe, Papiergarn",2329000,5167000,7496000
2018,7,WA54,Synthetisches oder künstliches Filament,152057000,130808000,282865000
2018,7,WA55,Synthetische oder künstliche Spinnfaser,150277000,121317000,271594000
2018,7,WA56,"Watte, Filz, Vliesstoff usw., Tauwerk",208434000,138521000,346955000
2018,7,WA57,"Teppiche, Fußbodenbelag aus Spinnstoff",48308000,88465000,136773000
2018,7,WA58,"Spezialgewebe, Spitzen, Tapisserien",41486000,22508000,63994000
2018,7,WA59,"Getränkte, bestrichene usw. Gewebe",209674000,97963000,307637000
2018,7,WA60,Gewirke und Gestricke,63359000,40873000,104232000
2018,7,WA61,"Bekleidung usw. aus Gewirken, Gestricken",812137000,1664007000,2476144000
2018,7,WA62,"Andere Bekleidung, Bekleidungszubehör",862087000,1578387000,2440474000
2018,7,WA63,"Andere Konfektion, Spinnstoffwaren usw.",234757000,354701000,589458000
2018,7,WA64,"Schuhe, Gamaschen, ähnliche Waren",664955000,1044909000,1709864000
2018,7,WA65,Kopfbedeckungen und Teile davon,35880000,54142000,90022000
2018,7,WA66,"Schirme, Gehstöcke usw., Peitschen",10324000,18172000,28496000
2018,7,WA67,"Zugerichtete Federn, Daunen, künstliche Blumen",11434000,23391000,34825000
2018,7,WA68,"Waren aus Steinen, Gips, Zement usw.",433993000,312272000,746265000
2018,7,WA69,Keramische Waren,316375000,249214000,565589000
2018,7,WA70,Glas und Glaswaren,568999000,455283000,1024282000
2018,7,WA71,"Perlen, Edelsteine, Edelmetalle",986644000,1642539000,2629183000
2018,7,WA72,Eisen und Stahl,2024223000,2521232000,4545455000
2018,7,WA73,Waren aus Eisen oder Stahl,2436271000,1984948000,4421219000
2018,7,WA74,Kupfer und Waren daraus,982187000,865529000,1847716000
2018,7,WA75,Nickel und Waren daraus,112404000,127492000,239896000
2018,7,WA76,Aluminium und Waren daraus,1340000000,1527982000,2867982000
2018,7,WA78,Blei und Waren daraus,32723000,45024000,77747000
2018,7,WA79,Zink und Waren daraus,67434000,166848000,234282000
2018,7,WA80,Zinn und Waren daraus,9431000,42387000,51818000
2018,7,WA81,"Andere unedle Metalle, Cermets usw.",134936000,194224000,329160000
2018,7,WA82,"Werkzeuge, Schneidwaren, Essbestecke",761406000,470290000,1231696000
2018,7,WA83,Verschiedene Waren aus unedlen Metallen,642100000,428657000,1070757000
2018,7,WA84,"Maschinen, Apparate, mechanische Geräte",19589235000,11905692000,31494927000
2018,7,WA85,Elektrotechnische Erzeugnisse,11623312000,11239142000,22862454000
2018,7,WA86,Schienenfahrzeuge,292105000,215239000,507344000
2018,7,WA87,"Kraftfahrzeuge, Landfahrzeuge",18379469000,9108699000,27488168000
2018,7,WA88,"Luftfahrzeuge, Raumfahrzeuge",2697099000,1241275000,3938374000
2018,7,WA89,Wasserfahrzeuge,477147000,724004000,1201151000
2018,7,WA90,"Optische, photografische usw. Erzeugnisse",5686775000,3213467000,8900242000
2018,7,WA91,Uhrmacherwaren,139389000,165171000,304560000
2018,7,WA92,Musikinstrumente,42533000,47061000,89594000
2018,7,WA93,Waffen und Munition,35758000,19947000,55705000
2018,7,WA94,"Möbel, Beleuchtungskörper usw.",1310811000,1473741000,2784552000
2018,7,WA95,"Spielzeug, Spiele usw., Sportgeräte",401857000,574383000,976240000
2018,7,WA96,Verschiedene Waren,338723000,252541000,591264000
2018,7,WA97,"Kunstgegenstände, Sammlungsstücke",50349000,44903000,95252000
2018,7,WA98,Vollständige Fabrikationsanlagen,113831000,6259000,120090000
2018,7,WA99,Zusammenstellungen verschiedener Waren,1486650000,1004471000,2491121000
2018,8,WA01,Lebende Tiere,113077000,130785000,243862000
2018,8,WA02,Fleisch,583753000,539404000,1123157000
2018,8,WA03,"Fische, Krebs- und Weichtiere",121944000,321509000,443453000
2018,8,WA04,"Milch, Milcherzeugnisse, Eier, Honig",756829000,706282000,1463111000
2018,8,WA05,Andere Waren tierischen Ursprungs,78652000,79592000,158244000
2018,8,WA06,"Pflanzen, Waren des Blumenhandels",65684000,180786000,246470000
2018,8,WA07,"Gemüse, Pflanzen für Ernährung",91713000,388401000,480114000
2018,8,WA08,Genießbare Früchte und Nüsse,158133000,873737000,1031870000
2018,8,WA09,"Kaffee, Tee, Mate, Gewürze",227801000,335635000,563436000
2018,8,WA10,Getreide,133338000,224125000,357463000
2018,8,WA11,"Müllereierzeugnisse, Malz usw.",127271000,59539000,186810000
2018,8,WA12,"Ölsamen usw., Heilpflanzen usw.",109384000,543232000,652616000
2018,8,WA13,"Schellack, Gummen, Harz, Pflanzensaft",51020000,37207000,88227000
2018,8,WA14,Flechtstoffe usw. pflanzlichen Ursprungs,629000,3392000,4021000
2018,8,WA15,"Tierische und pflanzliche Fette, Öle, Wachs",189912000,265368000,455280000
2018,8,WA16,"Zubereitungen von Fleisch, Fisch usw.",259040000,268033000,527073000
2018,8,WA17,Zucker und Zuckerwaren,194007000,130968000,324975000
2018,8,WA18,Kakao und Zubereitungen aus Kakao,488270000,381290000,869560000
2018,8,WA19,"Zubereitungen aus Getreide usw., Backwaren",571678000,350381000,922059000
2018,8,WA20,"Zubereitungen von Gemüse, Früchten usw.",258506000,421334000,679840000
2018,8,WA21,Verschiedene Lebensmittelzubereitungen,489677000,293819000,783496000
2018,8,WA22,"Getränke, alkoholhaltige Flüssigkeiten, Essig",549979000,605881000,1155860000
2018,8,WA23,"Rückstände der Lebensmittelindustrie, Futter",358679000,328442000,687121000
2018,8,WA24,Tabak,312900000,208649000,521549000
2018,8,WA25,"Salz, Schwefel, Steine, Erden usw.",152881000,185408000,338289000
2018,8,WA26,"Erze, Schlacken, Aschen",39522000,497395000,536917000
2018,8,WA27,Mineralische Brennstoffe usw.,2312088000,8262019000,10574107000
2018,8,WA28,Anorganische chemische Erzeugnisse,795533000,512341000,1307874000
2018,8,WA29,Organische chemische Erzeugnisse,2161853000,3479968000,5641821000
2018,8,WA30,Pharmazeutische Erzeugnisse,7381797000,4302266000,11684063000
2018,8,WA31,Düngemittel,166500000,58816000,225316000
2018,8,WA32,"Gerb- und Farbstoffe, Farben, Lacke usw.",922016000,496340000,1418356000
2018,8,WA33,"Etherische Öle, Riech-, Schönheitsmittel",862108000,659644000,1521752000
2018,8,WA34,"Seifen, Waschmittel usw.",654602000,358829000,1013431000
2018,8,WA35,"Eiweißstoffe, Klebstoffe, Enzyme",308435000,174279000,482714000
2018,8,WA36,"Sprengstoffe, pyrotechnische Artikel usw.",25283000,29318000,54601000
2018,8,WA37,Photochemische Erzeugnisse,107335000,68953000,176288000
2018,8,WA38,Verschiedene Erzeugnisse der Chemischen Industrie,1816857000,1140371000,2957228000
2018,8,WA39,Kunststoffe und Waren daraus,5031879000,3476972000,8508851000
2018,8,WA40,Kautschuk und Waren daraus,1235164000,1214954000,2450118000
2018,8,WA41,"Häute, Felle, Leder",55988000,50481000,106469000
2018,8,WA42,"Lederwaren, Sattlerwaren",214034000,358836000,572870000
2018,8,WA43,"Pelzfelle, künstliches Pelzwerk",13003000,13018000,26021000
2018,8,WA44,"Holz, Holzwaren, Holzkohle",658928000,673051000,1331979000
2018,8,WA45,"Kork, Korkwaren",3028000,9238000,12266000
2018,8,WA46,"Flechtwaren, Korbmacherwaren",3629000,7894000,11523000
2018,8,WA47,"Halbstoffe aus Holz usw., Papierabfall",101392000,389618000,491010000
2018,8,WA48,"Papier, Pappe und Waren daraus",1567551000,1102760000,2670311000
2018,8,WA49,"Bücher, Zeitungen, Bilddrucke usw.",412222000,231664000,643886000
2018,8,WA50,Seide,1595000,3372000,4967000
2018,8,WA51,"Wolle, feine und grobe Tierhaare",34639000,46163000,80802000
2018,8,WA52,Baumwolle,53490000,61691000,115181000
2018,8,WA53,"Andere pflanzliche Spinnstoffe, Papiergarn",2235000,4928000,7163000
2018,8,WA54,Synthetisches oder künstliches Filament,137474000,116529000,254003000
2018,8,WA55,Synthetische oder künstliche Spinnfaser,133011000,125511000,258522000
2018,8,WA56,"Watte, Filz, Vliesstoff usw., Tauwerk",195218000,120048000,315266000
2018,8,WA57,"Teppiche, Fußbodenbelag aus Spinnstoff",43194000,83387000,126581000
2018,8,WA58,"Spezialgewebe, Spitzen, Tapisserien",39874000,18463000,58337000
2018,8,WA59,"Getränkte, bestrichene usw. Gewebe",197218000,90542000,287760000
2018,8,WA60,Gewirke und Gestricke,51009000,27033000,78042000
2018,8,WA61,"Bekleidung usw. aus Gewirken, Gestricken",873865000,1712790000,2586655000
2018,8,WA62,"Andere Bekleidung, Bekleidungszubehör",967241000,1636854000,2604095000
2018,8,WA63,"Andere Konfektion, Spinnstoffwaren usw.",232989000,349395000,582384000
2018,8,WA64,"Schuhe, Gamaschen, ähnliche Waren",702160000,1048164000,1750324000
2018,8,WA65,Kopfbedeckungen und Teile davon,37361000,61301000,98662000
2018,8,WA66,"Schirme, Gehstöcke usw., Peitschen",8084000,15684000,23768000
2018,8,WA67,"Zugerichtete Federn, Daunen, künstliche Blumen",12139000,23287000,35426000
2018,8,WA68,"Waren aus Steinen, Gips, Zement usw.",390272000,276823000,667095000
2018,8,WA69,Keramische Waren,282750000,233616000,516366000
2018,8,WA70,Glas und Glaswaren,569147000,429491000,998638000
2018,8,WA71,"Perlen, Edelsteine, Edelmetalle",1044234000,1310923000,2355157000
2018,8,WA72,Eisen und Stahl,1963327000,2185692000,4149019000
2018,8,WA73,Waren aus Eisen oder Stahl,2332452000,1763816000,4096268000
2018,8,WA74,Kupfer und Waren daraus,883828000,783822000,1667650000
2018,8,WA75,Nickel und Waren daraus,99229000,122740000,221969000
2018,8,WA76,Aluminium und Waren daraus,1231851000,1373083000,2604934000
2018,8,WA78,Blei und Waren daraus,36384000,40853000,77237000
2018,8,WA79,Zink und Waren daraus,57015000,128306000,185321000
2018,8,WA80,Zinn und Waren daraus,8294000,42939000,51233000
2018,8,WA81,"Andere unedle Metalle, Cermets usw.",130781000,172373000,303154000
2018,8,WA82,"Werkzeuge, Schneidwaren, Essbestecke",697791000,448783000,1146574000
2018,8,WA83,Verschiedene Waren aus unedlen Metallen,633552000,380982000,1014534000
2018,8,WA84,"Maschinen, Apparate, mechanische Geräte",18929291000,10910280000,29839571000
2018,8,WA85,Elektrotechnische Erzeugnisse,11378135000,10756796000,22134931000
2018,8,WA86,Schienenfahrzeuge,277519000,234329000,511848000
2018,8,WA87,"Kraftfahrzeuge, Landfahrzeuge",15280937000,7688852000,22969789000
2018,8,WA88,"Luftfahrzeuge, Raumfahrzeuge",2067524000,794336000,2861860000
2018,8,WA89,Wasserfahrzeuge,740824000,140533000,881357000
2018,8,WA90,"Optische, photografische usw. Erzeugnisse",5464623000,2987649000,8452272000
2018,8,WA91,Uhrmacherwaren,130904000,150157000,281061000
2018,8,WA92,Musikinstrumente,45115000,49213000,94328000
2018,8,WA93,Waffen und Munition,41403000,17218000,58621000
2018,8,WA94,"Möbel, Beleuchtungskörper usw.",1267703000,1410486000,2678189000
2018,8,WA95,"Spielzeug, Spiele usw., Sportgeräte",427332000,613014000,1040346000
2018,8,WA96,Verschiedene Waren,319453000,230998000,550451000
2018,8,WA97,"Kunstgegenstände, Sammlungsstücke",38496000,36318000,74814000
2018,8,WA98,Vollständige Fabrikationsanlagen,95940000,48000,95988000
2018,8,WA99,Zusammenstellungen verschiedener Waren,1498702000,1055092000,2553794000
2018,9,WA01,Lebende Tiere,118061000,118031000,236092000
2018,9,WA02,Fleisch,622297000,553548000,1175845000
2018,9,WA03,"Fische, Krebs- und Weichtiere",117728000,324411000,442139000
2018,9,WA04,"Milch, Milcherzeugnisse, Eier, Honig",718026000,665944000,1383970000
2018,9,WA05,Andere Waren tierischen Ursprungs,82011000,76541000,158552000
2018,9,WA06,"Pflanzen, Waren des Blumenhandels",78281000,201627000,279908000
2018,9,WA07,"Gemüse, Pflanzen für Ernährung",93462000,416583000,510045000
2018,9,WA08,Genießbare Früchte und Nüsse,142835000,746869000,889704000
2018,9,WA09,"Kaffee, Tee, Mate, Gewürze",213650000,273637000,487287000
2018,9,WA10,Getreide,81939000,224099000,306038000
2018,9,WA11,"Müllereierzeugnisse, Malz usw.",117271000,51409000,168680000
2018,9,WA12,"Ölsamen usw., Heilpflanzen usw.",83250000,455924000,539174000
2018,9,WA13,"Schellack, Gummen, Harz, Pflanzensaft",48713000,43915000,92628000
2018,9,WA14,Flechtstoffe usw. pflanzlichen Ursprungs,904000,3246000,4150000
2018,9,WA15,"Tierische und pflanzliche Fette, Öle, Wachs",199748000,279881000,479629000
2018,9,WA16,"Zubereitungen von Fleisch, Fisch usw.",251285000,256770000,508055000
2018,9,WA17,Zucker und Zuckerwaren,181488000,127442000,308930000
2018,9,WA18,Kakao und Zubereitungen aus Kakao,541050000,406459000,947509000
2018,9,WA19,"Zubereitungen aus Getreide usw., Backwaren",554619000,355324000,909943000
2018,9,WA20,"Zubereitungen von Gemüse, Früchten usw.",231058000,409353000,640411000
2018,9,WA21,Verschiedene Lebensmittelzubereitungen,452381000,264665000,717046000
2018,9,WA22,"Getränke, alkoholhaltige Flüssigkeiten, Essig",499163000,607274000,1106437000
2018,9,WA23,"Rückstände der Lebensmittelindustrie, Futter",313544000,331506000,645050000
2018,9,WA24,Tabak,288280000,197977000,486257000
2018,9,WA25,"Salz, Schwefel, Steine, Erden usw.",170222000,161908000,332130000
2018,9,WA26,"Erze, Schlacken, Aschen",39630000,657167000,696797000
2018,9,WA27,Mineralische Brennstoffe usw.,2312099000,8368316000,10680415000
2018,9,WA28,Anorganische chemische Erzeugnisse,769273000,590429000,1359702000
2018,9,WA29,Organische chemische Erzeugnisse,1914121000,3912706000,5826827000
2018,9,WA30,Pharmazeutische Erzeugnisse,6981077000,3819365000,10800442000
2018,9,WA31,Düngemittel,138194000,50423000,188617000
2018,9,WA32,"Gerb- und Farbstoffe, Farben, Lacke usw.",936421000,476914000,1413335000
2018,9,WA33,"Etherische Öle, Riech-, Schönheitsmittel",778743000,614220000,1392963000
2018,9,WA34,"Seifen, Waschmittel usw.",622873000,350219000,973092000
2018,9,WA35,"Eiweißstoffe, Klebstoffe, Enzyme",301323000,173676000,474999000
2018,9,WA36,"Sprengstoffe, pyrotechnische Artikel usw.",26540000,22460000,49000000
2018,9,WA37,Photochemische Erzeugnisse,101511000,74263000,175774000
2018,9,WA38,Verschiedene Erzeugnisse der Chemischen Industrie,1762039000,1125565000,2887604000
2018,9,WA39,Kunststoffe und Waren daraus,5076221000,3381694000,8457915000
2018,9,WA40,Kautschuk und Waren daraus,1265809000,1194887000,2460696000
2018,9,WA41,"Häute, Felle, Leder",73471000,57660000,131131000
2018,9,WA42,"Lederwaren, Sattlerwaren",193850000,307249000,501099000
2018,9,WA43,"Pelzfelle, künstliches Pelzwerk",10638000,11858000,22496000
2018,9,WA44,"Holz, Holzwaren, Holzkohle",705315000,687756000,1393071000
2018,9,WA45,"Kork, Korkwaren",2080000,6780000,8860000
2018,9,WA46,"Flechtwaren, Korbmacherwaren",3204000,7547000,10751000
2018,9,WA47,"Halbstoffe aus Holz usw., Papierabfall",96711000,335642000,432353000
2018,9,WA48,"Papier, Pappe und Waren daraus",1571916000,1061747000,2633663000
2018,9,WA49,"Bücher, Zeitungen, Bilddrucke usw.",387210000,225626000,612836000
2018,9,WA50,Seide,4507000,3467000,7974000
2018,9,WA51,"Wolle, feine und grobe Tierhaare",41242000,44051000,85293000
2018,9,WA52,Baumwolle,64180000,61965000,126145000
2018,9,WA53,"Andere pflanzliche Spinnstoffe, Papiergarn",3134000,5560000,8694000
2018,9,WA54,Synthetisches oder künstliches Filament,152879000,115756000,268635000
2018,9,WA55,Synthetische oder künstliche Spinnfaser,146241000,112858000,259099000
2018,9,WA56,"Watte, Filz, Vliesstoff usw., Tauwerk",198395000,114990000,313385000
2018,9,WA57,"Teppiche, Fußbodenbelag aus Spinnstoff",43126000,83306000,126432000
2018,9,WA58,"Spezialgewebe, Spitzen, Tapisserien",42993000,20968000,63961000
2018,9,WA59,"Getränkte, bestrichene usw. Gewebe",197421000,88194000,285615000
2018,9,WA60,Gewirke und Gestricke,57711000,32625000,90336000
2018,9,WA61,"Bekleidung usw. aus Gewirken, Gestricken",868302000,1514414000,2382716000
2018,9,WA62,"Andere Bekleidung, Bekleidungszubehör",960813000,1503702000,2464515000
2018,9,WA63,"Andere Konfektion, Spinnstoffwaren usw.",218830000,312738000,531568000
2018,9,WA64,"Schuhe, Gamaschen, ähnliche Waren",656980000,920807000,1577787000
2018,9,WA65,Kopfbedeckungen und Teile davon,42645000,59252000,101897000
2018,9,WA66,"Schirme, Gehstöcke usw., Peitschen",7297000,9693000,16990000
2018,9,WA67,"Zugerichtete Federn, Daunen, künstliche Blumen",12631000,19023000,31654000
2018,9,WA68,"Waren aus Steinen, Gips, Zement usw.",401440000,287362000,688802000
2018,9,WA69,Keramische Waren,281898000,234425000,516323000
2018,9,WA70,Glas und Glaswaren,561539000,441894000,1003433000
2018,9,WA71,"Perlen, Edelsteine, Edelmetalle",1035016000,1434019000,2469035000
2018,9,WA72,Eisen und Stahl,2049423000,2232055000,4281478000
2018,9,WA73,Waren aus Eisen oder Stahl,2364854000,1882578000,4247432000
2018,9,WA74,Kupfer und Waren daraus,914885000,824362000,1739247000
2018,9,WA75,Nickel und Waren daraus,108538000,135103000,243641000
2018,9,WA76,Aluminium und Waren daraus,1234757000,1394089000,2628846000
2018,9,WA78,Blei und Waren daraus,37139000,38629000,75768000
2018,9,WA79,Zink und Waren daraus,63520000,120029000,183549000
2018,9,WA80,Zinn und Waren daraus,8184000,34581000,42765000
2018,9,WA81,"Andere unedle Metalle, Cermets usw.",125152000,158166000,283318000
2018,9,WA82,"Werkzeuge, Schneidwaren, Essbestecke",647152000,415852000,1063004000
2018,9,WA83,Verschiedene Waren aus unedlen Metallen,606556000,394533000,1001089000
2018,9,WA84,"Maschinen, Apparate, mechanische Geräte",19270026000,11860018000,31130044000
2018,9,WA85,Elektrotechnische Erzeugnisse,12006467000,11933410000,23939877000
2018,9,WA86,Schienenfahrzeuge,244950000,243008000,487958000
2018,9,WA87,"Kraftfahrzeuge, Landfahrzeuge",18100271000,9127978000,27228249000
2018,9,WA88,"Luftfahrzeuge, Raumfahrzeuge",3135512000,806879000,3942391000
2018,9,WA89,Wasserfahrzeuge,204049000,41412000,245461000
2018,9,WA90,"Optische, photografische usw. Erzeugnisse",5754179000,3129607000,8883786000
2018,9,WA91,Uhrmacherwaren,146561000,166240000,312801000
2018,9,WA92,Musikinstrumente,62327000,53324000,115651000
2018,9,WA93,Waffen und Munition,34181000,15430000,49611000
2018,9,WA94,"Möbel, Beleuchtungskörper usw.",1327891000,1471643000,2799534000
2018,9,WA95,"Spielzeug, Spiele usw., Sportgeräte",554425000,773196000,1327621000
2018,9,WA96,Verschiedene Waren,314748000,225795000,540543000
2018,9,WA97,"Kunstgegenstände, Sammlungsstücke",67943000,24352000,92295000
2018,9,WA98,Vollständige Fabrikationsanlagen,90240000,440000,90680000
2018,9,WA99,Zusammenstellungen verschiedener Waren,1398236000,978476000,2376712000
2018,10,WA01,Lebende Tiere,127069000,108828000,235897000
2018,10,WA02,Fleisch,649262000,630015000,1279277000
2018,10,WA03,"Fische, Krebs- und Weichtiere",142714000,361642000,504356000
2018,10,WA04,"Milch, Milcherzeugnisse, Eier, Honig",750570000,708373000,1458943000
2018,10,WA05,Andere Waren tierischen Ursprungs,77775000,88853000,166628000
2018,10,WA06,"Pflanzen, Waren des Blumenhandels",81762000,189535000,271297000
2018,10,WA07,"Gemüse, Pflanzen für Ernährung",90251000,435344000,525595000
2018,10,WA08,Genießbare Früchte und Nüsse,152691000,771546000,924237000
2018,10,WA09,"Kaffee, Tee, Mate, Gewürze",236962000,313151000,550113000
2018,10,WA10,Getreide,103898000,265522000,369420000
2018,10,WA11,"Müllereierzeugnisse, Malz usw.",140045000,59614000,199659000
2018,10,WA12,"Ölsamen usw., Heilpflanzen usw.",111513000,533822000,645335000
2018,10,WA13,"Schellack, Gummen, Harz, Pflanzensaft",54905000,43498000,98403000
2018,10,WA14,Flechtstoffe usw. pflanzlichen Ursprungs,770000,3411000,4181000
2018,10,WA15,"Tierische und pflanzliche Fette, Öle, Wachs",214022000,294918000,508940000
2018,10,WA16,"Zubereitungen von Fleisch, Fisch usw.",265321000,262223000,527544000
2018,10,WA17,Zucker und Zuckerwaren,213774000,134686000,348460000
2018,10,WA18,Kakao und Zubereitungen aus Kakao,596069000,433397000,1029466000
2018,10,WA19,"Zubereitungen aus Getreide usw., Backwaren",590627000,372512000,963139000
2018,10,WA20,"Zubereitungen von Gemüse, Früchten usw.",255757000,443681000,699438000
2018,10,WA21,Verschiedene Lebensmittelzubereitungen,487573000,295614000,783187000
2018,10,WA22,"Getränke, alkoholhaltige Flüssigkeiten, Essig",505761000,666595000,1172356000
2018,10,WA23,"Rückstände der Lebensmittelindustrie, Futter",394406000,337717000,732123000
2018,10,WA24,Tabak,284762000,230992000,515754000
2018,10,WA25,"Salz, Schwefel, Steine, Erden usw.",181889000,169301000,351190000
2018,10,WA26,"Erze, Schlacken, Aschen",55611000,682790000,738401000
2018,10,WA27,Mineralische Brennstoffe usw.,2508540000,9060091000,11568631000
2018,10,WA28,Anorganische chemische Erzeugnisse,807226000,627536000,1434762000
2018,10,WA29,Organische chemische Erzeugnisse,2071781000,2736902000,4808683000
2018,10,WA30,Pharmazeutische Erzeugnisse,6593373000,4370576000,10963949000
2018,10,WA31,Düngemittel,230115000,75446000,305561000
2018,10,WA32,"Gerb- und Farbstoffe, Farben, Lacke usw.",1023039000,544299000,1567338000
2018,10,WA33,"Etherische Öle, Riech-, Schönheitsmittel",917216000,687882000,1605098000
2018,10,WA34,"Seifen, Waschmittel usw.",673248000,412098000,1085346000
2018,10,WA35,"Eiweißstoffe, Klebstoffe, Enzyme",309473000,174250000,483723000
2018,10,WA36,"Sprengstoffe, pyrotechnische Artikel usw.",26907000,23219000,50126000
2018,10,WA37,Photochemische Erzeugnisse,116947000,79892000,196839000
2018,10,WA38,Verschiedene Erzeugnisse der Chemischen Industrie,2027732000,1221825000,3249557000
2018,10,WA39,Kunststoffe und Waren daraus,5484780000,3601646000,9086426000
2018,10,WA40,Kautschuk und Waren daraus,1389107000,1314261000,2703368000
2018,10,WA41,"Häute, Felle, Leder",82878000,65949000,148827000
2018,10,WA42,"Lederwaren, Sattlerwaren",210769000,370417000,581186000
2018,10,WA43,"Pelzfelle, künstliches Pelzwerk",10641000,14292000,24933000
2018,10,WA44,"Holz, Holzwaren, Holzkohle",764321000,738689000,1503010000
2018,10,WA45,"Kork, Korkwaren",2418000,8752000,11170000
2018,10,WA46,"Flechtwaren, Korbmacherwaren",3724000,7985000,11709000
2018,10,WA47,"Halbstoffe aus Holz usw., Papierabfall",108345000,377467000,485812000
2018,10,WA48,"Papier, Pappe und Waren daraus",1670567000,1129928000,2800495000
2018,10,WA49,"Bücher, Zeitungen, Bilddrucke usw.",435333000,265189000,700522000
2018,10,WA50,Seide,3746000,3219000,6965000
2018,10,WA51,"Wolle, feine und grobe Tierhaare",36623000,52690000,89313000
2018,10,WA52,Baumwolle,74039000,81815000,155854000
2018,10,WA53,"Andere pflanzliche Spinnstoffe, Papiergarn",4239000,6632000,10871000
2018,10,WA54,Synthetisches oder künstliches Filament,165255000,138317000,303572000
2018,10,WA55,Synthetische oder künstliche Spinnfaser,153095000,130384000,283479000
2018,10,WA56,"Watte, Filz, Vliesstoff usw., Tauwerk",214908000,131978000,346886000
2018,10,WA57,"Teppiche, Fußbodenbelag aus Spinnstoff",46961000,94046000,141007000
2018,10,WA58,"Spezialgewebe, Spitzen, Tapisserien",49158000,24169000,73327000
2018,10,WA59,"Getränkte, bestrichene usw. Gewebe",225546000,101677000,327223000
2018,10,WA60,Gewirke und Gestricke,64664000,39447000,104111000
2018,10,WA61,"Bekleidung usw. aus Gewirken, Gestricken",889421000,1663419000,2552840000
2018,10,WA62,"Andere Bekleidung, Bekleidungszubehör",977239000,1505431000,2482670000
2018,10,WA63,"Andere Konfektion, Spinnstoffwaren usw.",241173000,345097000,586270000
2018,10,WA64,"Schuhe, Gamaschen, ähnliche Waren",592481000,953892000,1546373000
2018,10,WA65,Kopfbedeckungen und Teile davon,42871000,63861000,106732000
2018,10,WA66,"Schirme, Gehstöcke usw., Peitschen",5467000,12455000,17922000
2018,10,WA67,"Zugerichtete Federn, Daunen, künstliche Blumen",14552000,18418000,32970000
2018,10,WA68,"Waren aus Steinen, Gips, Zement usw.",446359000,303018000,749377000
2018,10,WA69,Keramische Waren,336334000,269725000,606059000
2018,10,WA70,Glas und Glaswaren,617314000,458804000,1076118000
2018,10,WA71,"Perlen, Edelsteine, Edelmetalle",1266838000,1685435000,2952273000
2018,10,WA72,Eisen und Stahl,2229781000,2432190000,4661971000
2018,10,WA73,Waren aus Eisen oder Stahl,2526930000,1934673000,4461603000
2018,10,WA74,Kupfer und Waren daraus,1007774000,836758000,1844532000
2018,10,WA75,Nickel und Waren daraus,109473000,150047000,259520000
2018,10,WA76,Aluminium und Waren daraus,1348947000,1487845000,2836792000
2018,10,WA78,Blei und Waren daraus,36886000,43677000,80563000
2018,10,WA79,Zink und Waren daraus,70310000,128373000,198683000
2018,10,WA80,Zinn und Waren daraus,9463000,44111000,53574000
2018,10,WA81,"Andere unedle Metalle, Cermets usw.",137421000,167725000,305146000
2018,10,WA82,"Werkzeuge, Schneidwaren, Essbestecke",809953000,472532000,1282485000
2018,10,WA83,Verschiedene Waren aus unedlen Metallen,674825000,425294000,1100119000
2018,10,WA84,"Maschinen, Apparate, mechanische Geräte",20798153000,12959826000,33757979000
2018,10,WA85,Elektrotechnische Erzeugnisse,12942671000,12974324000,25916995000
2018,10,WA86,Schienenfahrzeuge,374545000,246833000,621378000
2018,10,WA87,"Kraftfahrzeuge, Landfahrzeuge",19507179000,10409847000,29917026000
2018,10,WA88,"Luftfahrzeuge, Raumfahrzeuge",2427753000,1048802000,3476555000
2018,10,WA89,Wasserfahrzeuge,1135974000,125141000,1261115000
2018,10,WA90,"Optische, photografische usw. Erzeugnisse",6084473000,3481655000,9566128000
2018,10,WA91,Uhrmacherwaren,159995000,180550000,340545000
2018,10,WA92,Musikinstrumente,63569000,63214000,126783000
2018,10,WA93,Waffen und Munition,44287000,19770000,64057000
2018,10,WA94,"Möbel, Beleuchtungskörper usw.",1457557000,1680409000,3137966000
2018,10,WA95,"Spielzeug, Spiele usw., Sportgeräte",659771000,961328000,1621099000
2018,10,WA96,Verschiedene Waren,340336000,253625000,593961000
2018,10,WA97,"Kunstgegenstände, Sammlungsstücke",67886000,48325000,116211000
2018,10,WA98,Vollständige Fabrikationsanlagen,91932000,313000,92245000
2018,10,WA99,Zusammenstellungen verschiedener Waren,1438471000,1137370000,2575841000
2018,11,WA01,Lebende Tiere,131696000,129053000,260749000
2018,11,WA02,Fleisch,630892000,590060000,1220952000
2018,11,WA03,"Fische, Krebs- und Weichtiere",137761000,362880000,500641000
2018,11,WA04,"Milch, Milcherzeugnisse, Eier, Honig",746777000,740959000,1487736000
2018,11,WA05,Andere Waren tierischen Ursprungs,83517000,87052000,170569000
2018,11,WA06,"Pflanzen, Waren des Blumenhandels",66399000,220204000,286603000
2018,11,WA07,"Gemüse, Pflanzen für Ernährung",112802000,480997000,593799000
2018,11,WA08,Genießbare Früchte und Nüsse,160520000,800602000,961122000
2018,11,WA09,"Kaffee, Tee, Mate, Gewürze",284220000,329075000,613295000
2018,11,WA10,Getreide,98850000,273589000,372439000
2018,11,WA11,"Müllereierzeugnisse, Malz usw.",151956000,59560000,211516000
2018,11,WA12,"Ölsamen usw., Heilpflanzen usw.",119393000,433082000,552475000
2018,11,WA13,"Schellack, Gummen, Harz, Pflanzensaft",57293000,44220000,101513000
2018,11,WA14,Flechtstoffe usw. pflanzlichen Ursprungs,824000,3611000,4435000
2018,11,WA15,"Tierische und pflanzliche Fette, Öle, Wachs",219384000,315714000,535098000
2018,11,WA16,"Zubereitungen von Fleisch, Fisch usw.",245792000,258043000,503835000
2018,11,WA17,Zucker und Zuckerwaren,210799000,127062000,337861000
2018,11,WA18,Kakao und Zubereitungen aus Kakao,525243000,401319000,926562000
2018,11,WA19,"Zubereitungen aus Getreide usw., Backwaren",566888000,363766000,930654000
2018,11,WA20,"Zubereitungen von Gemüse, Früchten usw.",249841000,428406000,678247000
2018,11,WA21,Verschiedene Lebensmittelzubereitungen,471562000,296555000,768117000
2018,11,WA22,"Getränke, alkoholhaltige Flüssigkeiten, Essig",506627000,711894000,1218521000
2018,11,WA23,"Rückstände der Lebensmittelindustrie, Futter",362951000,340698000,703649000
2018,11,WA24,Tabak,310483000,225468000,535951000
2018,11,WA25,"Salz, Schwefel, Steine, Erden usw.",178099000,173468000,351567000
2018,11,WA26,"Erze, Schlacken, Aschen",43388000,682183000,725571000
2018,11,WA27,Mineralische Brennstoffe usw.,2604152000,8622151000,11226303000
2018,11,WA28,Anorganische chemische Erzeugnisse,792096000,619056000,1411152000
2018,11,WA29,Organische chemische Erzeugnisse,2078875000,3065879000,5144754000
2018,11,WA30,Pharmazeutische Erzeugnisse,6551418000,4416890000,10968308000
2018,11,WA31,Düngemittel,203855000,82685000,286540000
2018,11,WA32,"Gerb- und Farbstoffe, Farben, Lacke usw.",985177000,500746000,1485923000
2018,11,WA33,"Etherische Öle, Riech-, Schönheitsmittel",902216000,625019000,1527235000
2018,11,WA34,"Seifen, Waschmittel usw.",658795000,372254000,1031049000
2018,11,WA35,"Eiweißstoffe, Klebstoffe, Enzyme",308219000,175530000,483749000
2018,11,WA36,"Sprengstoffe, pyrotechnische Artikel usw.",28002000,36854000,64856000
2018,11,WA37,Photochemische Erzeugnisse,84687000,84830000,169517000
2018,11,WA38,Verschiedene Erzeugnisse der Chemischen Industrie,2020904000,1141354000,3162258000
2018,11,WA39,Kunststoffe und Waren daraus,5160572000,3453004000,8613576000
2018,11,WA40,Kautschuk und Waren daraus,1338194000,1228288000,2566482000
2018,11,WA41,"Häute, Felle, Leder",70430000,56737000,127167000
2018,11,WA42,"Lederwaren, Sattlerwaren",217186000,368606000,585792000
2018,11,WA43,"Pelzfelle, künstliches Pelzwerk",8697000,11301000,19998000
2018,11,WA44,"Holz, Holzwaren, Holzkohle",737662000,675933000,1413595000
2018,11,WA45,"Kork, Korkwaren",2156000,8304000,10460000
2018,11,WA46,"Flechtwaren, Korbmacherwaren",3307000,8098000,11405000
2018,11,WA47,"Halbstoffe aus Holz usw., Papierabfall",102494000,334131000,436625000
2018,11,WA48,"Papier, Pappe und Waren daraus",1652653000,1111989000,2764642000
2018,11,WA49,"Bücher, Zeitungen, Bilddrucke usw.",417844000,263521000,681365000
2018,11,WA50,Seide,2694000,3256000,5950000
2018,11,WA51,"Wolle, feine und grobe Tierhaare",40004000,54097000,94101000
2018,11,WA52,Baumwolle,73657000,81325000,154982000
2018,11,WA53,"Andere pflanzliche Spinnstoffe, Papiergarn",4373000,7442000,11815000
2018,11,WA54,Synthetisches oder künstliches Filament,160307000,126311000,286618000
2018,11,WA55,Synthetische oder künstliche Spinnfaser,135842000,120304000,256146000
2018,11,WA56,"Watte, Filz, Vliesstoff usw., Tauwerk",207949000,123454000,331403000
2018,11,WA57,"Teppiche, Fußbodenbelag aus Spinnstoff",51908000,94962000,146870000
2018,11,WA58,"Spezialgewebe, Spitzen, Tapisserien",45555000,21494000,67049000
2018,11,WA59,"Getränkte, bestrichene usw. Gewebe",210993000,97296000,308289000
2018,11,WA60,Gewirke und Gestricke,68702000,37700000,106402000
2018,11,WA61,"Bekleidung usw. aus Gewirken, Gestricken",882366000,1551743000,2434109000
2018,11,WA62,"Andere Bekleidung, Bekleidungszubehör",885224000,1287262000,2172486000
2018,11,WA63,"Andere Konfektion, Spinnstoffwaren usw.",236360000,334988000,571348000
2018,11,WA64,"Schuhe, Gamaschen, ähnliche Waren",596369000,830999000,1427368000
2018,11,WA65,Kopfbedeckungen und Teile davon,39928000,53198000,93126000
2018,11,WA66,"Schirme, Gehstöcke usw., Peitschen",8545000,13381000,21926000
2018,11,WA67,"Zugerichtete Federn, Daunen, künstliche Blumen",12136000,19127000,31263000
2018,11,WA68,"Waren aus Steinen, Gips, Zement usw.",427448000,287787000,715235000
2018,11,WA69,Keramische Waren,316854000,237034000,553888000
2018,11,WA70,Glas und Glaswaren,611912000,453875000,1065787000
2018,11,WA71,"Perlen, Edelsteine, Edelmetalle",1063499000,1496871000,2560370000
2018,11,WA72,Eisen und Stahl,2054424000,2426509000,4480933000
2018,11,WA73,Waren aus Eisen oder Stahl,2464171000,1898568000,4362739000
2018,11,WA74,Kupfer und Waren daraus,922760000,875319000,1798079000
2018,11,WA75,Nickel und Waren daraus,115661000,128890000,244551000
2018,11,WA76,Aluminium und Waren daraus,1262229000,1395542000,2657771000
2018,11,WA78,Blei und Waren daraus,39156000,43080000,82236000
2018,11,WA79,Zink und Waren daraus,66091000,135117000,201208000
2018,11,WA80,Zinn und Waren daraus,12142000,31613000,43755000
2018,11,WA81,"Andere unedle Metalle, Cermets usw.",135226000,169969000,305195000
2018,11,WA82,"Werkzeuge, Schneidwaren, Essbestecke",754562000,459841000,1214403000
2018,11,WA83,Verschiedene Waren aus unedlen Metallen,652628000,405415000,1058043000
2018,11,WA84,"Maschinen, Apparate, mechanische Geräte",20577671000,12737172000,33314843000
2018,11,WA85,Elektrotechnische Erzeugnisse,12763485000,12608817000,25372302000
2018,11,WA86,Schienenfahrzeuge,400065000,257003000,657068000
2018,11,WA87,"Kraftfahrzeuge, Landfahrzeuge",19503905000,10132391000,29636296000
2018,11,WA88,"Luftfahrzeuge, Raumfahrzeuge",4212436000,1126129000,5338565000
2018,11,WA89,Wasserfahrzeuge,104377000,73014000,177391000
2018,11,WA90,"Optische, photografische usw. Erzeugnisse",6171558000,3425402000,9596960000
2018,11,WA91,Uhrmacherwaren,190410000,193969000,384379000
2018,11,WA92,Musikinstrumente,67592000,74066000,141658000
2018,11,WA93,Waffen und Munition,39515000,20759000,60274000
2018,11,WA94,"Möbel, Beleuchtungskörper usw.",1460794000,1589036000,3049830000
2018,11,WA95,"Spielzeug, Spiele usw., Sportgeräte",612114000,960312000,1572426000
2018,11,WA96,Verschiedene Waren,337664000,241242000,578906000
2018,11,WA97,"Kunstgegenstände, Sammlungsstücke",77917000,53545000,131462000
2018,11,WA98,Vollständige Fabrikationsanlagen,182195000,4610000,186805000
2018,11,WA99,Zusammenstellungen verschiedener Waren,1394350000,1167179000,2561529000
2018,12,WA01,Lebende Tiere,123652000,134003000,257655000
2018,12,WA02,Fleisch,585063000,565724000,1150787000
2018,12,WA03,"Fische, Krebs- und Weichtiere",136171000,326760000,462931000
2018,12,WA04,"Milch, Milcherzeugnisse, Eier, Honig",691832000,662105000,1353937000
2018,12,WA05,Andere Waren tierischen Ursprungs,65847000,72430000,138277000
2018,12,WA06,"Pflanzen, Waren des Blumenhandels",54322000,184257000,238579000
2018,12,WA07,"Gemüse, Pflanzen für Ernährung",82098000,519965000,602063000
2018,12,WA08,Genießbare Früchte und Nüsse,145960000,731483000,877443000
2018,12,WA09,"Kaffee, Tee, Mate, Gewürze",202661000,286697000,489358000
2018,12,WA10,Getreide,133572000,270410000,403982000
2018,12,WA11,"Müllereierzeugnisse, Malz usw.",116683000,52275000,168958000
2018,12,WA12,"Ölsamen usw., Heilpflanzen usw.",107544000,389156000,496700000
2018,12,WA13,"Schellack, Gummen, Harz, Pflanzensaft",43228000,50258000,93486000
2018,12,WA14,Flechtstoffe usw. pflanzlichen Ursprungs,574000,3175000,3749000
2018,12,WA15,"Tierische und pflanzliche Fette, Öle, Wachs",184169000,278597000,462766000
2018,12,WA16,"Zubereitungen von Fleisch, Fisch usw.",250283000,246203000,496486000
2018,12,WA17,Zucker und Zuckerwaren,172038000,118006000,290044000
2018,12,WA18,Kakao und Zubereitungen aus Kakao,384845000,354541000,739386000
2018,12,WA19,"Zubereitungen aus Getreide usw., Backwaren",467606000,330839000,798445000
2018,12,WA20,"Zubereitungen von Gemüse, Früchten usw.",222050000,376768000,598818000
2018,12,WA21,Verschiedene Lebensmittelzubereitungen,403920000,252500000,656420000
2018,12,WA22,"Getränke, alkoholhaltige Flüssigkeiten, Essig",399651000,577171000,976822000
2018,12,WA23,"Rückstände der Lebensmittelindustrie, Futter",333276000,333443000,666719000
2018,12,WA24,Tabak,212051000,158297000,370348000
2018,12,WA25,"Salz, Schwefel, Steine, Erden usw.",132307000,145146000,277453000
2018,12,WA26,"Erze, Schlacken, Aschen",42454000,623179000,665633000
2018,12,WA27,Mineralische Brennstoffe usw.,2322320000,8486909000,10809229000
2018,12,WA28,Anorganische chemische Erzeugnisse,675288000,509560000,1184848000
2018,12,WA29,Organische chemische Erzeugnisse,1792574000,2862035000,4654609000
2018,12,WA30,Pharmazeutische Erzeugnisse,5429942000,3847526000,9277468000
2018,12,WA31,Düngemittel,190315000,76293000,266608000
2018,12,WA32,"Gerb- und Farbstoffe, Farben, Lacke usw.",717896000,425039000,1142935000
2018,12,WA33,"Etherische Öle, Riech-, Schönheitsmittel",698615000,550822000,1249437000
2018,12,WA34,"Seifen, Waschmittel usw.",512177000,307930000,820107000
2018,12,WA35,"Eiweißstoffe, Klebstoffe, Enzyme",226361000,149414000,375775000
2018,12,WA36,"Sprengstoffe, pyrotechnische Artikel usw.",31448000,26484000,57932000
2018,12,WA37,Photochemische Erzeugnisse,110600000,70272000,180872000
2018,12,WA38,Verschiedene Erzeugnisse der Chemischen Industrie,1630610000,1029385000,2659995000
2018,12,WA39,Kunststoffe und Waren daraus,3784831000,2776127000,6560958000
2018,12,WA40,Kautschuk und Waren daraus,969225000,845671000,1814896000
2018,12,WA41,"Häute, Felle, Leder",56271000,46728000,102999000
2018,12,WA42,"Lederwaren, Sattlerwaren",177710000,313664000,491374000
2018,12,WA43,"Pelzfelle, künstliches Pelzwerk",7247000,10188000,17435000
2018,12,WA44,"Holz, Holzwaren, Holzkohle",520957000,537198000,1058155000
2018,12,WA45,"Kork, Korkwaren",2105000,8598000,10703000
2018,12,WA46,"Flechtwaren, Korbmacherwaren",2760000,7105000,9865000
2018,12,WA47,"Halbstoffe aus Holz usw., Papierabfall",98922000,339639000,438561000
2018,12,WA48,"Papier, Pappe und Waren daraus",1303680000,938451000,2242131000
2018,12,WA49,"Bücher, Zeitungen, Bilddrucke usw.",364785000,273311000,638096000
2018,12,WA50,Seide,1427000,2877000,4304000
2018,12,WA51,"Wolle, feine und grobe Tierhaare",24960000,35475000,60435000
2018,12,WA52,Baumwolle,53017000,58700000,111717000
2018,12,WA53,"Andere pflanzliche Spinnstoffe, Papiergarn",4630000,5893000,10523000
2018,12,WA54,Synthetisches oder künstliches Filament,122771000,93572000,216343000
2018,12,WA55,Synthetische oder künstliche Spinnfaser,116125000,92684000,208809000
2018,12,WA56,"Watte, Filz, Vliesstoff usw., Tauwerk",149485000,99012000,248497000
2018,12,WA57,"Teppiche, Fußbodenbelag aus Spinnstoff",36679000,84303000,120982000
2018,12,WA58,"Spezialgewebe, Spitzen, Tapisserien",32282000,16837000,49119000
2018,12,WA59,"Getränkte, bestrichene usw. Gewebe",158351000,76123000,234474000
2018,12,WA60,Gewirke und Gestricke,45699000,26220000,71919000
2018,12,WA61,"Bekleidung usw. aus Gewirken, Gestricken",697025000,1192382000,1889407000
2018,12,WA62,"Andere Bekleidung, Bekleidungszubehör",691683000,1076777000,1768460000
2018,12,WA63,"Andere Konfektion, Spinnstoffwaren usw.",195870000,271303000,467173000
2018,12,WA64,"Schuhe, Gamaschen, ähnliche Waren",460315000,742592000,1202907000
2018,12,WA65,Kopfbedeckungen und Teile davon,30444000,46527000,76971000
2018,12,WA66,"Schirme, Gehstöcke usw., Peitschen",4604000,16712000,21316000
2018,12,WA67,"Zugerichtete Federn, Daunen, künstliche Blumen",8865000,20885000,29750000
2018,12,WA68,"Waren aus Steinen, Gips, Zement usw.",300657000,221524000,522181000
2018,12,WA69,Keramische Waren,267601000,197489000,465090000
2018,12,WA70,Glas und Glaswaren,439714000,346544000,786258000
2018,12,WA71,"Perlen, Edelsteine, Edelmetalle",877998000,1272775000,2150773000
2018,12,WA72,Eisen und Stahl,1618198000,1694579000,3312777000
2018,12,WA73,Waren aus Eisen oder Stahl,1939784000,1463655000,3403439000
2018,12,WA74,Kupfer und Waren daraus,627627000,557037000,1184664000
2018,12,WA75,Nickel und Waren daraus,83216000,110927000,194143000
2018,12,WA76,Aluminium und Waren daraus,930927000,1053397000,1984324000
2018,12,WA78,Blei und Waren daraus,23597000,33038000,56635000
2018,12,WA79,Zink und Waren daraus,44628000,103569000,148197000
2018,12,WA80,Zinn und Waren daraus,7026000,25338000,32364000
2018,12,WA81,"Andere unedle Metalle, Cermets usw.",110365000,146699000,257064000
2018,12,WA82,"Werkzeuge, Schneidwaren, Essbestecke",604515000,392437000,996952000
2018,12,WA83,Verschiedene Waren aus unedlen Metallen,471546000,308842000,780388000
2018,12,WA84,"Maschinen, Apparate, mechanische Geräte",18451841000,10865044000,29316885000
2018,12,WA85,Elektrotechnische Erzeugnisse,10347828000,10193141000,20540969000
2018,12,WA86,Schienenfahrzeuge,252870000,285920000,538790000
2018,12,WA87,"Kraftfahrzeuge, Landfahrzeuge",14704361000,8121963000,22826324000
2018,12,WA88,"Luftfahrzeuge, Raumfahrzeuge",4550118000,1418472000,5968590000
2018,12,WA89,Wasserfahrzeuge,129451000,90443000,219894000
2018,12,WA90,"Optische, photografische usw. Erzeugnisse",5541017000,2970672000,8511689000
2018,12,WA91,Uhrmacherwaren,143193000,153283000,296476000
2018,12,WA92,Musikinstrumente,59385000,53830000,113215000
2018,12,WA93,Waffen und Munition,33084000,13632000,46716000
2018,12,WA94,"Möbel, Beleuchtungskörper usw.",1143115000,1345995000,2489110000
2018,12,WA95,"Spielzeug, Spiele usw., Sportgeräte",362477000,651345000,1013822000
2018,12,WA96,Verschiedene Waren,277813000,206845000,484658000
2018,12,WA97,"Kunstgegenstände, Sammlungsstücke",52690000,40636000,93326000
2018,12,WA98,Vollständige Fabrikationsanlagen,99263000,1563000,100826000
2018,12,WA99,Zusammenstellungen verschiedener Waren,1155577000,970127000,2125704000
2019,1,WA01,Lebende Tiere,104423000,128129000,232552000
2019,1,WA02,Fleisch,619854000,535110000,1154964000
2019,1,WA03,"Fische, Krebs- und Weichtiere",128374000,370909000,499283000
2019,1,WA04,"Milch, Milcherzeugnisse, Eier, Honig",794708000,682077000,1476785000
2019,1,WA05,Andere Waren tierischen Ursprungs,83003000,88537000,171540000
2019,1,WA06,"Pflanzen, Waren des Blumenhandels",47768000,204583000,252351000
2019,1,WA07,"Gemüse, Pflanzen für Ernährung",92399000,606980000,699379000
2019,1,WA08,Genießbare Früchte und Nüsse,156898000,773119000,930017000
2019,1,WA09,"Kaffee, Tee, Mate, Gewürze",231992000,352026000,584018000
2019,1,WA10,Getreide,155321000,316219000,471540000
2019,1,WA11,"Müllereierzeugnisse, Malz usw.",144471000,55047000,199518000
2019,1,WA12,"Ölsamen usw., Heilpflanzen usw.",149910000,449687000,599597000
2019,1,WA13,"Schellack, Gummen, Harz, Pflanzensaft",65337000,45912000,111249000
2019,1,WA14,Flechtstoffe usw. pflanzlichen Ursprungs,632000,3980000,4612000
2019,1,WA15,"Tierische und pflanzliche Fette, Öle, Wachs",203293000,284932000,488225000
2019,1,WA16,"Zubereitungen von Fleisch, Fisch usw.",224581000,266742000,491323000
2019,1,WA17,Zucker und Zuckerwaren,182368000,133299000,315667000
2019,1,WA18,Kakao und Zubereitungen aus Kakao,442373000,363659000,806032000
2019,1,WA19,"Zubereitungen aus Getreide usw., Backwaren",524881000,343112000,867993000
2019,1,WA20,"Zubereitungen von Gemüse, Früchten usw.",252380000,427046000,679426000
2019,1,WA21,Verschiedene Lebensmittelzubereitungen,465609000,268831000,734440000
2019,1,WA22,"Getränke, alkoholhaltige Flüssigkeiten, Essig",437571000,543476000,981047000
2019,1,WA23,"Rückstände der Lebensmittelindustrie, Futter",373458000,342183000,715641000
2019,1,WA24,Tabak,316054000,184416000,500470000
2019,1,WA25,"Salz, Schwefel, Steine, Erden usw.",157405000,164180000,321585000
2019,1,WA26,"Erze, Schlacken, Aschen",47796000,766770000,814566000
2019,1,WA27,Mineralische Brennstoffe usw.,2526867000,8284958000,10811825000
2019,1,WA28,Anorganische chemische Erzeugnisse,832184000,595774000,1427958000
2019,1,WA29,Organische chemische Erzeugnisse,2434691000,3919244000,6353935000
2019,1,WA30,Pharmazeutische Erzeugnisse,6747059000,3769881000,10516940000
2019,1,WA31,Düngemittel,178182000,106806000,284988000
2019,1,WA32,"Gerb- und Farbstoffe, Farben, Lacke usw.",1030325000,537511000,1567836000
2019,1,WA33,"Etherische Öle, Riech-, Schönheitsmittel",854093000,575102000,1429195000
2019,1,WA34,"Seifen, Waschmittel usw.",677812000,342557000,1020369000
2019,1,WA35,"Eiweißstoffe, Klebstoffe, Enzyme",306258000,184129000,490387000
2019,1,WA36,"Sprengstoffe, pyrotechnische Artikel usw.",22234000,13343000,35577000
2019,1,WA37,Photochemische Erzeugnisse,108291000,77704000,185995000
2019,1,WA38,Verschiedene Erzeugnisse der Chemischen Industrie,2168146000,1293463000,3461609000
2019,1,WA39,Kunststoffe und Waren daraus,5352662000,3439129000,8791791000
2019,1,WA40,Kautschuk und Waren daraus,1277838000,1146754000,2424592000
2019,1,WA41,"Häute, Felle, Leder",65656000,48108000,113764000
2019,1,WA42,"Lederwaren, Sattlerwaren",208435000,381115000,589550000
2019,1,WA43,"Pelzfelle, künstliches Pelzwerk",6159000,8988000,15147000
2019,1,WA44,"Holz, Holzwaren, Holzkohle",668842000,679109000,1347951000
2019,1,WA45,"Kork, Korkwaren",2640000,9867000,12507000
2019,1,WA46,"Flechtwaren, Korbmacherwaren",3604000,12107000,15711000
2019,1,WA47,"Halbstoffe aus Holz usw., Papierabfall",98759000,412624000,511383000
2019,1,WA48,"Papier, Pappe und Waren daraus",1627130000,1092811000,2719941000
2019,1,WA49,"Bücher, Zeitungen, Bilddrucke usw.",313704000,217732000,531436000
2019,1,WA50,Seide,2340000,3202000,5542000
2019,1,WA51,"Wolle, feine und grobe Tierhaare",43113000,57726000,100839000
2019,1,WA52,Baumwolle,63817000,73814000,137631000
2019,1,WA53,"Andere pflanzliche Spinnstoffe, Papiergarn",5003000,7512000,12515000
2019,1,WA54,Synthetisches oder künstliches Filament,157077000,134480000,291557000
2019,1,WA55,Synthetische oder künstliche Spinnfaser,148898000,128603000,277501000
2019,1,WA56,"Watte, Filz, Vliesstoff usw., Tauwerk",217093000,129968000,347061000
2019,1,WA57,"Teppiche, Fußbodenbelag aus Spinnstoff",44997000,96735000,141732000
2019,1,WA58,"Spezialgewebe, Spitzen, Tapisserien",45798000,22185000,67983000
2019,1,WA59,"Getränkte, bestrichene usw. Gewebe",222156000,99429000,321585000
2019,1,WA60,Gewirke und Gestricke,64117000,35108000,99225000
2019,1,WA61,"Bekleidung usw. aus Gewirken, Gestricken",864900000,1583011000,2447911000
2019,1,WA62,"Andere Bekleidung, Bekleidungszubehör",972662000,1604542000,2577204000
2019,1,WA63,"Andere Konfektion, Spinnstoffwaren usw.",214828000,367037000,581865000
2019,1,WA64,"Schuhe, Gamaschen, ähnliche Waren",701168000,1055065000,1756233000
2019,1,WA65,Kopfbedeckungen und Teile davon,41193000,66978000,108171000
2019,1,WA66,"Schirme, Gehstöcke usw., Peitschen",7308000,33090000,40398000
2019,1,WA67,"Zugerichtete Federn, Daunen, künstliche Blumen",12688000,23348000,36036000
2019,1,WA68,"Waren aus Steinen, Gips, Zement usw.",398647000,278101000,676748000
2019,1,WA69,Keramische Waren,295851000,243033000,538884000
2019,1,WA70,Glas und Glaswaren,567464000,424486000,991950000
2019,1,WA71,"Perlen, Edelsteine, Edelmetalle",1065189000,1374642000,2439831000
2019,1,WA72,Eisen und Stahl,2083871000,2291899000,4375770000
2019,1,WA73,Waren aus Eisen oder Stahl,2387562000,1829318000,4216880000
2019,1,WA74,Kupfer und Waren daraus,874448000,854998000,1729446000
2019,1,WA75,Nickel und Waren daraus,121674000,127867000,249541000
2019,1,WA76,Aluminium und Waren daraus,1270153000,1347432000,2617585000
2019,1,WA78,Blei und Waren daraus,35038000,30692000,65730000
2019,1,WA79,Zink und Waren daraus,68086000,112056000,180142000
2019,1,WA80,Zinn und Waren daraus,9265000,32214000,41479000
2019,1,WA81,"Andere unedle Metalle, Cermets usw.",150104000,186831000,336935000
2019,1,WA82,"Werkzeuge, Schneidwaren, Essbestecke",724865000,487965000,1212830000
2019,1,WA83,Verschiedene Waren aus unedlen Metallen,663875000,421745000,1085620000
2019,1,WA84,"Maschinen, Apparate, mechanische Geräte",18718583000,12532499000,31251082000
2019,1,WA85,Elektrotechnische Erzeugnisse,11923849000,11870760000,23794609000
2019,1,WA86,Schienenfahrzeuge,306754000,241098000,547852000
2019,1,WA87,"Kraftfahrzeuge, Landfahrzeuge",17680221000,9745063000,27425284000
2019,1,WA88,"Luftfahrzeuge, Raumfahrzeuge",2372534000,1402396000,3774930000
2019,1,WA89,Wasserfahrzeuge,131973000,61378000,193351000
2019,1,WA90,"Optische, photografische usw. Erzeugnisse",5641588000,3220076000,8861664000
2019,1,WA91,Uhrmacherwaren,131989000,159248000,291237000
2019,1,WA92,Musikinstrumente,49797000,54105000,103902000
2019,1,WA93,Waffen und Munition,33159000,16539000,49698000
2019,1,WA94,"Möbel, Beleuchtungskörper usw.",1267268000,1628995000,2896263000
2019,1,WA95,"Spielzeug, Spiele usw., Sportgeräte",316282000,534313000,850595000
2019,1,WA96,Verschiedene Waren,332003000,254210000,586213000
2019,1,WA97,"Kunstgegenstände, Sammlungsstücke",43549000,38361000,81910000
2019,1,WA98,Vollständige Fabrikationsanlagen,140171000,213000,140384000
2019,1,WA99,Zusammenstellungen verschiedener Waren,1350107000,1031587000,2381694000
2019,2,WA01,Lebende Tiere,117122000,143457000,260579000
2019,2,WA02,Fleisch,555636000,473039000,1028675000
2019,2,WA03,"Fische, Krebs- und Weichtiere",109150000,318051000,427201000
2019,2,WA04,"Milch, Milcherzeugnisse, Eier, Honig",728920000,644748000,1373668000
2019,2,WA05,Andere Waren tierischen Ursprungs,75684000,84096000,159780000
2019,2,WA06,"Pflanzen, Waren des Blumenhandels",73192000,273714000,346906000
2019,2,WA07,"Gemüse, Pflanzen für Ernährung",101935000,644493000,746428000
2019,2,WA08,Genießbare Früchte und Nüsse,142890000,757950000,900840000
2019,2,WA09,"Kaffee, Tee, Mate, Gewürze",216094000,300158000,516252000
2019,2,WA10,Getreide,167145000,302924000,470069000
2019,2,WA11,"Müllereierzeugnisse, Malz usw.",128250000,59803000,188053000
2019,2,WA12,"Ölsamen usw., Heilpflanzen usw.",170376000,435030000,605406000
2019,2,WA13,"Schellack, Gummen, Harz, Pflanzensaft",60031000,50438000,110469000
2019,2,WA14,Flechtstoffe usw. pflanzlichen Ursprungs,807000,4199000,5006000
2019,2,WA15,"Tierische und pflanzliche Fette, Öle, Wachs",189983000,279321000,469304000
2019,2,WA16,"Zubereitungen von Fleisch, Fisch usw.",264706000,228400000,493106000
2019,2,WA17,Zucker und Zuckerwaren,174941000,152572000,327513000
2019,2,WA18,Kakao und Zubereitungen aus Kakao,451028000,371102000,822130000
2019,2,WA19,"Zubereitungen aus Getreide usw., Backwaren",506347000,356929000,863276000
2019,2,WA20,"Zubereitungen von Gemüse, Früchten usw.",225988000,379825000,605813000
2019,2,WA21,Verschiedene Lebensmittelzubereitungen,482320000,294257000,776577000
2019,2,WA22,"Getränke, alkoholhaltige Flüssigkeiten, Essig",441420000,525953000,967373000
2019,2,WA23,"Rückstände der Lebensmittelindustrie, Futter",340093000,346226000,686319000
2019,2,WA24,Tabak,267554000,161944000,429498000
2019,2,WA25,"Salz, Schwefel, Steine, Erden usw.",165255000,154608000,319863000
2019,2,WA26,"Erze, Schlacken, Aschen",34462000,769415000,803877000
2019,2,WA27,Mineralische Brennstoffe usw.,2646731000,8720246000,11366977000
2019,2,WA28,Anorganische chemische Erzeugnisse,813923000,566105000,1380028000
2019,2,WA29,Organische chemische Erzeugnisse,2218561000,3402721000,5621282000
2019,2,WA30,Pharmazeutische Erzeugnisse,6186171000,4088981000,10275152000
2019,2,WA31,Düngemittel,217564000,95584000,313148000
2019,2,WA32,"Gerb- und Farbstoffe, Farben, Lacke usw.",938882000,547240000,1486122000
2019,2,WA33,"Etherische Öle, Riech-, Schönheitsmittel",846067000,605292000,1451359000
2019,2,WA34,"Seifen, Waschmittel usw.",623290000,330937000,954227000
2019,2,WA35,"Eiweißstoffe, Klebstoffe, Enzyme",274632000,185745000,460377000
2019,2,WA36,"Sprengstoffe, pyrotechnische Artikel usw.",21973000,11015000,32988000
2019,2,WA37,Photochemische Erzeugnisse,102499000,72608000,175107000
2019,2,WA38,Verschiedene Erzeugnisse der Chemischen Industrie,2171547000,1264232000,3435779000
2019,2,WA39,Kunststoffe und Waren daraus,5081758000,3462229000,8543987000
2019,2,WA40,Kautschuk und Waren daraus,1247962000,1168534000,2416496000
2019,2,WA41,"Häute, Felle, Leder",65689000,53816000,119505000
2019,2,WA42,"Lederwaren, Sattlerwaren",186562000,335335000,521897000
2019,2,WA43,"Pelzfelle, künstliches Pelzwerk",7046000,7292000,14338000
2019,2,WA44,"Holz, Holzwaren, Holzkohle",707228000,683518000,1390746000
2019,2,WA45,"Kork, Korkwaren",2598000,8814000,11412000
2019,2,WA46,"Flechtwaren, Korbmacherwaren",4080000,12561000,16641000
2019,2,WA47,"Halbstoffe aus Holz usw., Papierabfall",113180000,306071000,419251000
2019,2,WA48,"Papier, Pappe und Waren daraus",1525514000,992686000,2518200000
2019,2,WA49,"Bücher, Zeitungen, Bilddrucke usw.",324024000,214161000,538185000
2019,2,WA50,Seide,2596000,2300000,4896000
2019,2,WA51,"Wolle, feine und grobe Tierhaare",43042000,52179000,95221000
2019,2,WA52,Baumwolle,60941000,62027000,122968000
2019,2,WA53,"Andere pflanzliche Spinnstoffe, Papiergarn",4022000,5713000,9735000
2019,2,WA54,Synthetisches oder künstliches Filament,156327000,130964000,287291000
2019,2,WA55,Synthetische oder künstliche Spinnfaser,144577000,127375000,271952000
2019,2,WA56,"Watte, Filz, Vliesstoff usw., Tauwerk",206605000,124715000,331320000
2019,2,WA57,"Teppiche, Fußbodenbelag aus Spinnstoff",49995000,93562000,143557000
2019,2,WA58,"Spezialgewebe, Spitzen, Tapisserien",44342000,21079000,65421000
2019,2,WA59,"Getränkte, bestrichene usw. Gewebe",206354000,97983000,304337000
2019,2,WA60,Gewirke und Gestricke,58721000,34096000,92817000
2019,2,WA61,"Bekleidung usw. aus Gewirken, Gestricken",737435000,1315095000,2052530000
2019,2,WA62,"Andere Bekleidung, Bekleidungszubehör",874324000,1430648000,2304972000
2019,2,WA63,"Andere Konfektion, Spinnstoffwaren usw.",209988000,327214000,537202000
2019,2,WA64,"Schuhe, Gamaschen, ähnliche Waren",673296000,1009202000,1682498000
2019,2,WA65,Kopfbedeckungen und Teile davon,35352000,58108000,93460000
2019,2,WA66,"Schirme, Gehstöcke usw., Peitschen",8711000,32823000,41534000
2019,2,WA67,"Zugerichtete Federn, Daunen, künstliche Blumen",14303000,18800000,33103000
2019,2,WA68,"Waren aus Steinen, Gips, Zement usw.",395482000,279974000,675456000
2019,2,WA69,Keramische Waren,302497000,244127000,546624000
2019,2,WA70,Glas und Glaswaren,560529000,445735000,1006264000
2019,2,WA71,"Perlen, Edelsteine, Edelmetalle",967889000,1268150000,2236039000
2019,2,WA72,Eisen und Stahl,1872307000,2258270000,4130577000
2019,2,WA73,Waren aus Eisen oder Stahl,2388051000,1844482000,4232533000
2019,2,WA74,Kupfer und Waren daraus,999755000,800234000,1799989000
2019,2,WA75,Nickel und Waren daraus,121830000,137792000,259622000
2019,2,WA76,Aluminium und Waren daraus,1240444000,1370441000,2610885000
2019,2,WA78,Blei und Waren daraus,36878000,46902000,83780000
2019,2,WA79,Zink und Waren daraus,65616000,114554000,180170000
2019,2,WA80,Zinn und Waren daraus,9457000,33890000,43347000
2019,2,WA81,"Andere unedle Metalle, Cermets usw.",142202000,157683000,299885000
2019,2,WA82,"Werkzeuge, Schneidwaren, Essbestecke",746976000,437997000,1184973000
2019,2,WA83,Verschiedene Waren aus unedlen Metallen,615801000,409382000,1025183000
2019,2,WA84,"Maschinen, Apparate, mechanische Geräte",18955135000,11728263000,30683398000
2019,2,WA85,Elektrotechnische Erzeugnisse,11328844000,10788424000,22117268000
2019,2,WA86,Schienenfahrzeuge,306843000,249894000,556737000
2019,2,WA87,"Kraftfahrzeuge, Landfahrzeuge",19091764000,9922477000,29014241000
2019,2,WA88,"Luftfahrzeuge, Raumfahrzeuge",2874520000,1189215000,4063735000
2019,2,WA89,Wasserfahrzeuge,411616000,44231000,455847000
2019,2,WA90,"Optische, photografische usw. Erzeugnisse",5627183000,3112172000,8739355000
2019,2,WA91,Uhrmacherwaren,122245000,132112000,254357000
2019,2,WA92,Musikinstrumente,50424000,47880000,98304000
2019,2,WA93,Waffen und Munition,36667000,17921000,54588000
2019,2,WA94,"Möbel, Beleuchtungskörper usw.",1307630000,1626441000,2934071000
2019,2,WA95,"Spielzeug, Spiele usw., Sportgeräte",331428000,510486000,841914000
2019,2,WA96,Verschiedene Waren,323047000,226545000,549592000
2019,2,WA97,"Kunstgegenstände, Sammlungsstücke",39182000,34262000,73444000
2019,2,WA98,Vollständige Fabrikationsanlagen,125810000,1259000,127069000
2019,2,WA99,Zusammenstellungen verschiedener Waren,1389001000,1013787000,2402788000
2019,3,WA01,Lebende Tiere,105557000,130499000,236056000
2019,3,WA02,Fleisch,613088000,552147000,1165235000
2019,3,WA03,"Fische, Krebs- und Weichtiere",132943000,336150000,469093000
2019,3,WA04,"Milch, Milcherzeugnisse, Eier, Honig",817380000,690288000,1507668000
2019,3,WA05,Andere Waren tierischen Ursprungs,82594000,79021000,161615000
2019,3,WA06,"Pflanzen, Waren des Blumenhandels",108526000,320398000,428924000
2019,3,WA07,"Gemüse, Pflanzen für Ernährung",115019000,624674000,739693000
2019,3,WA08,Genießbare Früchte und Nüsse,150510000,746853000,897363000
2019,3,WA09,"Kaffee, Tee, Mate, Gewürze",221932000,285769000,507701000
2019,3,WA10,Getreide,153212000,269908000,423120000
2019,3,WA11,"Müllereierzeugnisse, Malz usw.",138664000,52728000,191392000
2019,3,WA12,"Ölsamen usw., Heilpflanzen usw.",165616000,457451000,623067000
2019,3,WA13,"Schellack, Gummen, Harz, Pflanzensaft",64776000,47823000,112599000
2019,3,WA14,Flechtstoffe usw. pflanzlichen Ursprungs,846000,4220000,5066000
2019,3,WA15,"Tierische und pflanzliche Fette, Öle, Wachs",216821000,293951000,510772000
2019,3,WA16,"Zubereitungen von Fleisch, Fisch usw.",244170000,228129000,472299000
2019,3,WA17,Zucker und Zuckerwaren,174864000,133350000,308214000
2019,3,WA18,Kakao und Zubereitungen aus Kakao,450761000,368681000,819442000
2019,3,WA19,"Zubereitungen aus Getreide usw., Backwaren",552975000,348381000,901356000
2019,3,WA20,"Zubereitungen von Gemüse, Früchten usw.",252518000,401864000,654382000
2019,3,WA21,Verschiedene Lebensmittelzubereitungen,536571000,312123000,848694000
2019,3,WA22,"Getränke, alkoholhaltige Flüssigkeiten, Essig",476925000,628598000,1105523000
2019,3,WA23,"Rückstände der Lebensmittelindustrie, Futter",351235000,321279000,672514000
2019,3,WA24,Tabak,316493000,211346000,527839000
2019,3,WA25,"Salz, Schwefel, Steine, Erden usw.",170904000,160152000,331056000
2019,3,WA26,"Erze, Schlacken, Aschen",42921000,670726000,713647000
2019,3,WA27,Mineralische Brennstoffe usw.,2930683000,8427003000,11357686000
2019,3,WA28,Anorganische chemische Erzeugnisse,859163000,508518000,1367681000
2019,3,WA29,Organische chemische Erzeugnisse,2243002000,2440743000,4683745000
2019,3,WA30,Pharmazeutische Erzeugnisse,6411396000,4616603000,11027999000
2019,3,WA31,Düngemittel,251434000,101396000,352830000
2019,3,WA32,"Gerb- und Farbstoffe, Farben, Lacke usw.",1039822000,526073000,1565895000
2019,3,WA33,"Etherische Öle, Riech-, Schönheitsmittel",920910000,635058000,1555968000
2019,3,WA34,"Seifen, Waschmittel usw.",681811000,360325000,1042136000
2019,3,WA35,"Eiweißstoffe, Klebstoffe, Enzyme",304442000,192579000,497021000
2019,3,WA36,"Sprengstoffe, pyrotechnische Artikel usw.",29475000,12603000,42078000
2019,3,WA37,Photochemische Erzeugnisse,110149000,78199000,188348000
2019,3,WA38,Verschiedene Erzeugnisse der Chemischen Industrie,2194627000,1324670000,3519297000
2019,3,WA39,Kunststoffe und Waren daraus,5346180000,3551744000,8897924000
2019,3,WA40,Kautschuk und Waren daraus,1332231000,1195729000,2527960000
2019,3,WA41,"Häute, Felle, Leder",69320000,51782000,121102000
2019,3,WA42,"Lederwaren, Sattlerwaren",209403000,345246000,554649000
2019,3,WA43,"Pelzfelle, künstliches Pelzwerk",11602000,12220000,23822000
2019,3,WA44,"Holz, Holzwaren, Holzkohle",741745000,705909000,1447654000
2019,3,WA45,"Kork, Korkwaren",2738000,10254000,12992000
2019,3,WA46,"Flechtwaren, Korbmacherwaren",4930000,9544000,14474000
2019,3,WA47,"Halbstoffe aus Holz usw., Papierabfall",111766000,327148000,438914000
2019,3,WA48,"Papier, Pappe und Waren daraus",1626777000,1079740000,2706517000
2019,3,WA49,"Bücher, Zeitungen, Bilddrucke usw.",358225000,219299000,577524000
2019,3,WA50,Seide,3143000,2860000,6003000
2019,3,WA51,"Wolle, feine und grobe Tierhaare",44430000,55721000,100151000
2019,3,WA52,Baumwolle,62991000,65458000,128449000
2019,3,WA53,"Andere pflanzliche Spinnstoffe, Papiergarn",3250000,5884000,9134000
2019,3,WA54,Synthetisches oder künstliches Filament,162962000,129663000,292625000
2019,3,WA55,Synthetische oder künstliche Spinnfaser,143151000,128392000,271543000
2019,3,WA56,"Watte, Filz, Vliesstoff usw., Tauwerk",225364000,129243000,354607000
2019,3,WA57,"Teppiche, Fußbodenbelag aus Spinnstoff",44195000,89924000,134119000
2019,3,WA58,"Spezialgewebe, Spitzen, Tapisserien",46041000,23249000,69290000
2019,3,WA59,"Getränkte, bestrichene usw. Gewebe",210783000,100933000,311716000
2019,3,WA60,Gewirke und Gestricke,68808000,40857000,109665000
2019,3,WA61,"Bekleidung usw. aus Gewirken, Gestricken",834580000,1321177000,2155757000
2019,3,WA62,"Andere Bekleidung, Bekleidungszubehör",1025239000,1489122000,2514361000
2019,3,WA63,"Andere Konfektion, Spinnstoffwaren usw.",227308000,311566000,538874000
2019,3,WA64,"Schuhe, Gamaschen, ähnliche Waren",756812000,1001185000,1757997000
2019,3,WA65,Kopfbedeckungen und Teile davon,43647000,57149000,100796000
2019,3,WA66,"Schirme, Gehstöcke usw., Peitschen",7583000,26393000,33976000
2019,3,WA67,"Zugerichtete Federn, Daunen, künstliche Blumen",13344000,16755000,30099000
2019,3,WA68,"Waren aus Steinen, Gips, Zement usw.",425402000,303894000,729296000
2019,3,WA69,Keramische Waren,336274000,249979000,586253000
2019,3,WA70,Glas und Glaswaren,588227000,438157000,1026384000
2019,3,WA71,"Perlen, Edelsteine, Edelmetalle",1307364000,1356571000,2663935000
2019,3,WA72,Eisen und Stahl,2238194000,2373022000,4611216000
2019,3,WA73,Waren aus Eisen oder Stahl,2584176000,1884025000,4468201000
2019,3,WA74,Kupfer und Waren daraus,940372000,900893000,1841265000
2019,3,WA75,Nickel und Waren daraus,123411000,154450000,277861000
2019,3,WA76,Aluminium und Waren daraus,1190290000,1400751000,2591041000
2019,3,WA78,Blei und Waren daraus,33679000,37942000,71621000
2019,3,WA79,Zink und Waren daraus,65731000,128025000,193756000
2019,3,WA80,Zinn und Waren daraus,8330000,44524000,52854000
2019,3,WA81,"Andere unedle Metalle, Cermets usw.",141190000,166356000,307546000
2019,3,WA82,"Werkzeuge, Schneidwaren, Essbestecke",765572000,454041000,1219613000
2019,3,WA83,Verschiedene Waren aus unedlen Metallen,656418000,422885000,1079303000
2019,3,WA84,"Maschinen, Apparate, mechanische Geräte",21104897000,12897747000,34002644000
2019,3,WA85,Elektrotechnische Erzeugnisse,12111799000,11461388000,23573187000
2019,3,WA86,Schienenfahrzeuge,321070000,271526000,592596000
2019,3,WA87,"Kraftfahrzeuge, Landfahrzeuge",19903287000,10982053000,30885340000
2019,3,WA88,"Luftfahrzeuge, Raumfahrzeuge",3144266000,1515645000,4659911000
2019,3,WA89,Wasserfahrzeuge,1787303000,910366000,2697669000
2019,3,WA90,"Optische, photografische usw. Erzeugnisse",6254336000,3399046000,9653382000
2019,3,WA91,Uhrmacherwaren,130899000,142451000,273350000
2019,3,WA92,Musikinstrumente,57667000,51542000,109209000
2019,3,WA93,Waffen und Munition,42539000,21151000,63690000
2019,3,WA94,"Möbel, Beleuchtungskörper usw.",1355580000,1640529000,2996109000
2019,3,WA95,"Spielzeug, Spiele usw., Sportgeräte",336484000,486679000,823163000
2019,3,WA96,Verschiedene Waren,338347000,232160000,570507000
2019,3,WA97,"Kunstgegenstände, Sammlungsstücke",74934000,41519000,116453000
2019,3,WA98,Vollständige Fabrikationsanlagen,137941000,6000,137947000
2019,3,WA99,Zusammenstellungen verschiedener Waren,1339843000,1068424000,2408267000
2019,4,WA01,Lebende Tiere,117748000,157373000,275121000
2019,4,WA02,Fleisch,627408000,577752000,1205160000
2019,4,WA03,"Fische, Krebs- und Weichtiere",130319000,347991000,478310000
2019,4,WA04,"Milch, Milcherzeugnisse, Eier, Honig",752069000,671742000,1423811000
2019,4,WA05,Andere Waren tierischen Ursprungs,78176000,78371000,156547000
2019,4,WA06,"Pflanzen, Waren des Blumenhandels",134230000,374121000,508351000
2019,4,WA07,"Gemüse, Pflanzen für Ernährung",96827000,645367000,742194000
2019,4,WA08,Genießbare Früchte und Nüsse,160171000,874014000,1034185000
2019,4,WA09,"Kaffee, Tee, Mate, Gewürze",222938000,316677000,539615000
2019,4,WA10,Getreide,192067000,220648000,412715000
2019,4,WA11,"Müllereierzeugnisse, Malz usw.",142656000,56694000,199350000
2019,4,WA12,"Ölsamen usw., Heilpflanzen usw.",85062000,417046000,502108000
2019,4,WA13,"Schellack, Gummen, Harz, Pflanzensaft",65477000,56072000,121549000
2019,4,WA14,Flechtstoffe usw. pflanzlichen Ursprungs,906000,4354000,5260000
2019,4,WA15,"Tierische und pflanzliche Fette, Öle, Wachs",194961000,301060000,496021000
2019,4,WA16,"Zubereitungen von Fleisch, Fisch usw.",267197000,255513000,522710000
2019,4,WA17,Zucker und Zuckerwaren,172988000,131805000,304793000
2019,4,WA18,Kakao und Zubereitungen aus Kakao,375639000,344733000,720372000
2019,4,WA19,"Zubereitungen aus Getreide usw., Backwaren",535936000,355858000,891794000
2019,4,WA20,"Zubereitungen von Gemüse, Früchten usw.",251122000,405086000,656208000
2019,4,WA21,Verschiedene Lebensmittelzubereitungen,527611000,307591000,835202000
2019,4,WA22,"Getränke, alkoholhaltige Flüssigkeiten, Essig",500933000,621912000,1122845000
2019,4,WA23,"Rückstände der Lebensmittelindustrie, Futter",340179000,307546000,647725000
2019,4,WA24,Tabak,281633000,249477000,531110000
2019,4,WA25,"Salz, Schwefel, Steine, Erden usw.",173179000,159485000,332664000
2019,4,WA26,"Erze, Schlacken, Aschen",38115000,680855000,718970000
2019,4,WA27,Mineralische Brennstoffe usw.,2534117000,8229728000,10763845000
2019,4,WA28,Anorganische chemische Erzeugnisse,850672000,612828000,1463500000
2019,4,WA29,Organische chemische Erzeugnisse,2069326000,3470421000,5539747000
2019,4,WA30,Pharmazeutische Erzeugnisse,6317323000,3890890000,10208213000
2019,4,WA31,Düngemittel,191126000,90909000,282035000
2019,4,WA32,"Gerb- und Farbstoffe, Farben, Lacke usw.",987336000,489907000,1477243000
2019,4,WA33,"Etherische Öle, Riech-, Schönheitsmittel",855580000,605190000,1460770000
2019,4,WA34,"Seifen, Waschmittel usw.",634828000,351999000,986827000
2019,4,WA35,"Eiweißstoffe, Klebstoffe, Enzyme",273445000,183636000,457081000
2019,4,WA36,"Sprengstoffe, pyrotechnische Artikel usw.",23389000,11848000,35237000
2019,4,WA37,Photochemische Erzeugnisse,105161000,66905000,172066000
2019,4,WA38,Verschiedene Erzeugnisse der Chemischen Industrie,1945324000,1257621000,3202945000
2019,4,WA39,Kunststoffe und Waren daraus,5126791000,3429748000,8556539000
2019,4,WA40,Kautschuk und Waren daraus,1251035000,1193258000,2444293000
2019,4,WA41,"Häute, Felle, Leder",62846000,58998000,121844000
2019,4,WA42,"Lederwaren, Sattlerwaren",187626000,305332000,492958000
2019,4,WA43,"Pelzfelle, künstliches Pelzwerk",5428000,6150000,11578000
2019,4,WA44,"Holz, Holzwaren, Holzkohle",741776000,686716000,1428492000
2019,4,WA45,"Kork, Korkwaren",2553000,9290000,11843000
2019,4,WA46,"Flechtwaren, Korbmacherwaren",4372000,9627000,13999000
2019,4,WA47,"Halbstoffe aus Holz usw., Papierabfall",111033000,309398000,420431000
2019,4,WA48,"Papier, Pappe und Waren daraus",1484870000,984612000,2469482000
2019,4,WA49,"Bücher, Zeitungen, Bilddrucke usw.",325375000,214697000,540072000
2019,4,WA50,Seide,2014000,2439000,4453000
2019,4,WA51,"Wolle, feine und grobe Tierhaare",43554000,53569000,97123000
2019,4,WA52,Baumwolle,63108000,68870000,131978000
2019,4,WA53,"Andere pflanzliche Spinnstoffe, Papiergarn",2969000,5380000,8349000
2019,4,WA54,Synthetisches oder künstliches Filament,153949000,135621000,289570000
2019,4,WA55,Synthetische oder künstliche Spinnfaser,142113000,129981000,272094000
2019,4,WA56,"Watte, Filz, Vliesstoff usw., Tauwerk",210349000,128419000,338768000
2019,4,WA57,"Teppiche, Fußbodenbelag aus Spinnstoff",42981000,80085000,123066000
2019,4,WA58,"Spezialgewebe, Spitzen, Tapisserien",46855000,22666000,69521000
2019,4,WA59,"Getränkte, bestrichene usw. Gewebe",200450000,93752000,294202000
2019,4,WA60,Gewirke und Gestricke,66080000,42189000,108269000
2019,4,WA61,"Bekleidung usw. aus Gewirken, Gestricken",725039000,1250023000,1975062000
2019,4,WA62,"Andere Bekleidung, Bekleidungszubehör",892084000,1324231000,2216315000
2019,4,WA63,"Andere Konfektion, Spinnstoffwaren usw.",223165000,325530000,548695000
2019,4,WA64,"Schuhe, Gamaschen, ähnliche Waren",571063000,824316000,1395379000
2019,4,WA65,Kopfbedeckungen und Teile davon,39095000,52218000,91313000
2019,4,WA66,"Schirme, Gehstöcke usw., Peitschen",9120000,27594000,36714000
2019,4,WA67,"Zugerichtete Federn, Daunen, künstliche Blumen",10792000,12491000,23283000
2019,4,WA68,"Waren aus Steinen, Gips, Zement usw.",407144000,302501000,709645000
2019,4,WA69,Keramische Waren,316318000,236316000,552634000
2019,4,WA70,Glas und Glaswaren,560656000,450382000,1011038000
2019,4,WA71,"Perlen, Edelsteine, Edelmetalle",1187381000,1314955000,2502336000
2019,4,WA72,Eisen und Stahl,1966878000,2170317000,4137195000
2019,4,WA73,Waren aus Eisen oder Stahl,2426246000,1834591000,4260837000
2019,4,WA74,Kupfer und Waren daraus,912190000,822027000,1734217000
2019,4,WA75,Nickel und Waren daraus,121383000,140118000,261501000
2019,4,WA76,Aluminium und Waren daraus,1346732000,1316129000,2662861000
2019,4,WA78,Blei und Waren daraus,35407000,38685000,74092000
2019,4,WA79,Zink und Waren daraus,78442000,131484000,209926000
2019,4,WA80,Zinn und Waren daraus,9950000,37665000,47615000
2019,4,WA81,"Andere unedle Metalle, Cermets usw.",133154000,169227000,302381000
2019,4,WA82,"Werkzeuge, Schneidwaren, Essbestecke",734347000,456352000,1190699000
2019,4,WA83,Verschiedene Waren aus unedlen Metallen,620349000,383424000,1003773000
2019,4,WA84,"Maschinen, Apparate, mechanische Geräte",19437381000,12327018000,31764399000
2019,4,WA85,Elektrotechnische Erzeugnisse,11469861000,11229622000,22699483000
2019,4,WA86,Schienenfahrzeuge,265863000,251571000,517434000
2019,4,WA87,"Kraftfahrzeuge, Landfahrzeuge",18948092000,10584108000,29532200000
2019,4,WA88,"Luftfahrzeuge, Raumfahrzeuge",3459482000,1010050000,4469532000
2019,4,WA89,Wasserfahrzeuge,143901000,97684000,241585000
2019,4,WA90,"Optische, photografische usw. Erzeugnisse",5606490000,3232551000,8839041000
2019,4,WA91,Uhrmacherwaren,133291000,158332000,291623000
2019,4,WA92,Musikinstrumente,56563000,51845000,108408000
2019,4,WA93,Waffen und Munition,37803000,22834000,60637000
2019,4,WA94,"Möbel, Beleuchtungskörper usw.",1285826000,1556883000,2842709000
2019,4,WA95,"Spielzeug, Spiele usw., Sportgeräte",333853000,470094000,803947000
2019,4,WA96,Verschiedene Waren,328840000,221454000,550294000
2019,4,WA97,"Kunstgegenstände, Sammlungsstücke",110410000,32001000,142411000
2019,4,WA98,Vollständige Fabrikationsanlagen,157109000,683000,157792000
2019,4,WA99,Zusammenstellungen verschiedener Waren,1342420000,1120161000,2462581000
2019,5,WA01,Lebende Tiere,93280000,154267000,247547000
2019,5,WA02,Fleisch,660981000,571690000,1232671000
2019,5,WA03,"Fische, Krebs- und Weichtiere",105165000,336989000,442154000
2019,5,WA04,"Milch, Milcherzeugnisse, Eier, Honig",822851000,651423000,1474274000
2019,5,WA05,Andere Waren tierischen Ursprungs,78169000,77598000,155767000
2019,5,WA06,"Pflanzen, Waren des Blumenhandels",115774000,322672000,438446000
2019,5,WA07,"Gemüse, Pflanzen für Ernährung",121434000,572322000,693756000
2019,5,WA08,Genießbare Früchte und Nüsse,147966000,844901000,992867000
2019,5,WA09,"Kaffee, Tee, Mate, Gewürze",221326000,318104000,539430000
2019,5,WA10,Getreide,137073000,212752000,349825000
2019,5,WA11,"Müllereierzeugnisse, Malz usw.",141864000,61820000,203684000
2019,5,WA12,"Ölsamen usw., Heilpflanzen usw.",91102000,445271000,536373000
2019,5,WA13,"Schellack, Gummen, Harz, Pflanzensaft",61662000,43513000,105175000
2019,5,WA14,Flechtstoffe usw. pflanzlichen Ursprungs,655000,3901000,4556000
2019,5,WA15,"Tierische und pflanzliche Fette, Öle, Wachs",212199000,276805000,489004000
2019,5,WA16,"Zubereitungen von Fleisch, Fisch usw.",219556000,234059000,453615000
2019,5,WA17,Zucker und Zuckerwaren,186875000,127379000,314254000
2019,5,WA18,Kakao und Zubereitungen aus Kakao,381021000,360352000,741373000
2019,5,WA19,"Zubereitungen aus Getreide usw., Backwaren",540175000,353905000,894080000
2019,5,WA20,"Zubereitungen von Gemüse, Früchten usw.",257893000,414627000,672520000
2019,5,WA21,Verschiedene Lebensmittelzubereitungen,493513000,291218000,784731000
2019,5,WA22,"Getränke, alkoholhaltige Flüssigkeiten, Essig",540259000,623837000,1164096000
2019,5,WA23,"Rückstände der Lebensmittelindustrie, Futter",330781000,318415000,649196000
2019,5,WA24,Tabak,262856000,220296000,483152000
2019,5,WA25,"Salz, Schwefel, Steine, Erden usw.",182024000,179428000,361452000
2019,5,WA26,"Erze, Schlacken, Aschen",45870000,744970000,790840000
2019,5,WA27,Mineralische Brennstoffe usw.,2700635000,8357581000,11058216000
2019,5,WA28,Anorganische chemische Erzeugnisse,882271000,585107000,1467378000
2019,5,WA29,Organische chemische Erzeugnisse,2163306000,3684054000,5847360000
2019,5,WA30,Pharmazeutische Erzeugnisse,6634334000,4189212000,10823546000
2019,5,WA31,Düngemittel,178255000,107394000,285649000
2019,5,WA32,"Gerb- und Farbstoffe, Farben, Lacke usw.",1009516000,521530000,1531046000
2019,5,WA33,"Etherische Öle, Riech-, Schönheitsmittel",883153000,621287000,1504440000
2019,5,WA34,"Seifen, Waschmittel usw.",660673000,368491000,1029164000
2019,5,WA35,"Eiweißstoffe, Klebstoffe, Enzyme",318593000,191971000,510564000
2019,5,WA36,"Sprengstoffe, pyrotechnische Artikel usw.",23230000,16905000,40135000
2019,5,WA37,Photochemische Erzeugnisse,103114000,72745000,175859000
2019,5,WA38,Verschiedene Erzeugnisse der Chemischen Industrie,1966823000,1195693000,3162516000
2019,5,WA39,Kunststoffe und Waren daraus,5318580000,3523345000,8841925000
2019,5,WA40,Kautschuk und Waren daraus,1264777000,1172357000,2437134000
2019,5,WA41,"Häute, Felle, Leder",60099000,53136000,113235000
2019,5,WA42,"Lederwaren, Sattlerwaren",190681000,349296000,539977000
2019,5,WA43,"Pelzfelle, künstliches Pelzwerk",11380000,12937000,24317000
2019,5,WA44,"Holz, Holzwaren, Holzkohle",742157000,676241000,1418398000
2019,5,WA45,"Kork, Korkwaren",2678000,8885000,11563000
2019,5,WA46,"Flechtwaren, Korbmacherwaren",4787000,9994000,14781000
2019,5,WA47,"Halbstoffe aus Holz usw., Papierabfall",98773000,320526000,419299000
2019,5,WA48,"Papier, Pappe und Waren daraus",1606942000,1009214000,2616156000
2019,5,WA49,"Bücher, Zeitungen, Bilddrucke usw.",315535000,213097000,528632000
2019,5,WA50,Seide,2326000,4193000,6519000
2019,5,WA51,"Wolle, feine und grobe Tierhaare",46825000,59270000,106095000
2019,5,WA52,Baumwolle,68041000,65680000,133721000
2019,5,WA53,"Andere pflanzliche Spinnstoffe, Papiergarn",2573000,4947000,7520000
2019,5,WA54,Synthetisches oder künstliches Filament,162435000,131855000,294290000
2019,5,WA55,Synthetische oder künstliche Spinnfaser,140180000,126327000,266507000
2019,5,WA56,"Watte, Filz, Vliesstoff usw., Tauwerk",220152000,132530000,352682000
2019,5,WA57,"Teppiche, Fußbodenbelag aus Spinnstoff",45834000,87202000,133036000
2019,5,WA58,"Spezialgewebe, Spitzen, Tapisserien",46458000,22520000,68978000
2019,5,WA59,"Getränkte, bestrichene usw. Gewebe",213114000,96911000,310025000
2019,5,WA60,Gewirke und Gestricke,70836000,42583000,113419000
2019,5,WA61,"Bekleidung usw. aus Gewirken, Gestricken",745617000,1228111000,1973728000
2019,5,WA62,"Andere Bekleidung, Bekleidungszubehör",850110000,1266306000,2116416000
2019,5,WA63,"Andere Konfektion, Spinnstoffwaren usw.",243509000,362225000,605734000
2019,5,WA64,"Schuhe, Gamaschen, ähnliche Waren",601154000,804174000,1405328000
2019,5,WA65,Kopfbedeckungen und Teile davon,36827000,47499000,84326000
2019,5,WA66,"Schirme, Gehstöcke usw., Peitschen",9170000,24117000,33287000
2019,5,WA67,"Zugerichtete Federn, Daunen, künstliche Blumen",10640000,14833000,25473000
2019,5,WA68,"Waren aus Steinen, Gips, Zement usw.",406503000,303220000,709723000
2019,5,WA69,Keramische Waren,315215000,254731000,569946000
2019,5,WA70,Glas und Glaswaren,577958000,455783000,1033741000
2019,5,WA71,"Perlen, Edelsteine, Edelmetalle",1189294000,1326856000,2516150000
2019,5,WA72,Eisen und Stahl,2248942000,2172776000,4421718000
2019,5,WA73,Waren aus Eisen oder Stahl,2406857000,1844727000,4251584000
2019,5,WA74,Kupfer und Waren daraus,887761000,798405000,1686166000
2019,5,WA75,Nickel und Waren daraus,121025000,138684000,259709000
2019,5,WA76,Aluminium und Waren daraus,1310179000,1371017000,2681196000
2019,5,WA78,Blei und Waren daraus,33132000,39299000,72431000
2019,5,WA79,Zink und Waren daraus,78918000,126689000,205607000
2019,5,WA80,Zinn und Waren daraus,8345000,37347000,45692000
2019,5,WA81,"Andere unedle Metalle, Cermets usw.",141050000,156555000,297605000
2019,5,WA82,"Werkzeuge, Schneidwaren, Essbestecke",725075000,454152000,1179227000
2019,5,WA83,Verschiedene Waren aus unedlen Metallen,642070000,412340000,1054410000
2019,5,WA84,"Maschinen, Apparate, mechanische Geräte",20377008000,11939109000,32316117000
2019,5,WA85,Elektrotechnische Erzeugnisse,11853052000,11026605000,22879657000
2019,5,WA86,Schienenfahrzeuge,297488000,279116000,576604000
2019,5,WA87,"Kraftfahrzeuge, Landfahrzeuge",19975060000,11163247000,31138307000
2019,5,WA88,"Luftfahrzeuge, Raumfahrzeuge",3178020000,1616145000,4794165000
2019,5,WA89,Wasserfahrzeuge,459164000,96628000,555792000
2019,5,WA90,"Optische, photografische usw. Erzeugnisse",6017510000,3172829000,9190339000
2019,5,WA91,Uhrmacherwaren,133401000,163215000,296616000
2019,5,WA92,Musikinstrumente,58674000,51566000,110240000
2019,5,WA93,Waffen und Munition,42302000,22608000,64910000
2019,5,WA94,"Möbel, Beleuchtungskörper usw.",1386197000,1589910000,2976107000
2019,5,WA95,"Spielzeug, Spiele usw., Sportgeräte",325912000,545957000,871869000
2019,5,WA96,Verschiedene Waren,343036000,237759000,580795000
2019,5,WA97,"Kunstgegenstände, Sammlungsstücke",74182000,29878000,104060000
2019,5,WA98,Vollständige Fabrikationsanlagen,145949000,0,145949000
2019,5,WA99,Zusammenstellungen verschiedener Waren,1381099000,1127267000,2508366000
2019,6,WA01,Lebende Tiere,130560000,171327000,301887000
2019,6,WA02,Fleisch,608267000,590171000,1198438000
2019,6,WA03,"Fische, Krebs- und Weichtiere",118103000,333229000,451332000
2019,6,WA04,"Milch, Milcherzeugnisse, Eier, Honig",764256000,645319000,1409575000
2019,6,WA05,Andere Waren tierischen Ursprungs,72668000,83749000,156417000
2019,6,WA06,"Pflanzen, Waren des Blumenhandels",62355000,224122000,286477000
2019,6,WA07,"Gemüse, Pflanzen für Ernährung",99305000,548785000,648090000
2019,6,WA08,Genießbare Früchte und Nüsse,168414000,929714000,1098128000
2019,6,WA09,"Kaffee, Tee, Mate, Gewürze",217565000,306712000,524277000
2019,6,WA10,Getreide,149864000,221123000,370987000
2019,6,WA11,"Müllereierzeugnisse, Malz usw.",141355000,54227000,195582000
2019,6,WA12,"Ölsamen usw., Heilpflanzen usw.",84846000,364093000,448939000
2019,6,WA13,"Schellack, Gummen, Harz, Pflanzensaft",53652000,43007000,96659000
2019,6,WA14,Flechtstoffe usw. pflanzlichen Ursprungs,659000,3965000,4624000
2019,6,WA15,"Tierische und pflanzliche Fette, Öle, Wachs",202334000,296189000,498523000
2019,6,WA16,"Zubereitungen von Fleisch, Fisch usw.",285467000,252447000,537914000
2019,6,WA17,Zucker und Zuckerwaren,186360000,126022000,312382000
2019,6,WA18,Kakao und Zubereitungen aus Kakao,347956000,326635000,674591000
2019,6,WA19,"Zubereitungen aus Getreide usw., Backwaren",504999000,349759000,854758000
2019,6,WA20,"Zubereitungen von Gemüse, Früchten usw.",235671000,398736000,634407000
2019,6,WA21,Verschiedene Lebensmittelzubereitungen,520958000,302997000,823955000
2019,6,WA22,"Getränke, alkoholhaltige Flüssigkeiten, Essig",522380000,632991000,1155371000
2019,6,WA23,"Rückstände der Lebensmittelindustrie, Futter",350745000,328103000,678848000
2019,6,WA24,Tabak,262900000,191974000,454874000
2019,6,WA25,"Salz, Schwefel, Steine, Erden usw.",163984000,173406000,337390000
2019,6,WA26,"Erze, Schlacken, Aschen",49171000,810464000,859635000
2019,6,WA27,Mineralische Brennstoffe usw.,2148631000,8084994000,10233625000
2019,6,WA28,Anorganische chemische Erzeugnisse,787137000,568887000,1356024000
2019,6,WA29,Organische chemische Erzeugnisse,2026275000,3013872000,5040147000
2019,6,WA30,Pharmazeutische Erzeugnisse,6920568000,4392531000,11313099000
2019,6,WA31,Düngemittel,157629000,86839000,244468000
2019,6,WA32,"Gerb- und Farbstoffe, Farben, Lacke usw.",910470000,461958000,1372428000
2019,6,WA33,"Etherische Öle, Riech-, Schönheitsmittel",801037000,546675000,1347712000
2019,6,WA34,"Seifen, Waschmittel usw.",602172000,344354000,946526000
2019,6,WA35,"Eiweißstoffe, Klebstoffe, Enzyme",295059000,177169000,472228000
2019,6,WA36,"Sprengstoffe, pyrotechnische Artikel usw.",23572000,23958000,47530000
2019,6,WA37,Photochemische Erzeugnisse,95773000,73227000,169000000
2019,6,WA38,Verschiedene Erzeugnisse der Chemischen Industrie,1798981000,1127073000,2926054000
2019,6,WA39,Kunststoffe und Waren daraus,5008458000,3319850000,8328308000
2019,6,WA40,Kautschuk und Waren daraus,1197078000,1111922000,2309000000
2019,6,WA41,"Häute, Felle, Leder",56147000,50774000,106921000
2019,6,WA42,"Lederwaren, Sattlerwaren",196478000,370953000,567431000
2019,6,WA43,"Pelzfelle, künstliches Pelzwerk",6890000,11512000,18402000
2019,6,WA44,"Holz, Holzwaren, Holzkohle",732797000,666701000,1399498000
2019,6,WA45,"Kork, Korkwaren",2011000,8334000,10345000
2019,6,WA46,"Flechtwaren, Korbmacherwaren",3690000,8704000,12394000
2019,6,WA47,"Halbstoffe aus Holz usw., Papierabfall",100478000,304893000,405371000
2019,6,WA48,"Papier, Pappe und Waren daraus",1484313000,1015887000,2500200000
2019,6,WA49,"Bücher, Zeitungen, Bilddrucke usw.",324874000,189570000,514444000
2019,6,WA50,Seide,2484000,2681000,5165000
2019,6,WA51,"Wolle, feine und grobe Tierhaare",38989000,52775000,91764000
2019,6,WA52,Baumwolle,56313000,62827000,119140000
2019,6,WA53,"Andere pflanzliche Spinnstoffe, Papiergarn",2108000,4614000,6722000
2019,6,WA54,Synthetisches oder künstliches Filament,153737000,115655000,269392000
2019,6,WA55,Synthetische oder künstliche Spinnfaser,150539000,114734000,265273000
2019,6,WA56,"Watte, Filz, Vliesstoff usw., Tauwerk",199742000,124440000,324182000
2019,6,WA57,"Teppiche, Fußbodenbelag aus Spinnstoff",42716000,82442000,125158000
2019,6,WA58,"Spezialgewebe, Spitzen, Tapisserien",42966000,21316000,64282000
2019,6,WA59,"Getränkte, bestrichene usw. Gewebe",204028000,92533000,296561000
2019,6,WA60,Gewirke und Gestricke,56996000,35405000,92401000
2019,6,WA61,"Bekleidung usw. aus Gewirken, Gestricken",746152000,1309936000,2056088000
2019,6,WA62,"Andere Bekleidung, Bekleidungszubehör",775510000,1252501000,2028011000
2019,6,WA63,"Andere Konfektion, Spinnstoffwaren usw.",229618000,325904000,555522000
2019,6,WA64,"Schuhe, Gamaschen, ähnliche Waren",626350000,1005371000,1631721000
2019,6,WA65,Kopfbedeckungen und Teile davon,31900000,51058000,82958000
2019,6,WA66,"Schirme, Gehstöcke usw., Peitschen",9039000,17695000,26734000
2019,6,WA67,"Zugerichtete Federn, Daunen, künstliche Blumen",9382000,17608000,26990000
2019,6,WA68,"Waren aus Steinen, Gips, Zement usw.",415078000,291792000,706870000
2019,6,WA69,Keramische Waren,302222000,233970000,536192000
2019,6,WA70,Glas und Glaswaren,530045000,419393000,949438000
2019,6,WA71,"Perlen, Edelsteine, Edelmetalle",1150436000,1230066000,2380502000
2019,6,WA72,Eisen und Stahl,1912654000,1962803000,3875457000
2019,6,WA73,Waren aus Eisen oder Stahl,2334017000,1811616000,4145633000
2019,6,WA74,Kupfer und Waren daraus,820283000,700956000,1521239000
2019,6,WA75,Nickel und Waren daraus,112379000,127934000,240313000
2019,6,WA76,Aluminium und Waren daraus,1247307000,1318309000,2565616000
2019,6,WA78,Blei und Waren daraus,31427000,33177000,64604000
2019,6,WA79,Zink und Waren daraus,72472000,125108000,197580000
2019,6,WA80,Zinn und Waren daraus,8572000,30469000,39041000
2019,6,WA81,"Andere unedle Metalle, Cermets usw.",133792000,151265000,285057000
2019,6,WA82,"Werkzeuge, Schneidwaren, Essbestecke",672304000,434375000,1106679000
2019,6,WA83,Verschiedene Waren aus unedlen Metallen,615851000,398493000,1014344000
2019,6,WA84,"Maschinen, Apparate, mechanische Geräte",18991043000,11385733000,30376776000
2019,6,WA85,Elektrotechnische Erzeugnisse,11218080000,10304896000,21522976000
2019,6,WA86,Schienenfahrzeuge,289908000,285083000,574991000
2019,6,WA87,"Kraftfahrzeuge, Landfahrzeuge",17107670000,10875581000,27983251000
2019,6,WA88,"Luftfahrzeuge, Raumfahrzeuge",3017230000,1203016000,4220246000
2019,6,WA89,Wasserfahrzeuge,262265000,72437000,334702000
2019,6,WA90,"Optische, photografische usw. Erzeugnisse",5665577000,3194153000,8859730000
2019,6,WA91,Uhrmacherwaren,132106000,165313000,297419000
2019,6,WA92,Musikinstrumente,54365000,50804000,105169000
2019,6,WA93,Waffen und Munition,36591000,20982000,57573000
2019,6,WA94,"Möbel, Beleuchtungskörper usw.",1341506000,1515717000,2857223000
2019,6,WA95,"Spielzeug, Spiele usw., Sportgeräte",391977000,544443000,936420000
2019,6,WA96,Verschiedene Waren,314960000,236524000,551484000
2019,6,WA97,"Kunstgegenstände, Sammlungsstücke",87587000,59100000,146687000
2019,6,WA98,Vollständige Fabrikationsanlagen,217134000,3090000,220224000
2019,6,WA99,Zusammenstellungen verschiedener Waren,1312827000,985239000,2298066000
2019,7,WA01,Lebende Tiere,104784000,153248000,258032000
2019,7,WA02,Fleisch,650004000,557452000,1207456000
2019,7,WA03,"Fische, Krebs- und Weichtiere",124875000,305346000,430221000
2019,7,WA04,"Milch, Milcherzeugnisse, Eier, Honig",823951000,689364000,1513315000
2019,7,WA05,Andere Waren tierischen Ursprungs,77373000,94814000,172187000
2019,7,WA06,"Pflanzen, Waren des Blumenhandels",61927000,184888000,246815000
2019,7,WA07,"Gemüse, Pflanzen für Ernährung",107508000,483889000,591397000
2019,7,WA08,Genießbare Früchte und Nüsse,148148000,914355000,1062503000
2019,7,WA09,"Kaffee, Tee, Mate, Gewürze",225875000,347287000,573162000
2019,7,WA10,Getreide,134882000,193648000,328530000
2019,7,WA11,"Müllereierzeugnisse, Malz usw.",139437000,56596000,196033000
2019,7,WA12,"Ölsamen usw., Heilpflanzen usw.",93087000,359521000,452608000
2019,7,WA13,"Schellack, Gummen, Harz, Pflanzensaft",58513000,48173000,106686000
2019,7,WA14,Flechtstoffe usw. pflanzlichen Ursprungs,618000,3686000,4304000
2019,7,WA15,"Tierische und pflanzliche Fette, Öle, Wachs",205432000,273420000,478852000
2019,7,WA16,"Zubereitungen von Fleisch, Fisch usw.",258214000,226953000,485167000
2019,7,WA17,Zucker und Zuckerwaren,197482000,133615000,331097000
2019,7,WA18,Kakao und Zubereitungen aus Kakao,434126000,409214000,843340000
2019,7,WA19,"Zubereitungen aus Getreide usw., Backwaren",562259000,361507000,923766000
2019,7,WA20,"Zubereitungen von Gemüse, Früchten usw.",249665000,416216000,665881000
2019,7,WA21,Verschiedene Lebensmittelzubereitungen,553293000,336179000,889472000
2019,7,WA22,"Getränke, alkoholhaltige Flüssigkeiten, Essig",564953000,725407000,1290360000
2019,7,WA23,"Rückstände der Lebensmittelindustrie, Futter",361621000,352684000,714305000
2019,7,WA24,Tabak,277587000,223653000,501240000
2019,7,WA25,"Salz, Schwefel, Steine, Erden usw.",174798000,164318000,339116000
2019,7,WA26,"Erze, Schlacken, Aschen",48555000,735535000,784090000
2019,7,WA27,Mineralische Brennstoffe usw.,2569686000,8009363000,10579049000
2019,7,WA28,Anorganische chemische Erzeugnisse,892980000,617162000,1510142000
2019,7,WA29,Organische chemische Erzeugnisse,2193371000,3414559000,5607930000
2019,7,WA30,Pharmazeutische Erzeugnisse,7426154000,4610273000,12036427000
2019,7,WA31,Düngemittel,164158000,84490000,248648000
2019,7,WA32,"Gerb- und Farbstoffe, Farben, Lacke usw.",1087147000,487748000,1574895000
2019,7,WA33,"Etherische Öle, Riech-, Schönheitsmittel",898919000,687632000,1586551000
2019,7,WA34,"Seifen, Waschmittel usw.",671335000,364634000,1035969000
2019,7,WA35,"Eiweißstoffe, Klebstoffe, Enzyme",311757000,192596000,504353000
2019,7,WA36,"Sprengstoffe, pyrotechnische Artikel usw.",22480000,30180000,52660000
2019,7,WA37,Photochemische Erzeugnisse,112066000,80146000,192212000
2019,7,WA38,Verschiedene Erzeugnisse der Chemischen Industrie,1875479000,1222845000,3098324000
2019,7,WA39,Kunststoffe und Waren daraus,5234705000,3514137000,8748842000
2019,7,WA40,Kautschuk und Waren daraus,1265445000,1178178000,2443623000
2019,7,WA41,"Häute, Felle, Leder",58830000,50341000,109171000
2019,7,WA42,"Lederwaren, Sattlerwaren",228927000,413794000,642721000
2019,7,WA43,"Pelzfelle, künstliches Pelzwerk",10419000,14501000,24920000
2019,7,WA44,"Holz, Holzwaren, Holzkohle",736304000,683448000,1419752000
2019,7,WA45,"Kork, Korkwaren",2869000,10974000,13843000
2019,7,WA46,"Flechtwaren, Korbmacherwaren",3917000,10004000,13921000
2019,7,WA47,"Halbstoffe aus Holz usw., Papierabfall",84167000,284847000,369014000
2019,7,WA48,"Papier, Pappe und Waren daraus",1599527000,1044232000,2643759000
2019,7,WA49,"Bücher, Zeitungen, Bilddrucke usw.",342542000,218253000,560795000
2019,7,WA50,Seide,2703000,2473000,5176000
2019,7,WA51,"Wolle, feine und grobe Tierhaare",41299000,47665000,88964000
2019,7,WA52,Baumwolle,55089000,61514000,116603000
2019,7,WA53,"Andere pflanzliche Spinnstoffe, Papiergarn",2242000,5331000,7573000
2019,7,WA54,Synthetisches oder künstliches Filament,140736000,122810000,263546000
2019,7,WA55,Synthetische oder künstliche Spinnfaser,136728000,115278000,252006000
2019,7,WA56,"Watte, Filz, Vliesstoff usw., Tauwerk",210806000,134336000,345142000
2019,7,WA57,"Teppiche, Fußbodenbelag aus Spinnstoff",43570000,83647000,127217000
2019,7,WA58,"Spezialgewebe, Spitzen, Tapisserien",43202000,21718000,64920000
2019,7,WA59,"Getränkte, bestrichene usw. Gewebe",203554000,98249000,301803000
2019,7,WA60,Gewirke und Gestricke,57292000,39411000,96703000
2019,7,WA61,"Bekleidung usw. aus Gewirken, Gestricken",880772000,1604904000,2485676000
2019,7,WA62,"Andere Bekleidung, Bekleidungszubehör",896969000,1500097000,2397066000
2019,7,WA63,"Andere Konfektion, Spinnstoffwaren usw.",247412000,366784000,614196000
2019,7,WA64,"Schuhe, Gamaschen, ähnliche Waren",704165000,1109533000,1813698000
2019,7,WA65,Kopfbedeckungen und Teile davon,39655000,68143000,107798000
2019,7,WA66,"Schirme, Gehstöcke usw., Peitschen",9794000,21695000,31489000
2019,7,WA67,"Zugerichtete Federn, Daunen, künstliche Blumen",13348000,25115000,38463000
2019,7,WA68,"Waren aus Steinen, Gips, Zement usw.",423721000,317693000,741414000
2019,7,WA69,Keramische Waren,306772000,254940000,561712000
2019,7,WA70,Glas und Glaswaren,561732000,436375000,998107000
2019,7,WA71,"Perlen, Edelsteine, Edelmetalle",1500400000,1526721000,3027121000
2019,7,WA72,Eisen und Stahl,1933062000,2111350000,4044412000
2019,7,WA73,Waren aus Eisen oder Stahl,2406789000,1960223000,4367012000
2019,7,WA74,Kupfer und Waren daraus,896165000,786426000,1682591000
2019,7,WA75,Nickel und Waren daraus,116504000,140148000,256652000
2019,7,WA76,Aluminium und Waren daraus,1251306000,1355578000,2606884000
2019,7,WA78,Blei und Waren daraus,27515000,43074000,70589000
2019,7,WA79,Zink und Waren daraus,75913000,125203000,201116000
2019,7,WA80,Zinn und Waren daraus,7327000,37642000,44969000
2019,7,WA81,"Andere unedle Metalle, Cermets usw.",131530000,175845000,307375000
2019,7,WA82,"Werkzeuge, Schneidwaren, Essbestecke",726402000,475030000,1201432000
2019,7,WA83,Verschiedene Waren aus unedlen Metallen,646472000,419017000,1065489000
2019,7,WA84,"Maschinen, Apparate, mechanische Geräte",20658957000,12022514000,32681471000
2019,7,WA85,Elektrotechnische Erzeugnisse,12331698000,11146806000,23478504000
2019,7,WA86,Schienenfahrzeuge,301051000,271534000,572585000
2019,7,WA87,"Kraftfahrzeuge, Landfahrzeuge",18942153000,9766261000,28708414000
2019,7,WA88,"Luftfahrzeuge, Raumfahrzeuge",3157223000,1372205000,4529428000
2019,7,WA89,Wasserfahrzeuge,355851000,278170000,634021000
2019,7,WA90,"Optische, photografische usw. Erzeugnisse",6125603000,3373089000,9498692000
2019,7,WA91,Uhrmacherwaren,140194000,187344000,327538000
2019,7,WA92,Musikinstrumente,51989000,51243000,103232000
2019,7,WA93,Waffen und Munition,41402000,25135000,66537000
2019,7,WA94,"Möbel, Beleuchtungskörper usw.",1306071000,1465896000,2771967000
2019,7,WA95,"Spielzeug, Spiele usw., Sportgeräte",405423000,573623000,979046000
2019,7,WA96,Verschiedene Waren,341062000,256319000,597381000
2019,7,WA97,"Kunstgegenstände, Sammlungsstücke",71155000,181685000,252840000
2019,7,WA98,Vollständige Fabrikationsanlagen,156084000,272000,156356000
2019,7,WA99,Zusammenstellungen verschiedener Waren,1415258000,1118567000,2533825000
2019,8,WA01,Lebende Tiere,106000000,165301000,271301000
2019,8,WA02,Fleisch,694877000,541692000,1236569000
2019,8,WA03,"Fische, Krebs- und Weichtiere",120358000,330583000,450941000
2019,8,WA04,"Milch, Milcherzeugnisse, Eier, Honig",771399000,652586000,1423985000
2019,8,WA05,Andere Waren tierischen Ursprungs,73662000,86230000,159892000
2019,8,WA06,"Pflanzen, Waren des Blumenhandels",61108000,198868000,259976000
2019,8,WA07,"Gemüse, Pflanzen für Ernährung",101027000,437104000,538131000
2019,8,WA08,Genießbare Früchte und Nüsse,152503000,862841000,1015344000
2019,8,WA09,"Kaffee, Tee, Mate, Gewürze",215748000,303989000,519737000
2019,8,WA10,Getreide,144671000,194036000,338707000
2019,8,WA11,"Müllereierzeugnisse, Malz usw.",120391000,58311000,178702000
2019,8,WA12,"Ölsamen usw., Heilpflanzen usw.",115696000,500303000,615999000
2019,8,WA13,"Schellack, Gummen, Harz, Pflanzensaft",53482000,43738000,97220000
2019,8,WA14,Flechtstoffe usw. pflanzlichen Ursprungs,713000,4067000,4780000
2019,8,WA15,"Tierische und pflanzliche Fette, Öle, Wachs",218454000,264988000,483442000
2019,8,WA16,"Zubereitungen von Fleisch, Fisch usw.",263995000,252550000,516545000
2019,8,WA17,Zucker und Zuckerwaren,180265000,129082000,309347000
2019,8,WA18,Kakao und Zubereitungen aus Kakao,481407000,376384000,857791000
2019,8,WA19,"Zubereitungen aus Getreide usw., Backwaren",566320000,350103000,916423000
2019,8,WA20,"Zubereitungen von Gemüse, Früchten usw.",244416000,383533000,627949000
2019,8,WA21,Verschiedene Lebensmittelzubereitungen,486208000,287969000,774177000
2019,8,WA22,"Getränke, alkoholhaltige Flüssigkeiten, Essig",520578000,591781000,1112359000
2019,8,WA23,"Rückstände der Lebensmittelindustrie, Futter",347093000,293910000,641003000
2019,8,WA24,Tabak,267747000,203633000,471380000
2019,8,WA25,"Salz, Schwefel, Steine, Erden usw.",146285000,158821000,305106000
2019,8,WA26,"Erze, Schlacken, Aschen",36636000,677673000,714309000
2019,8,WA27,Mineralische Brennstoffe usw.,2534100000,7803266000,10337366000
2019,8,WA28,Anorganische chemische Erzeugnisse,834878000,514432000,1349310000
2019,8,WA29,Organische chemische Erzeugnisse,1888752000,2528149000,4416901000
2019,8,WA30,Pharmazeutische Erzeugnisse,6712319000,4262008000,10974327000
2019,8,WA31,Düngemittel,170995000,63709000,234704000
2019,8,WA32,"Gerb- und Farbstoffe, Farben, Lacke usw.",900400000,454316000,1354716000
2019,8,WA33,"Etherische Öle, Riech-, Schönheitsmittel",849637000,592169000,1441806000
2019,8,WA34,"Seifen, Waschmittel usw.",594801000,353119000,947920000
2019,8,WA35,"Eiweißstoffe, Klebstoffe, Enzyme",283233000,177907000,461140000
2019,8,WA36,"Sprengstoffe, pyrotechnische Artikel usw.",23932000,13884000,37816000
2019,8,WA37,Photochemische Erzeugnisse,95441000,67372000,162813000
2019,8,WA38,Verschiedene Erzeugnisse der Chemischen Industrie,1685437000,1080166000,2765603000
2019,8,WA39,Kunststoffe und Waren daraus,4573091000,3147999000,7721090000
2019,8,WA40,Kautschuk und Waren daraus,1153025000,1096630000,2249655000
2019,8,WA41,"Häute, Felle, Leder",41556000,36035000,77591000
2019,8,WA42,"Lederwaren, Sattlerwaren",215169000,372811000,587980000
2019,8,WA43,"Pelzfelle, künstliches Pelzwerk",9742000,11544000,21286000
2019,8,WA44,"Holz, Holzwaren, Holzkohle",654094000,619541000,1273635000
2019,8,WA45,"Kork, Korkwaren",2692000,6308000,9000000
2019,8,WA46,"Flechtwaren, Korbmacherwaren",3307000,9735000,13042000
2019,8,WA47,"Halbstoffe aus Holz usw., Papierabfall",98904000,335010000,433914000
2019,8,WA48,"Papier, Pappe und Waren daraus",1413550000,1032770000,2446320000
2019,8,WA49,"Bücher, Zeitungen, Bilddrucke usw.",348287000,217732000,566019000
2019,8,WA50,Seide,1127000,2028000,3155000
2019,8,WA51,"Wolle, feine und grobe Tierhaare",31084000,38057000,69141000
2019,8,WA52,Baumwolle,46055000,53349000,99404000
2019,8,WA53,"Andere pflanzliche Spinnstoffe, Papiergarn",2242000,3880000,6122000
2019,8,WA54,Synthetisches oder künstliches Filament,120471000,102417000,222888000
2019,8,WA55,Synthetische oder künstliche Spinnfaser,119029000,111025000,230054000
2019,8,WA56,"Watte, Filz, Vliesstoff usw., Tauwerk",191527000,120024000,311551000
2019,8,WA57,"Teppiche, Fußbodenbelag aus Spinnstoff",39457000,83009000,122466000
2019,8,WA58,"Spezialgewebe, Spitzen, Tapisserien",38297000,17660000,55957000
2019,8,WA59,"Getränkte, bestrichene usw. Gewebe",178383000,84299000,262682000
2019,8,WA60,Gewirke und Gestricke,49478000,27502000,76980000
2019,8,WA61,"Bekleidung usw. aus Gewirken, Gestricken",913266000,1692369000,2605635000
2019,8,WA62,"Andere Bekleidung, Bekleidungszubehör",993233000,1688608000,2681841000
2019,8,WA63,"Andere Konfektion, Spinnstoffwaren usw.",223843000,341611000,565454000
2019,8,WA64,"Schuhe, Gamaschen, ähnliche Waren",731150000,1127401000,1858551000
2019,8,WA65,Kopfbedeckungen und Teile davon,42572000,70669000,113241000
2019,8,WA66,"Schirme, Gehstöcke usw., Peitschen",7296000,17866000,25162000
2019,8,WA67,"Zugerichtete Federn, Daunen, künstliche Blumen",11971000,25146000,37117000
2019,8,WA68,"Waren aus Steinen, Gips, Zement usw.",372404000,281899000,654303000
2019,8,WA69,Keramische Waren,279858000,232871000,512729000
2019,8,WA70,Glas und Glaswaren,510690000,404906000,915596000
2019,8,WA71,"Perlen, Edelsteine, Edelmetalle",1503473000,1477308000,2980781000
2019,8,WA72,Eisen und Stahl,1764046000,1828758000,3592804000
2019,8,WA73,Waren aus Eisen oder Stahl,2137175000,1649416000,3786591000
2019,8,WA74,Kupfer und Waren daraus,763936000,659611000,1423547000
2019,8,WA75,Nickel und Waren daraus,105254000,127699000,232953000
2019,8,WA76,Aluminium und Waren daraus,1164711000,1204430000,2369141000
2019,8,WA78,Blei und Waren daraus,30284000,34085000,64369000
2019,8,WA79,Zink und Waren daraus,51436000,113724000,165160000
2019,8,WA80,Zinn und Waren daraus,6644000,31597000,38241000
2019,8,WA81,"Andere unedle Metalle, Cermets usw.",120455000,149226000,269681000
2019,8,WA82,"Werkzeuge, Schneidwaren, Essbestecke",639175000,423865000,1063040000
2019,8,WA83,Verschiedene Waren aus unedlen Metallen,598211000,388941000,987152000
2019,8,WA84,"Maschinen, Apparate, mechanische Geräte",18483506000,10630465000,29113971000
2019,8,WA85,Elektrotechnische Erzeugnisse,11357023000,10478850000,21835873000
2019,8,WA86,Schienenfahrzeuge,264963000,232714000,497677000
2019,8,WA87,"Kraftfahrzeuge, Landfahrzeuge",14744750000,8344860000,23089610000
2019,8,WA88,"Luftfahrzeuge, Raumfahrzeuge",1663970000,800581000,2464551000
2019,8,WA89,Wasserfahrzeuge,279410000,73891000,353301000
2019,8,WA90,"Optische, photografische usw. Erzeugnisse",5671148000,3132664000,8803812000
2019,8,WA91,Uhrmacherwaren,123809000,169393000,293202000
2019,8,WA92,Musikinstrumente,49841000,56254000,106095000
2019,8,WA93,Waffen und Munition,30857000,17435000,48292000
2019,8,WA94,"Möbel, Beleuchtungskörper usw.",1195464000,1421978000,2617442000
2019,8,WA95,"Spielzeug, Spiele usw., Sportgeräte",521908000,729758000,1251666000
2019,8,WA96,Verschiedene Waren,319974000,237972000,557946000
2019,8,WA97,"Kunstgegenstände, Sammlungsstücke",47651000,40911000,88562000
2019,8,WA98,Vollständige Fabrikationsanlagen,98353000,11000,98364000
2019,8,WA99,Zusammenstellungen verschiedener Waren,1397766000,986081000,2383847000
2019,9,WA01,Lebende Tiere,117528000,150688000,268216000
2019,9,WA02,Fleisch,717494000,595992000,1313486000
2019,9,WA03,"Fische, Krebs- und Weichtiere",119478000,337991000,457469000
2019,9,WA04,"Milch, Milcherzeugnisse, Eier, Honig",803227000,695258000,1498485000
2019,9,WA05,Andere Waren tierischen Ursprungs,76364000,84950000,161314000
2019,9,WA06,"Pflanzen, Waren des Blumenhandels",87761000,194013000,281774000
2019,9,WA07,"Gemüse, Pflanzen für Ernährung",101019000,398840000,499859000
2019,9,WA08,Genießbare Früchte und Nüsse,145019000,799852000,944871000
2019,9,WA09,"Kaffee, Tee, Mate, Gewürze",232040000,292239000,524279000
2019,9,WA10,Getreide,119934000,198121000,318055000
2019,9,WA11,"Müllereierzeugnisse, Malz usw.",141119000,61969000,203088000
2019,9,WA12,"Ölsamen usw., Heilpflanzen usw.",84327000,469711000,554038000
2019,9,WA13,"Schellack, Gummen, Harz, Pflanzensaft",48660000,38858000,87518000
2019,9,WA14,Flechtstoffe usw. pflanzlichen Ursprungs,703000,3629000,4332000
2019,9,WA15,"Tierische und pflanzliche Fette, Öle, Wachs",216594000,302129000,518723000
2019,9,WA16,"Zubereitungen von Fleisch, Fisch usw.",273461000,252452000,525913000
2019,9,WA17,Zucker und Zuckerwaren,189372000,142117000,331489000
2019,9,WA18,Kakao und Zubereitungen aus Kakao,550195000,421949000,972144000
2019,9,WA19,"Zubereitungen aus Getreide usw., Backwaren",593450000,375018000,968468000
2019,9,WA20,"Zubereitungen von Gemüse, Früchten usw.",241248000,438813000,680061000
2019,9,WA21,Verschiedene Lebensmittelzubereitungen,479256000,299758000,779014000
2019,9,WA22,"Getränke, alkoholhaltige Flüssigkeiten, Essig",492543000,680477000,1173020000
2019,9,WA23,"Rückstände der Lebensmittelindustrie, Futter",362985000,349989000,712974000
2019,9,WA24,Tabak,284872000,242778000,527650000
2019,9,WA25,"Salz, Schwefel, Steine, Erden usw.",170834000,166963000,337797000
2019,9,WA26,"Erze, Schlacken, Aschen",47226000,636420000,683646000
2019,9,WA27,Mineralische Brennstoffe usw.,2725464000,7416253000,10141717000
2019,9,WA28,Anorganische chemische Erzeugnisse,943244000,558798000,1502042000
2019,9,WA29,Organische chemische Erzeugnisse,2079630000,2053986000,4133616000
2019,9,WA30,Pharmazeutische Erzeugnisse,7021625000,4811193000,11832818000
2019,9,WA31,Düngemittel,193508000,68104000,261612000
2019,9,WA32,"Gerb- und Farbstoffe, Farben, Lacke usw.",989796000,480439000,1470235000
2019,9,WA33,"Etherische Öle, Riech-, Schönheitsmittel",929441000,668395000,1597836000
2019,9,WA34,"Seifen, Waschmittel usw.",678783000,402227000,1081010000
2019,9,WA35,"Eiweißstoffe, Klebstoffe, Enzyme",312574000,177973000,490547000
2019,9,WA36,"Sprengstoffe, pyrotechnische Artikel usw.",24360000,32948000,57308000
2019,9,WA37,Photochemische Erzeugnisse,103591000,81255000,184846000
2019,9,WA38,Verschiedene Erzeugnisse der Chemischen Industrie,1937625000,1200784000,3138409000
2019,9,WA39,Kunststoffe und Waren daraus,5225684000,3382425000,8608109000
2019,9,WA40,Kautschuk und Waren daraus,1287649000,1182530000,2470179000
2019,9,WA41,"Häute, Felle, Leder",58301000,49356000,107657000
2019,9,WA42,"Lederwaren, Sattlerwaren",209147000,352714000,561861000
2019,9,WA43,"Pelzfelle, künstliches Pelzwerk",10537000,11403000,21940000
2019,9,WA44,"Holz, Holzwaren, Holzkohle",709473000,656657000,1366130000
2019,9,WA45,"Kork, Korkwaren",2371000,9951000,12322000
2019,9,WA46,"Flechtwaren, Korbmacherwaren",4200000,8209000,12409000
2019,9,WA47,"Halbstoffe aus Holz usw., Papierabfall",87155000,288239000,375394000
2019,9,WA48,"Papier, Pappe und Waren daraus",1598504000,1051136000,2649640000
2019,9,WA49,"Bücher, Zeitungen, Bilddrucke usw.",349069000,242132000,591201000
2019,9,WA50,Seide,1748000,1894000,3642000
2019,9,WA51,"Wolle, feine und grobe Tierhaare",37353000,42720000,80073000
2019,9,WA52,Baumwolle,62779000,60274000,123053000
2019,9,WA53,"Andere pflanzliche Spinnstoffe, Papiergarn",2698000,5123000,7821000
2019,9,WA54,Synthetisches oder künstliches Filament,143663000,114979000,258642000
2019,9,WA55,Synthetische oder künstliche Spinnfaser,138931000,120169000,259100000
2019,9,WA56,"Watte, Filz, Vliesstoff usw., Tauwerk",215332000,125625000,340957000
2019,9,WA57,"Teppiche, Fußbodenbelag aus Spinnstoff",48209000,94871000,143080000
2019,9,WA58,"Spezialgewebe, Spitzen, Tapisserien",43570000,20130000,63700000
2019,9,WA59,"Getränkte, bestrichene usw. Gewebe",200802000,96948000,297750000
2019,9,WA60,Gewirke und Gestricke,59362000,34617000,93979000
2019,9,WA61,"Bekleidung usw. aus Gewirken, Gestricken",983648000,1637790000,2621438000
2019,9,WA62,"Andere Bekleidung, Bekleidungszubehör",1109035000,1597613000,2706648000
2019,9,WA63,"Andere Konfektion, Spinnstoffwaren usw.",242486000,340436000,582922000
2019,9,WA64,"Schuhe, Gamaschen, ähnliche Waren",753781000,1077275000,1831056000
2019,9,WA65,Kopfbedeckungen und Teile davon,47962000,65520000,113482000
2019,9,WA66,"Schirme, Gehstöcke usw., Peitschen",7820000,11385000,19205000
2019,9,WA67,"Zugerichtete Federn, Daunen, künstliche Blumen",15133000,21255000,36388000
2019,9,WA68,"Waren aus Steinen, Gips, Zement usw.",421227000,295685000,716912000
2019,9,WA69,Keramische Waren,322671000,236687000,559358000
2019,9,WA70,Glas und Glaswaren,563435000,459734000,1023169000
2019,9,WA71,"Perlen, Edelsteine, Edelmetalle",1859882000,1582491000,3442373000
2019,9,WA72,Eisen und Stahl,1857646000,2046138000,3903784000
2019,9,WA73,Waren aus Eisen oder Stahl,2399201000,1805238000,4204439000
2019,9,WA74,Kupfer und Waren daraus,861604000,722288000,1583892000
2019,9,WA75,Nickel und Waren daraus,122382000,146205000,268587000
2019,9,WA76,Aluminium und Waren daraus,1252677000,1293676000,2546353000
2019,9,WA78,Blei und Waren daraus,38521000,32410000,70931000
2019,9,WA79,Zink und Waren daraus,62187000,114404000,176591000
2019,9,WA80,Zinn und Waren daraus,8445000,29794000,38239000
2019,9,WA81,"Andere unedle Metalle, Cermets usw.",126354000,152051000,278405000
2019,9,WA82,"Werkzeuge, Schneidwaren, Essbestecke",667130000,431711000,1098841000
2019,9,WA83,Verschiedene Waren aus unedlen Metallen,648839000,423309000,1072148000
2019,9,WA84,"Maschinen, Apparate, mechanische Geräte",19406207000,12051692000,31457899000
2019,9,WA85,Elektrotechnische Erzeugnisse,12288001000,11828947000,24116948000
2019,9,WA86,Schienenfahrzeuge,261101000,297443000,558544000
2019,9,WA87,"Kraftfahrzeuge, Landfahrzeuge",19253245000,10851289000,30104534000
2019,9,WA88,"Luftfahrzeuge, Raumfahrzeuge",3018864000,1474143000,4493007000
2019,9,WA89,Wasserfahrzeuge,124373000,34849000,159222000
2019,9,WA90,"Optische, photografische usw. Erzeugnisse",6171685000,3370837000,9542522000
2019,9,WA91,Uhrmacherwaren,146483000,193261000,339744000
2019,9,WA92,Musikinstrumente,61298000,66050000,127348000
2019,9,WA93,Waffen und Munition,41696000,23076000,64772000
2019,9,WA94,"Möbel, Beleuchtungskörper usw.",1452430000,1622175000,3074605000
2019,9,WA95,"Spielzeug, Spiele usw., Sportgeräte",557532000,817953000,1375485000
2019,9,WA96,Verschiedene Waren,333865000,241972000,575837000
2019,9,WA97,"Kunstgegenstände, Sammlungsstücke",50047000,30989000,81036000
2019,9,WA98,Vollständige Fabrikationsanlagen,57275000,315000,57590000
2019,9,WA99,Zusammenstellungen verschiedener Waren,1419191000,1008646000,2427837000
2019,10,WA01,Lebende Tiere,118497000,165257000,283754000
2019,10,WA02,Fleisch,789369000,587361000,1376730000
2019,10,WA03,"Fische, Krebs- und Weichtiere",118755000,373523000,492278000
2019,10,WA04,"Milch, Milcherzeugnisse, Eier, Honig",834768000,716708000,1551476000
2019,10,WA05,Andere Waren tierischen Ursprungs,82260000,81150000,163410000
2019,10,WA06,"Pflanzen, Waren des Blumenhandels",84506000,191911000,276417000
2019,10,WA07,"Gemüse, Pflanzen für Ernährung",90786000,392348000,483134000
2019,10,WA08,Genießbare Früchte und Nüsse,172546000,835467000,1008013000
2019,10,WA09,"Kaffee, Tee, Mate, Gewürze",255293000,316080000,571373000
2019,10,WA10,Getreide,115664000,226244000,341908000
2019,10,WA11,"Müllereierzeugnisse, Malz usw.",147410000,60751000,208161000
2019,10,WA12,"Ölsamen usw., Heilpflanzen usw.",96739000,554573000,651312000
2019,10,WA13,"Schellack, Gummen, Harz, Pflanzensaft",52874000,46378000,99252000
2019,10,WA14,Flechtstoffe usw. pflanzlichen Ursprungs,813000,3556000,4369000
2019,10,WA15,"Tierische und pflanzliche Fette, Öle, Wachs",227744000,313584000,541328000
2019,10,WA16,"Zubereitungen von Fleisch, Fisch usw.",275659000,256664000,532323000
2019,10,WA17,Zucker und Zuckerwaren,226122000,138738000,364860000
2019,10,WA18,Kakao und Zubereitungen aus Kakao,628760000,478178000,1106938000
2019,10,WA19,"Zubereitungen aus Getreide usw., Backwaren",633322000,365306000,998628000
2019,10,WA20,"Zubereitungen von Gemüse, Früchten usw.",262249000,443559000,705808000
2019,10,WA21,Verschiedene Lebensmittelzubereitungen,509998000,291166000,801164000
2019,10,WA22,"Getränke, alkoholhaltige Flüssigkeiten, Essig",535613000,687043000,1222656000
2019,10,WA23,"Rückstände der Lebensmittelindustrie, Futter",390331000,309430000,699761000
2019,10,WA24,Tabak,271341000,249709000,521050000
2019,10,WA25,"Salz, Schwefel, Steine, Erden usw.",187723000,147548000,335271000
2019,10,WA26,"Erze, Schlacken, Aschen",45902000,741085000,786987000
2019,10,WA27,Mineralische Brennstoffe usw.,2503565000,7686800000,10190365000
2019,10,WA28,Anorganische chemische Erzeugnisse,889810000,554881000,1444691000
2019,10,WA29,Organische chemische Erzeugnisse,2105664000,3092548000,5198212000
2019,10,WA30,Pharmazeutische Erzeugnisse,7388280000,4845566000,12233846000
2019,10,WA31,Düngemittel,156815000,70374000,227189000
2019,10,WA32,"Gerb- und Farbstoffe, Farben, Lacke usw.",1031026000,506521000,1537547000
2019,10,WA33,"Etherische Öle, Riech-, Schönheitsmittel",970024000,662653000,1632677000
2019,10,WA34,"Seifen, Waschmittel usw.",693398000,401471000,1094869000
2019,10,WA35,"Eiweißstoffe, Klebstoffe, Enzyme",311101000,191732000,502833000
2019,10,WA36,"Sprengstoffe, pyrotechnische Artikel usw.",24137000,32458000,56595000
2019,10,WA37,Photochemische Erzeugnisse,101921000,82412000,184333000
2019,10,WA38,Verschiedene Erzeugnisse der Chemischen Industrie,1983605000,1189542000,3173147000
2019,10,WA39,Kunststoffe und Waren daraus,5401979000,3420497000,8822476000
2019,10,WA40,Kautschuk und Waren daraus,1329584000,1276349000,2605933000
2019,10,WA41,"Häute, Felle, Leder",64697000,59317000,124014000
2019,10,WA42,"Lederwaren, Sattlerwaren",221024000,379373000,600397000
2019,10,WA43,"Pelzfelle, künstliches Pelzwerk",13000000,16187000,29187000
2019,10,WA44,"Holz, Holzwaren, Holzkohle",795957000,686342000,1482299000
2019,10,WA45,"Kork, Korkwaren",2758000,10242000,13000000
2019,10,WA46,"Flechtwaren, Korbmacherwaren",3411000,8402000,11813000
2019,10,WA47,"Halbstoffe aus Holz usw., Papierabfall",91690000,284359000,376049000
2019,10,WA48,"Papier, Pappe und Waren daraus",1645334000,1087316000,2732650000
2019,10,WA49,"Bücher, Zeitungen, Bilddrucke usw.",383361000,243271000,626632000
2019,10,WA50,Seide,2944000,2945000,5889000
2019,10,WA51,"Wolle, feine und grobe Tierhaare",36446000,43350000,79796000
2019,10,WA52,Baumwolle,69656000,75172000,144828000
2019,10,WA53,"Andere pflanzliche Spinnstoffe, Papiergarn",4407000,7338000,11745000
2019,10,WA54,Synthetisches oder künstliches Filament,156560000,122049000,278609000
2019,10,WA55,Synthetische oder künstliche Spinnfaser,147643000,119146000,266789000
2019,10,WA56,"Watte, Filz, Vliesstoff usw., Tauwerk",222063000,127587000,349650000
2019,10,WA57,"Teppiche, Fußbodenbelag aus Spinnstoff",50618000,97711000,148329000
2019,10,WA58,"Spezialgewebe, Spitzen, Tapisserien",48558000,23105000,71663000
2019,10,WA59,"Getränkte, bestrichene usw. Gewebe",210983000,98016000,308999000
2019,10,WA60,Gewirke und Gestricke,65124000,38395000,103519000
2019,10,WA61,"Bekleidung usw. aus Gewirken, Gestricken",975587000,1656126000,2631713000
2019,10,WA62,"Andere Bekleidung, Bekleidungszubehör",1038864000,1485451000,2524315000
2019,10,WA63,"Andere Konfektion, Spinnstoffwaren usw.",258019000,367775000,625794000
2019,10,WA64,"Schuhe, Gamaschen, ähnliche Waren",656042000,996877000,1652919000
2019,10,WA65,Kopfbedeckungen und Teile davon,51164000,65494000,116658000
2019,10,WA66,"Schirme, Gehstöcke usw., Peitschen",8012000,13471000,21483000
2019,10,WA67,"Zugerichtete Federn, Daunen, künstliche Blumen",15124000,24417000,39541000
2019,10,WA68,"Waren aus Steinen, Gips, Zement usw.",436378000,299897000,736275000
2019,10,WA69,Keramische Waren,333521000,256056000,589577000
2019,10,WA70,Glas und Glaswaren,600680000,461875000,1062555000
2019,10,WA71,"Perlen, Edelsteine, Edelmetalle",1426141000,1850974000,3277115000
2019,10,WA72,Eisen und Stahl,1896960000,2031211000,3928171000
2019,10,WA73,Waren aus Eisen oder Stahl,2487117000,1847654000,4334771000
2019,10,WA74,Kupfer und Waren daraus,900144000,916080000,1816224000
2019,10,WA75,Nickel und Waren daraus,123543000,150161000,273704000
2019,10,WA76,Aluminium und Waren daraus,1296497000,1363753000,2660250000
2019,10,WA78,Blei und Waren daraus,39738000,40964000,80702000
2019,10,WA79,Zink und Waren daraus,67815000,119572000,187387000
2019,10,WA80,Zinn und Waren daraus,7521000,29172000,36693000
2019,10,WA81,"Andere unedle Metalle, Cermets usw.",121085000,149023000,270108000
2019,10,WA82,"Werkzeuge, Schneidwaren, Essbestecke",722314000,450792000,1173106000
2019,10,WA83,Verschiedene Waren aus unedlen Metallen,688051000,439178000,1127229000
2019,10,WA84,"Maschinen, Apparate, mechanische Geräte",20610489000,12773539000,33384028000
2019,10,WA85,Elektrotechnische Erzeugnisse,12867038000,12674009000,25541047000
2019,10,WA86,Schienenfahrzeuge,387382000,293390000,680772000
2019,10,WA87,"Kraftfahrzeuge, Landfahrzeuge",19638859000,11208066000,30846925000
2019,10,WA88,"Luftfahrzeuge, Raumfahrzeuge",4079219000,1893215000,5972434000
2019,10,WA89,Wasserfahrzeuge,1036051000,146315000,1182366000
2019,10,WA90,"Optische, photografische usw. Erzeugnisse",6300300000,3536894000,9837194000
2019,10,WA91,Uhrmacherwaren,154518000,217272000,371790000
2019,10,WA92,Musikinstrumente,67193000,74207000,141400000
2019,10,WA93,Waffen und Munition,38569000,23879000,62448000
2019,10,WA94,"Möbel, Beleuchtungskörper usw.",1465150000,1737013000,3202163000
2019,10,WA95,"Spielzeug, Spiele usw., Sportgeräte",636544000,867243000,1503787000
2019,10,WA96,Verschiedene Waren,363900000,258345000,622245000
2019,10,WA97,"Kunstgegenstände, Sammlungsstücke",89550000,46312000,135862000
2019,10,WA98,Vollständige Fabrikationsanlagen,87124000,98000,87222000
2019,10,WA99,Zusammenstellungen verschiedener Waren,1508278000,1159453000,2667731000
2019,11,WA01,Lebende Tiere,140784000,155304000,296088000
2019,11,WA02,Fleisch,828697000,629988000,1458685000
2019,11,WA03,"Fische, Krebs- und Weichtiere",138942000,359138000,498080000
2019,11,WA04,"Milch, Milcherzeugnisse, Eier, Honig",774995000,739790000,1514785000
2019,11,WA05,Andere Waren tierischen Ursprungs,80375000,85927000,166302000
2019,11,WA06,"Pflanzen, Waren des Blumenhandels",65339000,203982000,269321000
2019,11,WA07,"Gemüse, Pflanzen für Ernährung",99228000,489932000,589160000
2019,11,WA08,Genießbare Früchte und Nüsse,173985000,915575000,1089560000
2019,11,WA09,"Kaffee, Tee, Mate, Gewürze",242209000,299773000,541982000
2019,11,WA10,Getreide,158750000,239753000,398503000
2019,11,WA11,"Müllereierzeugnisse, Malz usw.",142643000,60212000,202855000
2019,11,WA12,"Ölsamen usw., Heilpflanzen usw.",108805000,410596000,519401000
2019,11,WA13,"Schellack, Gummen, Harz, Pflanzensaft",60906000,42347000,103253000
2019,11,WA14,Flechtstoffe usw. pflanzlichen Ursprungs,575000,4490000,5065000
2019,11,WA15,"Tierische und pflanzliche Fette, Öle, Wachs",223505000,286158000,509663000
2019,11,WA16,"Zubereitungen von Fleisch, Fisch usw.",246384000,282542000,528926000
2019,11,WA17,Zucker und Zuckerwaren,193882000,129481000,323363000
2019,11,WA18,Kakao und Zubereitungen aus Kakao,558519000,465245000,1023764000
2019,11,WA19,"Zubereitungen aus Getreide usw., Backwaren",573363000,399757000,973120000
2019,11,WA20,"Zubereitungen von Gemüse, Früchten usw.",255350000,466866000,722216000
2019,11,WA21,Verschiedene Lebensmittelzubereitungen,489007000,289351000,778358000
2019,11,WA22,"Getränke, alkoholhaltige Flüssigkeiten, Essig",484827000,682041000,1166868000
2019,11,WA23,"Rückstände der Lebensmittelindustrie, Futter",396467000,378445000,774912000
2019,11,WA24,Tabak,253241000,212613000,465854000
2019,11,WA25,"Salz, Schwefel, Steine, Erden usw.",168738000,151998000,320736000
2019,11,WA26,"Erze, Schlacken, Aschen",44221000,629287000,673508000
2019,11,WA27,Mineralische Brennstoffe usw.,2354605000,8117873000,10472478000
2019,11,WA28,Anorganische chemische Erzeugnisse,805758000,517470000,1323228000
2019,11,WA29,Organische chemische Erzeugnisse,1999742000,3064318000,5064060000
2019,11,WA30,Pharmazeutische Erzeugnisse,7079898000,4547617000,11627515000
2019,11,WA31,Düngemittel,176187000,86365000,262552000
2019,11,WA32,"Gerb- und Farbstoffe, Farben, Lacke usw.",931669000,479798000,1411467000
2019,11,WA33,"Etherische Öle, Riech-, Schönheitsmittel",906851000,669327000,1576178000
2019,11,WA34,"Seifen, Waschmittel usw.",628582000,382506000,1011088000
2019,11,WA35,"Eiweißstoffe, Klebstoffe, Enzyme",309593000,184880000,494473000
2019,11,WA36,"Sprengstoffe, pyrotechnische Artikel usw.",27296000,16654000,43950000
2019,11,WA37,Photochemische Erzeugnisse,105528000,85260000,190788000
2019,11,WA38,Verschiedene Erzeugnisse der Chemischen Industrie,1982195000,1162204000,3144399000
2019,11,WA39,Kunststoffe und Waren daraus,4906448000,3137338000,8043786000
2019,11,WA40,Kautschuk und Waren daraus,1279998000,1111005000,2391003000
2019,11,WA41,"Häute, Felle, Leder",56367000,47753000,104120000
2019,11,WA42,"Lederwaren, Sattlerwaren",213391000,376906000,590297000
2019,11,WA43,"Pelzfelle, künstliches Pelzwerk",12412000,15586000,27998000
2019,11,WA44,"Holz, Holzwaren, Holzkohle",712946000,632825000,1345771000
2019,11,WA45,"Kork, Korkwaren",2548000,8522000,11070000
2019,11,WA46,"Flechtwaren, Korbmacherwaren",3724000,10709000,14433000
2019,11,WA47,"Halbstoffe aus Holz usw., Papierabfall",78675000,293089000,371764000
2019,11,WA48,"Papier, Pappe und Waren daraus",1569905000,1040887000,2610792000
2019,11,WA49,"Bücher, Zeitungen, Bilddrucke usw.",374313000,257187000,631500000
2019,11,WA50,Seide,1894000,3291000,5185000
2019,11,WA51,"Wolle, feine und grobe Tierhaare",24588000,41208000,65796000
2019,11,WA52,Baumwolle,67394000,74286000,141680000
2019,11,WA53,"Andere pflanzliche Spinnstoffe, Papiergarn",5135000,7851000,12986000
2019,11,WA54,Synthetisches oder künstliches Filament,144031000,120330000,264361000
2019,11,WA55,Synthetische oder künstliche Spinnfaser,123012000,110497000,233509000
2019,11,WA56,"Watte, Filz, Vliesstoff usw., Tauwerk",199674000,125467000,325141000
2019,11,WA57,"Teppiche, Fußbodenbelag aus Spinnstoff",51163000,99772000,150935000
2019,11,WA58,"Spezialgewebe, Spitzen, Tapisserien",41999000,21035000,63034000
2019,11,WA59,"Getränkte, bestrichene usw. Gewebe",191064000,95248000,286312000
2019,11,WA60,Gewirke und Gestricke,56790000,38418000,95208000
2019,11,WA61,"Bekleidung usw. aus Gewirken, Gestricken",917218000,1637981000,2555199000
2019,11,WA62,"Andere Bekleidung, Bekleidungszubehör",956284000,1406948000,2363232000
2019,11,WA63,"Andere Konfektion, Spinnstoffwaren usw.",243996000,336629000,580625000
2019,11,WA64,"Schuhe, Gamaschen, ähnliche Waren",667154000,943163000,1610317000
2019,11,WA65,Kopfbedeckungen und Teile davon,41927000,61962000,103889000
2019,11,WA66,"Schirme, Gehstöcke usw., Peitschen",6647000,14505000,21152000
2019,11,WA67,"Zugerichtete Federn, Daunen, künstliche Blumen",12820000,21090000,33910000
2019,11,WA68,"Waren aus Steinen, Gips, Zement usw.",412774000,287866000,700640000
2019,11,WA69,Keramische Waren,317841000,239473000,557314000
2019,11,WA70,Glas und Glaswaren,546572000,438589000,985161000
2019,11,WA71,"Perlen, Edelsteine, Edelmetalle",1580671000,1912315000,3492986000
2019,11,WA72,Eisen und Stahl,1719513000,1778532000,3498045000
2019,11,WA73,Waren aus Eisen oder Stahl,2333126000,1737010000,4070136000
2019,11,WA74,Kupfer und Waren daraus,747116000,862273000,1609389000
2019,11,WA75,Nickel und Waren daraus,117237000,128739000,245976000
2019,11,WA76,Aluminium und Waren daraus,1255273000,1279262000,2534535000
2019,11,WA78,Blei und Waren daraus,35993000,39418000,75411000
2019,11,WA79,Zink und Waren daraus,60883000,118148000,179031000
2019,11,WA80,Zinn und Waren daraus,7331000,30027000,37358000
2019,11,WA81,"Andere unedle Metalle, Cermets usw.",115888000,155274000,271162000
2019,11,WA82,"Werkzeuge, Schneidwaren, Essbestecke",710795000,438660000,1149455000
2019,11,WA83,Verschiedene Waren aus unedlen Metallen,599231000,410069000,1009300000
2019,11,WA84,"Maschinen, Apparate, mechanische Geräte",19687170000,12424332000,32111502000
2019,11,WA85,Elektrotechnische Erzeugnisse,12554795000,12278232000,24833027000
2019,11,WA86,Schienenfahrzeuge,367104000,293486000,660590000
2019,11,WA87,"Kraftfahrzeuge, Landfahrzeuge",18579337000,10263981000,28843318000
2019,11,WA88,"Luftfahrzeuge, Raumfahrzeuge",3558918000,1355891000,4914809000
2019,11,WA89,Wasserfahrzeuge,286411000,171491000,457902000
2019,11,WA90,"Optische, photografische usw. Erzeugnisse",6176152000,3434677000,9610829000
2019,11,WA91,Uhrmacherwaren,162884000,229036000,391920000
2019,11,WA92,Musikinstrumente,68573000,69989000,138562000
2019,11,WA93,Waffen und Munition,36837000,19792000,56629000
2019,11,WA94,"Möbel, Beleuchtungskörper usw.",1421812000,1625154000,3046966000
2019,11,WA95,"Spielzeug, Spiele usw., Sportgeräte",601024000,912850000,1513874000
2019,11,WA96,Verschiedene Waren,335812000,245235000,581047000
2019,11,WA97,"Kunstgegenstände, Sammlungsstücke",65422000,36054000,101476000
2019,11,WA98,Vollständige Fabrikationsanlagen,131177000,15000,131192000
2019,11,WA99,Zusammenstellungen verschiedener Waren,1474625000,1080964000,2555589000
2019,12,WA01,Lebende Tiere,132216000,160988000,293204000
2019,12,WA02,Fleisch,785717000,625482000,1411199000
2019,12,WA03,"Fische, Krebs- und Weichtiere",131992000,321344000,453336000
2019,12,WA04,"Milch, Milcherzeugnisse, Eier, Honig",723891000,690361000,1414252000
2019,12,WA05,Andere Waren tierischen Ursprungs,63812000,71784000,135596000
2019,12,WA06,"Pflanzen, Waren des Blumenhandels",57899000,205781000,263680000
2019,12,WA07,"Gemüse, Pflanzen für Ernährung",71922000,541959000,613881000
2019,12,WA08,Genießbare Früchte und Nüsse,171648000,787844000,959492000
2019,12,WA09,"Kaffee, Tee, Mate, Gewürze",218867000,259247000,478114000
2019,12,WA10,Getreide,112116000,222344000,334460000
2019,12,WA11,"Müllereierzeugnisse, Malz usw.",129137000,50259000,179396000
2019,12,WA12,"Ölsamen usw., Heilpflanzen usw.",90448000,482765000,573213000
2019,12,WA13,"Schellack, Gummen, Harz, Pflanzensaft",45997000,37457000,83454000
2019,12,WA14,Flechtstoffe usw. pflanzlichen Ursprungs,454000,3549000,4003000
2019,12,WA15,"Tierische und pflanzliche Fette, Öle, Wachs",178926000,262224000,441150000
2019,12,WA16,"Zubereitungen von Fleisch, Fisch usw.",249482000,252328000,501810000
2019,12,WA17,Zucker und Zuckerwaren,199718000,114534000,314252000
2019,12,WA18,Kakao und Zubereitungen aus Kakao,425232000,333312000,758544000
2019,12,WA19,"Zubereitungen aus Getreide usw., Backwaren",503790000,351244000,855034000
2019,12,WA20,"Zubereitungen von Gemüse, Früchten usw.",232458000,410399000,642857000
2019,12,WA21,Verschiedene Lebensmittelzubereitungen,438224000,265619000,703843000
2019,12,WA22,"Getränke, alkoholhaltige Flüssigkeiten, Essig",430558000,632950000,1063508000
2019,12,WA23,"Rückstände der Lebensmittelindustrie, Futter",371754000,331982000,703736000
2019,12,WA24,Tabak,214257000,188172000,402429000
2019,12,WA25,"Salz, Schwefel, Steine, Erden usw.",135671000,129936000,265607000
2019,12,WA26,"Erze, Schlacken, Aschen",33753000,624199000,657952000
2019,12,WA27,Mineralische Brennstoffe usw.,2363560000,8265387000,10628947000
2019,12,WA28,Anorganische chemische Erzeugnisse,778797000,446475000,1225272000
2019,12,WA29,Organische chemische Erzeugnisse,1763617000,2420680000,4184297000
2019,12,WA30,Pharmazeutische Erzeugnisse,5825236000,4332215000,10157451000
2019,12,WA31,Düngemittel,172049000,71597000,243646000
2019,12,WA32,"Gerb- und Farbstoffe, Farben, Lacke usw.",703695000,362541000,1066236000
2019,12,WA33,"Etherische Öle, Riech-, Schönheitsmittel",738879000,543969000,1282848000
2019,12,WA34,"Seifen, Waschmittel usw.",527262000,326047000,853309000
2019,12,WA35,"Eiweißstoffe, Klebstoffe, Enzyme",247326000,158340000,405666000
2019,12,WA36,"Sprengstoffe, pyrotechnische Artikel usw.",27884000,13763000,41647000
2019,12,WA37,Photochemische Erzeugnisse,83540000,71445000,154985000
2019,12,WA38,Verschiedene Erzeugnisse der Chemischen Industrie,1654324000,1053053000,2707377000
2019,12,WA39,Kunststoffe und Waren daraus,3839912000,2559493000,6399405000
2019,12,WA40,Kautschuk und Waren daraus,938491000,796515000,1735006000
2019,12,WA41,"Häute, Felle, Leder",52192000,42921000,95113000
2019,12,WA42,"Lederwaren, Sattlerwaren",196705000,357702000,554407000
2019,12,WA43,"Pelzfelle, künstliches Pelzwerk",6318000,6613000,12931000
2019,12,WA44,"Holz, Holzwaren, Holzkohle",540599000,501800000,1042399000
2019,12,WA45,"Kork, Korkwaren",2052000,7407000,9459000
2019,12,WA46,"Flechtwaren, Korbmacherwaren",3307000,9490000,12797000
2019,12,WA47,"Halbstoffe aus Holz usw., Papierabfall",75340000,267616000,342956000
2019,12,WA48,"Papier, Pappe und Waren daraus",1257650000,897796000,2155446000
2019,12,WA49,"Bücher, Zeitungen, Bilddrucke usw.",331106000,256692000,587798000
2019,12,WA50,Seide,1666000,1811000,3477000
2019,12,WA51,"Wolle, feine und grobe Tierhaare",35983000,42654000,78637000
2019,12,WA52,Baumwolle,51464000,50223000,101687000
2019,12,WA53,"Andere pflanzliche Spinnstoffe, Papiergarn",4759000,6414000,11173000
2019,12,WA54,Synthetisches oder künstliches Filament,106988000,85334000,192322000
2019,12,WA55,Synthetische oder künstliche Spinnfaser,117182000,81549000,198731000
2019,12,WA56,"Watte, Filz, Vliesstoff usw., Tauwerk",157042000,93446000,250488000
2019,12,WA57,"Teppiche, Fußbodenbelag aus Spinnstoff",36241000,83342000,119583000
2019,12,WA58,"Spezialgewebe, Spitzen, Tapisserien",30055000,15144000,45199000
2019,12,WA59,"Getränkte, bestrichene usw. Gewebe",149627000,71858000,221485000
2019,12,WA60,Gewirke und Gestricke,46623000,28251000,74874000
2019,12,WA61,"Bekleidung usw. aus Gewirken, Gestricken",790905000,1317559000,2108464000
2019,12,WA62,"Andere Bekleidung, Bekleidungszubehör",777664000,1209574000,1987238000
2019,12,WA63,"Andere Konfektion, Spinnstoffwaren usw.",199384000,294739000,494123000
2019,12,WA64,"Schuhe, Gamaschen, ähnliche Waren",577878000,849177000,1427055000
2019,12,WA65,Kopfbedeckungen und Teile davon,38063000,54777000,92840000
2019,12,WA66,"Schirme, Gehstöcke usw., Peitschen",5394000,14490000,19884000
2019,12,WA67,"Zugerichtete Federn, Daunen, künstliche Blumen",9446000,21733000,31179000
2019,12,WA68,"Waren aus Steinen, Gips, Zement usw.",302411000,206988000,509399000
2019,12,WA69,Keramische Waren,261182000,198643000,459825000
2019,12,WA70,Glas und Glaswaren,420361000,329427000,749788000
2019,12,WA71,"Perlen, Edelsteine, Edelmetalle",1148664000,2058063000,3206727000
2019,12,WA72,Eisen und Stahl,1303985000,1386425000,2690410000
2019,12,WA73,Waren aus Eisen oder Stahl,1798950000,1369038000,3167988000
2019,12,WA74,Kupfer und Waren daraus,717593000,562550000,1280143000
2019,12,WA75,Nickel und Waren daraus,94495000,122709000,217204000
2019,12,WA76,Aluminium und Waren daraus,897299000,911850000,1809149000
2019,12,WA78,Blei und Waren daraus,24212000,40882000,65094000
2019,12,WA79,Zink und Waren daraus,45497000,88571000,134068000
2019,12,WA80,Zinn und Waren daraus,5047000,24195000,29242000
2019,12,WA81,"Andere unedle Metalle, Cermets usw.",96982000,128714000,225696000
2019,12,WA82,"Werkzeuge, Schneidwaren, Essbestecke",589690000,362525000,952215000
2019,12,WA83,Verschiedene Waren aus unedlen Metallen,491452000,322229000,813681000
2019,12,WA84,"Maschinen, Apparate, mechanische Geräte",18468051000,10993942000,29461993000
2019,12,WA85,Elektrotechnische Erzeugnisse,10489302000,10338915000,20828217000
2019,12,WA86,Schienenfahrzeuge,270145000,290604000,560749000
2019,12,WA87,"Kraftfahrzeuge, Landfahrzeuge",14635591000,8752921000,23388512000
2019,12,WA88,"Luftfahrzeuge, Raumfahrzeuge",5133171000,1088163000,6221334000
2019,12,WA89,Wasserfahrzeuge,205127000,222342000,427469000
2019,12,WA90,"Optische, photografische usw. Erzeugnisse",5734074000,3135279000,8869353000
2019,12,WA91,Uhrmacherwaren,144449000,184900000,329349000
2019,12,WA92,Musikinstrumente,68074000,62285000,130359000
2019,12,WA93,Waffen und Munition,34231000,13896000,48127000
2019,12,WA94,"Möbel, Beleuchtungskörper usw.",1174055000,1377557000,2551612000
2019,12,WA95,"Spielzeug, Spiele usw., Sportgeräte",426618000,655322000,1081940000
2019,12,WA96,Verschiedene Waren,298829000,220211000,519040000
2019,12,WA97,"Kunstgegenstände, Sammlungsstücke",62088000,48788000,110876000
2019,12,WA98,Vollständige Fabrikationsanlagen,65694000,0,65694000
2019,12,WA99,Zusammenstellungen verschiedener Waren,1239074000,985274000,2224348000
2020,1,WA01,Lebende Tiere,127842000,169273000,297115000
2020,1,WA02,Fleisch,767977000,584073000,1352050000
2020,1,WA03,"Fische, Krebs- und Weichtiere",137792000,400384000,538176000
2020,1,WA04,"Milch, Milcherzeugnisse, Eier, Honig",858033000,692148000,1550181000
2020,1,WA05,Andere Waren tierischen Ursprungs,76957000,79956000,156913000
2020,1,WA06,"Pflanzen, Waren des Blumenhandels",46474000,206446000,252920000
2020,1,WA07,"Gemüse, Pflanzen für Ernährung",96421000,631652000,728073000
2020,1,WA08,Genießbare Früchte und Nüsse,163611000,895504000,1059115000
2020,1,WA09,"Kaffee, Tee, Mate, Gewürze",230395000,315107000,545502000
2020,1,WA10,Getreide,217791000,261108000,478899000
2020,1,WA11,"Müllereierzeugnisse, Malz usw.",134946000,59791000,194737000
2020,1,WA12,"Ölsamen usw., Heilpflanzen usw.",143569000,484006000,627575000
2020,1,WA13,"Schellack, Gummen, Harz, Pflanzensaft",64951000,50549000,115500000
2020,1,WA14,Flechtstoffe usw. pflanzlichen Ursprungs,659000,4252000,4911000
2020,1,WA15,"Tierische und pflanzliche Fette, Öle, Wachs",219204000,284773000,503977000
2020,1,WA16,"Zubereitungen von Fleisch, Fisch usw.",236608000,257705000,494313000
2020,1,WA17,Zucker und Zuckerwaren,176911000,138314000,315225000
2020,1,WA18,Kakao und Zubereitungen aus Kakao,481501000,388703000,870204000
2020,1,WA19,"Zubereitungen aus Getreide usw., Backwaren",562440000,353271000,915711000
2020,1,WA20,"Zubereitungen von Gemüse, Früchten usw.",232547000,408317000,640864000
2020,1,WA21,Verschiedene Lebensmittelzubereitungen,473981000,291645000,765626000
2020,1,WA22,"Getränke, alkoholhaltige Flüssigkeiten, Essig",445294000,549483000,994777000
2020,1,WA23,"Rückstände der Lebensmittelindustrie, Futter",373369000,347837000,721206000
2020,1,WA24,Tabak,195686000,189701000,385387000
2020,1,WA25,"Salz, Schwefel, Steine, Erden usw.",150711000,143909000,294620000
2020,1,WA26,"Erze, Schlacken, Aschen",37912000,776758000,814670000
2020,1,WA27,Mineralische Brennstoffe usw.,2470599000,8114556000,10585155000
2020,1,WA28,Anorganische chemische Erzeugnisse,949483000,498316000,1447799000
2020,1,WA29,Organische chemische Erzeugnisse,2306690000,3285770000,5592460000
2020,1,WA30,Pharmazeutische Erzeugnisse,6809375000,4356453000,11165828000
2020,1,WA31,Düngemittel,166045000,87271000,253316000
2020,1,WA32,"Gerb- und Farbstoffe, Farben, Lacke usw.",977267000,490801000,1468068000
2020,1,WA33,"Etherische Öle, Riech-, Schönheitsmittel",852619000,609469000,1462088000
2020,1,WA34,"Seifen, Waschmittel usw.",677803000,336573000,1014376000
2020,1,WA35,"Eiweißstoffe, Klebstoffe, Enzyme",312137000,182482000,494619000
2020,1,WA36,"Sprengstoffe, pyrotechnische Artikel usw.",27678000,11457000,39135000
2020,1,WA37,Photochemische Erzeugnisse,95412000,74724000,170136000
2020,1,WA38,Verschiedene Erzeugnisse der Chemischen Industrie,2135020000,1270447000,3405467000
2020,1,WA39,Kunststoffe und Waren daraus,5215843000,3227162000,8443005000
2020,1,WA40,Kautschuk und Waren daraus,1182983000,1087503000,2270486000
2020,1,WA41,"Häute, Felle, Leder",56159000,43468000,99627000
2020,1,WA42,"Lederwaren, Sattlerwaren",228517000,399502000,628019000
2020,1,WA43,"Pelzfelle, künstliches Pelzwerk",4092000,6541000,10633000
2020,1,WA44,"Holz, Holzwaren, Holzkohle",693020000,603138000,1296158000
2020,1,WA45,"Kork, Korkwaren",2542000,8332000,10874000
2020,1,WA46,"Flechtwaren, Korbmacherwaren",4625000,13860000,18485000
2020,1,WA47,"Halbstoffe aus Holz usw., Papierabfall",81807000,235760000,317567000
2020,1,WA48,"Papier, Pappe und Waren daraus",1521632000,1009539000,2531171000
2020,1,WA49,"Bücher, Zeitungen, Bilddrucke usw.",325792000,213430000,539222000
2020,1,WA50,Seide,2007000,2719000,4726000
2020,1,WA51,"Wolle, feine und grobe Tierhaare",37518000,44015000,81533000
2020,1,WA52,Baumwolle,60341000,65501000,125842000
2020,1,WA53,"Andere pflanzliche Spinnstoffe, Papiergarn",4976000,7299000,12275000
2020,1,WA54,Synthetisches oder künstliches Filament,150229000,125928000,276157000
2020,1,WA55,Synthetische oder künstliche Spinnfaser,143207000,114708000,257915000
2020,1,WA56,"Watte, Filz, Vliesstoff usw., Tauwerk",199051000,127718000,326769000
2020,1,WA57,"Teppiche, Fußbodenbelag aus Spinnstoff",49390000,96965000,146355000
2020,1,WA58,"Spezialgewebe, Spitzen, Tapisserien",41919000,20815000,62734000
2020,1,WA59,"Getränkte, bestrichene usw. Gewebe",203515000,95625000,299140000
2020,1,WA60,Gewirke und Gestricke,56389000,37655000,94044000
2020,1,WA61,"Bekleidung usw. aus Gewirken, Gestricken",915471000,1613481000,2528952000
2020,1,WA62,"Andere Bekleidung, Bekleidungszubehör",1021608000,1625412000,2647020000
2020,1,WA63,"Andere Konfektion, Spinnstoffwaren usw.",237014000,381043000,618057000
2020,1,WA64,"Schuhe, Gamaschen, ähnliche Waren",740282000,1141356000,1881638000
2020,1,WA65,Kopfbedeckungen und Teile davon,42752000,64729000,107481000
2020,1,WA66,"Schirme, Gehstöcke usw., Peitschen",8176000,32830000,41006000
2020,1,WA67,"Zugerichtete Federn, Daunen, künstliche Blumen",19637000,28510000,48147000
2020,1,WA68,"Waren aus Steinen, Gips, Zement usw.",427863000,275890000,703753000
2020,1,WA69,Keramische Waren,294593000,227950000,522543000
2020,1,WA70,Glas und Glaswaren,539965000,406771000,946736000
2020,1,WA71,"Perlen, Edelsteine, Edelmetalle",1604877000,2192144000,3797021000
2020,1,WA72,Eisen und Stahl,1824748000,1812032000,3636780000
2020,1,WA73,Waren aus Eisen oder Stahl,2201734000,1688272000,3890006000
2020,1,WA74,Kupfer und Waren daraus,988099000,877264000,1865363000
2020,1,WA75,Nickel und Waren daraus,125058000,123498000,248556000
2020,1,WA76,Aluminium und Waren daraus,1179360000,1224524000,2403884000
2020,1,WA78,Blei und Waren daraus,32225000,34212000,66437000
2020,1,WA79,Zink und Waren daraus,50547000,85552000,136099000
2020,1,WA80,Zinn und Waren daraus,8610000,30161000,38771000
2020,1,WA81,"Andere unedle Metalle, Cermets usw.",127961000,150911000,278872000
2020,1,WA82,"Werkzeuge, Schneidwaren, Essbestecke",712164000,443143000,1155307000
2020,1,WA83,Verschiedene Waren aus unedlen Metallen,639022000,436117000,1075139000
2020,1,WA84,"Maschinen, Apparate, mechanische Geräte",18033056000,12286379000,30319435000
2020,1,WA85,Elektrotechnische Erzeugnisse,11849058000,11680510000,23529568000
2020,1,WA86,Schienenfahrzeuge,289852000,276319000,566171000
2020,1,WA87,"Kraftfahrzeuge, Landfahrzeuge",16900188000,9676523000,26576711000
2020,1,WA88,"Luftfahrzeuge, Raumfahrzeuge",1707055000,1072353000,2779408000
2020,1,WA89,Wasserfahrzeuge,175368000,60182000,235550000
2020,1,WA90,"Optische, photografische usw. Erzeugnisse",5641610000,3369525000,9011135000
2020,1,WA91,Uhrmacherwaren,148267000,190246000,338513000
2020,1,WA92,Musikinstrumente,48852000,60794000,109646000
2020,1,WA93,Waffen und Munition,36042000,19716000,55758000
2020,1,WA94,"Möbel, Beleuchtungskörper usw.",1232036000,1665860000,2897896000
2020,1,WA95,"Spielzeug, Spiele usw., Sportgeräte",308885000,521282000,830167000
2020,1,WA96,Verschiedene Waren,316644000,251642000,568286000
2020,1,WA97,"Kunstgegenstände, Sammlungsstücke",49260000,36380000,85640000
2020,1,WA98,Vollständige Fabrikationsanlagen,111444000,32000,111476000
2020,1,WA99,Zusammenstellungen verschiedener Waren,1322668000,1066115000,2388783000
2020,2,WA01,Lebende Tiere,114976000,156349000,271325000
2020,2,WA02,Fleisch,718919000,563155000,1282074000
2020,2,WA03,"Fische, Krebs- und Weichtiere",116482000,327889000,444371000
2020,2,WA04,"Milch, Milcherzeugnisse, Eier, Honig",816202000,662508000,1478710000
2020,2,WA05,Andere Waren tierischen Ursprungs,75837000,72187000,148024000
2020,2,WA06,"Pflanzen, Waren des Blumenhandels",72696000,250069000,322765000
2020,2,WA07,"Gemüse, Pflanzen für Ernährung",100466000,645977000,746443000
2020,2,WA08,Genießbare Früchte und Nüsse,167321000,858230000,1025551000
2020,2,WA09,"Kaffee, Tee, Mate, Gewürze",225207000,295448000,520655000
2020,2,WA10,Getreide,265162000,267601000,532763000
2020,2,WA11,"Müllereierzeugnisse, Malz usw.",137311000,53764000,191075000
2020,2,WA12,"Ölsamen usw., Heilpflanzen usw.",161344000,507120000,668464000
2020,2,WA13,"Schellack, Gummen, Harz, Pflanzensaft",60741000,50826000,111567000
2020,2,WA14,Flechtstoffe usw. pflanzlichen Ursprungs,826000,4167000,4993000
2020,2,WA15,"Tierische und pflanzliche Fette, Öle, Wachs",220357000,318102000,538459000
2020,2,WA16,"Zubereitungen von Fleisch, Fisch usw.",293588000,279701000,573289000
2020,2,WA17,Zucker und Zuckerwaren,187752000,126810000,314562000
2020,2,WA18,Kakao und Zubereitungen aus Kakao,477643000,371593000,849236000
2020,2,WA19,"Zubereitungen aus Getreide usw., Backwaren",534268000,363325000,897593000
2020,2,WA20,"Zubereitungen von Gemüse, Früchten usw.",257243000,420443000,677686000
2020,2,WA21,Verschiedene Lebensmittelzubereitungen,506697000,307086000,813783000
2020,2,WA22,"Getränke, alkoholhaltige Flüssigkeiten, Essig",429328000,574280000,1003608000
2020,2,WA23,"Rückstände der Lebensmittelindustrie, Futter",393283000,316530000,709813000
2020,2,WA24,Tabak,209324000,174963000,384287000
2020,2,WA25,"Salz, Schwefel, Steine, Erden usw.",161754000,139219000,300973000
2020,2,WA26,"Erze, Schlacken, Aschen",49034000,733700000,782734000
2020,2,WA27,Mineralische Brennstoffe usw.,2548929000,7484900000,10033829000
2020,2,WA28,Anorganische chemische Erzeugnisse,996503000,436277000,1432780000
2020,2,WA29,Organische chemische Erzeugnisse,2095789000,2649217000,4745006000
2020,2,WA30,Pharmazeutische Erzeugnisse,6904339000,4845647000,11749986000
2020,2,WA31,Düngemittel,200440000,100712000,301152000
2020,2,WA32,"Gerb- und Farbstoffe, Farben, Lacke usw.",994829000,474562000,1469391000
2020,2,WA33,"Etherische Öle, Riech-, Schönheitsmittel",802525000,561765000,1364290000
2020,2,WA34,"Seifen, Waschmittel usw.",657292000,338612000,995904000
2020,2,WA35,"Eiweißstoffe, Klebstoffe, Enzyme",293139000,190731000,483870000
2020,2,WA36,"Sprengstoffe, pyrotechnische Artikel usw.",23053000,11657000,34710000
2020,2,WA37,Photochemische Erzeugnisse,91840000,70535000,162375000
2020,2,WA38,Verschiedene Erzeugnisse der Chemischen Industrie,2067903000,1234653000,3302556000
2020,2,WA39,Kunststoffe und Waren daraus,5044938000,3188937000,8233875000
2020,2,WA40,Kautschuk und Waren daraus,1242404000,1079465000,2321869000
2020,2,WA41,"Häute, Felle, Leder",64638000,52917000,117555000
2020,2,WA42,"Lederwaren, Sattlerwaren",204864000,360638000,565502000
2020,2,WA43,"Pelzfelle, künstliches Pelzwerk",7605000,8705000,16310000
2020,2,WA44,"Holz, Holzwaren, Holzkohle",725582000,634782000,1360364000
2020,2,WA45,"Kork, Korkwaren",2343000,8685000,11028000
2020,2,WA46,"Flechtwaren, Korbmacherwaren",4522000,9802000,14324000
2020,2,WA47,"Halbstoffe aus Holz usw., Papierabfall",86120000,229350000,315470000
2020,2,WA48,"Papier, Pappe und Waren daraus",1503886000,924727000,2428613000
2020,2,WA49,"Bücher, Zeitungen, Bilddrucke usw.",310027000,195787000,505814000
2020,2,WA50,Seide,3525000,2979000,6504000
2020,2,WA51,"Wolle, feine und grobe Tierhaare",40956000,45760000,86716000
2020,2,WA52,Baumwolle,61556000,57827000,119383000
2020,2,WA53,"Andere pflanzliche Spinnstoffe, Papiergarn",3831000,5755000,9586000
2020,2,WA54,Synthetisches oder künstliches Filament,146739000,120733000,267472000
2020,2,WA55,Synthetische oder künstliche Spinnfaser,144170000,111660000,255830000
2020,2,WA56,"Watte, Filz, Vliesstoff usw., Tauwerk",208255000,126065000,334320000
2020,2,WA57,"Teppiche, Fußbodenbelag aus Spinnstoff",48738000,89815000,138553000
2020,2,WA58,"Spezialgewebe, Spitzen, Tapisserien",44307000,20511000,64818000
2020,2,WA59,"Getränkte, bestrichene usw. Gewebe",200761000,93085000,293846000
2020,2,WA60,Gewirke und Gestricke,62789000,37348000,100137000
2020,2,WA61,"Bekleidung usw. aus Gewirken, Gestricken",797791000,1296254000,2094045000
2020,2,WA62,"Andere Bekleidung, Bekleidungszubehör",958193000,1396064000,2354257000
2020,2,WA63,"Andere Konfektion, Spinnstoffwaren usw.",267996000,318640000,586636000
2020,2,WA64,"Schuhe, Gamaschen, ähnliche Waren",729113000,1126957000,1856070000
2020,2,WA65,Kopfbedeckungen und Teile davon,42408000,64720000,107128000
2020,2,WA66,"Schirme, Gehstöcke usw., Peitschen",7337000,24815000,32152000
2020,2,WA67,"Zugerichtete Federn, Daunen, künstliche Blumen",14156000,16839000,30995000
2020,2,WA68,"Waren aus Steinen, Gips, Zement usw.",411873000,282702000,694575000
2020,2,WA69,Keramische Waren,276031000,234377000,510408000
2020,2,WA70,Glas und Glaswaren,535246000,423283000,958529000
2020,2,WA71,"Perlen, Edelsteine, Edelmetalle",1633735000,1886113000,3519848000
2020,2,WA72,Eisen und Stahl,1886214000,1864294000,3750508000
2020,2,WA73,Waren aus Eisen oder Stahl,2338777000,1704637000,4043414000
2020,2,WA74,Kupfer und Waren daraus,910066000,727763000,1637829000
2020,2,WA75,Nickel und Waren daraus,120169000,138698000,258867000
2020,2,WA76,Aluminium und Waren daraus,1209051000,1278343000,2487394000
2020,2,WA78,Blei und Waren daraus,34087000,31958000,66045000
2020,2,WA79,Zink und Waren daraus,55626000,101893000,157519000
2020,2,WA80,Zinn und Waren daraus,7264000,29027000,36291000
2020,2,WA81,"Andere unedle Metalle, Cermets usw.",120502000,145164000,265666000
2020,2,WA82,"Werkzeuge, Schneidwaren, Essbestecke",699329000,412462000,1111791000
2020,2,WA83,Verschiedene Waren aus unedlen Metallen,658763000,424051000,1082814000
2020,2,WA84,"Maschinen, Apparate, mechanische Geräte",18351041000,11444578000,29795619000
2020,2,WA85,Elektrotechnische Erzeugnisse,11349437000,10408484000,21757921000
2020,2,WA86,Schienenfahrzeuge,330088000,241297000,571385000
2020,2,WA87,"Kraftfahrzeuge, Landfahrzeuge",18454923000,10026770000,28481693000
2020,2,WA88,"Luftfahrzeuge, Raumfahrzeuge",2504600000,1129470000,3634070000
2020,2,WA89,Wasserfahrzeuge,608721000,89813000,698534000
2020,2,WA90,"Optische, photografische usw. Erzeugnisse",5550566000,3178581000,8729147000
2020,2,WA91,Uhrmacherwaren,126300000,170278000,296578000
2020,2,WA92,Musikinstrumente,57256000,51874000,109130000
2020,2,WA93,Waffen und Munition,36815000,17361000,54176000
2020,2,WA94,"Möbel, Beleuchtungskörper usw.",1344203000,1698219000,3042422000
2020,2,WA95,"Spielzeug, Spiele usw., Sportgeräte",360323000,489321000,849644000
2020,2,WA96,Verschiedene Waren,318732000,236327000,555059000
2020,2,WA97,"Kunstgegenstände, Sammlungsstücke",81732000,47959000,129691000
2020,2,WA98,Vollständige Fabrikationsanlagen,90688000,0,90688000
2020,2,WA99,Zusammenstellungen verschiedener Waren,1265123000,1080620000,2345743000
2020,3,WA01,Lebende Tiere,111566000,179072000,290638000
2020,3,WA02,Fleisch,715825000,591723000,1307548000
2020,3,WA03,"Fische, Krebs- und Weichtiere",113721000,350499000,464220000
2020,3,WA04,"Milch, Milcherzeugnisse, Eier, Honig",838792000,736456000,1575248000
2020,3,WA05,Andere Waren tierischen Ursprungs,87076000,76588000,163664000
2020,3,WA06,"Pflanzen, Waren des Blumenhandels",103223000,275873000,379096000
2020,3,WA07,"Gemüse, Pflanzen für Ernährung",119058000,718976000,838034000
2020,3,WA08,Genießbare Früchte und Nüsse,170358000,952280000,1122638000
2020,3,WA09,"Kaffee, Tee, Mate, Gewürze",258577000,360267000,618844000
2020,3,WA10,Getreide,396912000,287855000,684767000
2020,3,WA11,"Müllereierzeugnisse, Malz usw.",149791000,58341000,208132000
2020,3,WA12,"Ölsamen usw., Heilpflanzen usw.",201788000,426683000,628471000
2020,3,WA13,"Schellack, Gummen, Harz, Pflanzensaft",70860000,60453000,131313000
2020,3,WA14,Flechtstoffe usw. pflanzlichen Ursprungs,659000,4028000,4687000
2020,3,WA15,"Tierische und pflanzliche Fette, Öle, Wachs",227309000,329754000,557063000
2020,3,WA16,"Zubereitungen von Fleisch, Fisch usw.",253425000,277186000,530611000
2020,3,WA17,Zucker und Zuckerwaren,190389000,142493000,332882000
2020,3,WA18,Kakao und Zubereitungen aus Kakao,399310000,383549000,782859000
2020,3,WA19,"Zubereitungen aus Getreide usw., Backwaren",605869000,410537000,1016406000
2020,3,WA20,"Zubereitungen von Gemüse, Früchten usw.",280187000,483156000,763343000
2020,3,WA21,Verschiedene Lebensmittelzubereitungen,554150000,335134000,889284000
2020,3,WA22,"Getränke, alkoholhaltige Flüssigkeiten, Essig",448054000,599857000,1047911000
2020,3,WA23,"Rückstände der Lebensmittelindustrie, Futter",438633000,338195000,776828000
2020,3,WA24,Tabak,232237000,234033000,466270000
2020,3,WA25,"Salz, Schwefel, Steine, Erden usw.",165050000,155260000,320310000
2020,3,WA26,"Erze, Schlacken, Aschen",35630000,842711000,878341000
2020,3,WA27,Mineralische Brennstoffe usw.,2316967000,6715543000,9032510000
2020,3,WA28,Anorganische chemische Erzeugnisse,1048337000,563328000,1611665000
2020,3,WA29,Organische chemische Erzeugnisse,2288689000,3188545000,5477234000
2020,3,WA30,Pharmazeutische Erzeugnisse,8259808000,5646172000,13905980000
2020,3,WA31,Düngemittel,214376000,83632000,298008000
2020,3,WA32,"Gerb- und Farbstoffe, Farben, Lacke usw.",1037298000,516608000,1553906000
2020,3,WA33,"Etherische Öle, Riech-, Schönheitsmittel",808827000,556227000,1365054000
2020,3,WA34,"Seifen, Waschmittel usw.",695322000,364278000,1059600000
2020,3,WA35,"Eiweißstoffe, Klebstoffe, Enzyme",336035000,197442000,533477000
2020,3,WA36,"Sprengstoffe, pyrotechnische Artikel usw.",27019000,12609000,39628000
2020,3,WA37,Photochemische Erzeugnisse,113300000,72699000,185999000
2020,3,WA38,Verschiedene Erzeugnisse der Chemischen Industrie,2155546000,1327155000,3482701000
2020,3,WA39,Kunststoffe und Waren daraus,5306454000,3400555000,8707009000
2020,3,WA40,Kautschuk und Waren daraus,1122977000,1093733000,2216710000
2020,3,WA41,"Häute, Felle, Leder",56428000,47623000,104051000
2020,3,WA42,"Lederwaren, Sattlerwaren",171453000,291018000,462471000
2020,3,WA43,"Pelzfelle, künstliches Pelzwerk",2478000,4311000,6789000
2020,3,WA44,"Holz, Holzwaren, Holzkohle",695561000,661126000,1356687000
2020,3,WA45,"Kork, Korkwaren",2415000,11120000,13535000
2020,3,WA46,"Flechtwaren, Korbmacherwaren",4041000,11548000,15589000
2020,3,WA47,"Halbstoffe aus Holz usw., Papierabfall",72919000,244575000,317494000
2020,3,WA48,"Papier, Pappe und Waren daraus",1523542000,1048670000,2572212000
2020,3,WA49,"Bücher, Zeitungen, Bilddrucke usw.",287166000,200334000,487500000
2020,3,WA50,Seide,2011000,2733000,4744000
2020,3,WA51,"Wolle, feine und grobe Tierhaare",36612000,44310000,80922000
2020,3,WA52,Baumwolle,55072000,62535000,117607000
2020,3,WA53,"Andere pflanzliche Spinnstoffe, Papiergarn",2399000,5790000,8189000
2020,3,WA54,Synthetisches oder künstliches Filament,143016000,129033000,272049000
2020,3,WA55,Synthetische oder künstliche Spinnfaser,140892000,114371000,255263000
2020,3,WA56,"Watte, Filz, Vliesstoff usw., Tauwerk",216046000,140051000,356097000
2020,3,WA57,"Teppiche, Fußbodenbelag aus Spinnstoff",38763000,82813000,121576000
2020,3,WA58,"Spezialgewebe, Spitzen, Tapisserien",38931000,19191000,58122000
2020,3,WA59,"Getränkte, bestrichene usw. Gewebe",210943000,101985000,312928000
2020,3,WA60,Gewirke und Gestricke,60262000,43414000,103676000
2020,3,WA61,"Bekleidung usw. aus Gewirken, Gestricken",687998000,1344883000,2032881000
2020,3,WA62,"Andere Bekleidung, Bekleidungszubehör",810194000,1438316000,2248510000
2020,3,WA63,"Andere Konfektion, Spinnstoffwaren usw.",217922000,396003000,613925000
2020,3,WA64,"Schuhe, Gamaschen, ähnliche Waren",596980000,906206000,1503186000
2020,3,WA65,Kopfbedeckungen und Teile davon,34115000,55047000,89162000
2020,3,WA66,"Schirme, Gehstöcke usw., Peitschen",6359000,25434000,31793000
2020,3,WA67,"Zugerichtete Federn, Daunen, künstliche Blumen",10171000,14395000,24566000
2020,3,WA68,"Waren aus Steinen, Gips, Zement usw.",418581000,284263000,702844000
2020,3,WA69,Keramische Waren,289384000,215302000,504686000
2020,3,WA70,Glas und Glaswaren,517047000,398349000,915396000
2020,3,WA71,"Perlen, Edelsteine, Edelmetalle",1628327000,3065912000,4694239000
2020,3,WA72,Eisen und Stahl,1843307000,1824482000,3667789000
2020,3,WA73,Waren aus Eisen oder Stahl,2260221000,1717234000,3977455000
2020,3,WA74,Kupfer und Waren daraus,912510000,733767000,1646277000
2020,3,WA75,Nickel und Waren daraus,120926000,117889000,238815000
2020,3,WA76,Aluminium und Waren daraus,1216996000,1216673000,2433669000
2020,3,WA78,Blei und Waren daraus,28877000,42102000,70979000
2020,3,WA79,Zink und Waren daraus,55732000,106892000,162624000
2020,3,WA80,Zinn und Waren daraus,8424000,28170000,36594000
2020,3,WA81,"Andere unedle Metalle, Cermets usw.",125911000,145722000,271633000
2020,3,WA82,"Werkzeuge, Schneidwaren, Essbestecke",688463000,411579000,1100042000
2020,3,WA83,Verschiedene Waren aus unedlen Metallen,578104000,388499000,966603000
2020,3,WA84,"Maschinen, Apparate, mechanische Geräte",19308922000,11742522000,31051444000
2020,3,WA85,Elektrotechnische Erzeugnisse,11521600000,10835278000,22356878000
2020,3,WA86,Schienenfahrzeuge,329673000,260302000,589975000
2020,3,WA87,"Kraftfahrzeuge, Landfahrzeuge",15746844000,9116806000,24863650000
2020,3,WA88,"Luftfahrzeuge, Raumfahrzeuge",2204285000,1272825000,3477110000
2020,3,WA89,Wasserfahrzeuge,1123192000,573421000,1696613000
2020,3,WA90,"Optische, photografische usw. Erzeugnisse",5955456000,3384009000,9339465000
2020,3,WA91,Uhrmacherwaren,86317000,118184000,204501000
2020,3,WA92,Musikinstrumente,47403000,57682000,105085000
2020,3,WA93,Waffen und Munition,34987000,19894000,54881000
2020,3,WA94,"Möbel, Beleuchtungskörper usw.",1183574000,1439137000,2622711000
2020,3,WA95,"Spielzeug, Spiele usw., Sportgeräte",336896000,491685000,828581000
2020,3,WA96,Verschiedene Waren,357305000,235271000,592576000
2020,3,WA97,"Kunstgegenstände, Sammlungsstücke",64168000,90846000,155014000
2020,3,WA98,Vollständige Fabrikationsanlagen,118400000,6000,118406000
2020,3,WA99,Zusammenstellungen verschiedener Waren,1134834000,990831000,2125665000
2020,4,WA01,Lebende Tiere,89476000,159806000,249282000
2020,4,WA02,Fleisch,608490000,512749000,1121239000
2020,4,WA03,"Fische, Krebs- und Weichtiere",91996000,257882000,349878000
2020,4,WA04,"Milch, Milcherzeugnisse, Eier, Honig",713263000,629550000,1342813000
2020,4,WA05,Andere Waren tierischen Ursprungs,74159000,61713000,135872000
2020,4,WA06,"Pflanzen, Waren des Blumenhandels",117596000,354707000,472303000
2020,4,WA07,"Gemüse, Pflanzen für Ernährung",103974000,718189000,822163000
2020,4,WA08,Genießbare Früchte und Nüsse,164221000,996279000,1160500000
2020,4,WA09,"Kaffee, Tee, Mate, Gewürze",228736000,377334000,606070000
2020,4,WA10,Getreide,289735000,266180000,555915000
2020,4,WA11,"Müllereierzeugnisse, Malz usw.",141123000,58516000,199639000
2020,4,WA12,"Ölsamen usw., Heilpflanzen usw.",105789000,414301000,520090000
2020,4,WA13,"Schellack, Gummen, Harz, Pflanzensaft",61126000,55895000,117021000
2020,4,WA14,Flechtstoffe usw. pflanzlichen Ursprungs,782000,3364000,4146000
2020,4,WA15,"Tierische und pflanzliche Fette, Öle, Wachs",219854000,296848000,516702000
2020,4,WA16,"Zubereitungen von Fleisch, Fisch usw.",244204000,247378000,491582000
2020,4,WA17,Zucker und Zuckerwaren,172718000,126369000,299087000
2020,4,WA18,Kakao und Zubereitungen aus Kakao,325421000,318403000,643824000
2020,4,WA19,"Zubereitungen aus Getreide usw., Backwaren",540120000,353606000,893726000
2020,4,WA20,"Zubereitungen von Gemüse, Früchten usw.",228641000,471777000,700418000
2020,4,WA21,Verschiedene Lebensmittelzubereitungen,499394000,310610000,810004000
2020,4,WA22,"Getränke, alkoholhaltige Flüssigkeiten, Essig",395797000,529307000,925104000
2020,4,WA23,"Rückstände der Lebensmittelindustrie, Futter",396484000,320909000,717393000
2020,4,WA24,Tabak,188673000,225092000,413765000
2020,4,WA25,"Salz, Schwefel, Steine, Erden usw.",139552000,148736000,288288000
2020,4,WA26,"Erze, Schlacken, Aschen",28786000,580798000,609584000
2020,4,WA27,Mineralische Brennstoffe usw.,1367430000,4200509000,5567939000
2020,4,WA28,Anorganische chemische Erzeugnisse,784856000,463439000,1248295000
2020,4,WA29,Organische chemische Erzeugnisse,2007851000,2859460000,4867311000
2020,4,WA30,Pharmazeutische Erzeugnisse,7010543000,4744818000,11755361000
2020,4,WA31,Düngemittel,191318000,107798000,299116000
2020,4,WA32,"Gerb- und Farbstoffe, Farben, Lacke usw.",785588000,450218000,1235806000
2020,4,WA33,"Etherische Öle, Riech-, Schönheitsmittel",666056000,450055000,1116111000
2020,4,WA34,"Seifen, Waschmittel usw.",615540000,328639000,944179000
2020,4,WA35,"Eiweißstoffe, Klebstoffe, Enzyme",298696000,190354000,489050000
2020,4,WA36,"Sprengstoffe, pyrotechnische Artikel usw.",10954000,10248000,21202000
2020,4,WA37,Photochemische Erzeugnisse,75850000,50930000,126780000
2020,4,WA38,Verschiedene Erzeugnisse der Chemischen Industrie,1826787000,1160074000,2986861000
2020,4,WA39,Kunststoffe und Waren daraus,4220925000,2966570000,7187495000
2020,4,WA40,Kautschuk und Waren daraus,773924000,757365000,1531289000
2020,4,WA41,"Häute, Felle, Leder",27765000,26877000,54642000
2020,4,WA42,"Lederwaren, Sattlerwaren",107412000,189058000,296470000
2020,4,WA43,"Pelzfelle, künstliches Pelzwerk",1309000,2981000,4290000
2020,4,WA44,"Holz, Holzwaren, Holzkohle",604774000,596165000,1200939000
2020,4,WA45,"Kork, Korkwaren",1918000,8433000,10351000
2020,4,WA46,"Flechtwaren, Korbmacherwaren",3251000,10560000,13811000
2020,4,WA47,"Halbstoffe aus Holz usw., Papierabfall",73028000,251842000,324870000
2020,4,WA48,"Papier, Pappe und Waren daraus",1334881000,926888000,2261769000
2020,4,WA49,"Bücher, Zeitungen, Bilddrucke usw.",249396000,160450000,409846000
2020,4,WA50,Seide,703000,2485000,3188000
2020,4,WA51,"Wolle, feine und grobe Tierhaare",15611000,20105000,35716000
2020,4,WA52,Baumwolle,40908000,55899000,96807000
2020,4,WA53,"Andere pflanzliche Spinnstoffe, Papiergarn",1444000,4630000,6074000
2020,4,WA54,Synthetisches oder künstliches Filament,91218000,98615000,189833000
2020,4,WA55,Synthetische oder künstliche Spinnfaser,113502000,93276000,206778000
2020,4,WA56,"Watte, Filz, Vliesstoff usw., Tauwerk",183526000,125030000,308556000
2020,4,WA57,"Teppiche, Fußbodenbelag aus Spinnstoff",22139000,60044000,82183000
2020,4,WA58,"Spezialgewebe, Spitzen, Tapisserien",26908000,15454000,42362000
2020,4,WA59,"Getränkte, bestrichene usw. Gewebe",139991000,76597000,216588000
2020,4,WA60,Gewirke und Gestricke,43006000,32934000,75940000
2020,4,WA61,"Bekleidung usw. aus Gewirken, Gestricken",495357000,908596000,1403953000
2020,4,WA62,"Andere Bekleidung, Bekleidungszubehör",518783000,892567000,1411350000
2020,4,WA63,"Andere Konfektion, Spinnstoffwaren usw.",264448000,1794176000,2058624000
2020,4,WA64,"Schuhe, Gamaschen, ähnliche Waren",356338000,577969000,934307000
2020,4,WA65,Kopfbedeckungen und Teile davon,27995000,41399000,69394000
2020,4,WA66,"Schirme, Gehstöcke usw., Peitschen",6278000,27672000,33950000
2020,4,WA67,"Zugerichtete Federn, Daunen, künstliche Blumen",6056000,9825000,15881000
2020,4,WA68,"Waren aus Steinen, Gips, Zement usw.",340027000,248314000,588341000
2020,4,WA69,Keramische Waren,197434000,201773000,399207000
2020,4,WA70,Glas und Glaswaren,395679000,271091000,666770000
2020,4,WA71,"Perlen, Edelsteine, Edelmetalle",1424549000,2381561000,3806110000
2020,4,WA72,Eisen und Stahl,1303620000,1387480000,2691100000
2020,4,WA73,Waren aus Eisen oder Stahl,1709490000,1433575000,3143065000
2020,4,WA74,Kupfer und Waren daraus,719627000,617457000,1337084000
2020,4,WA75,Nickel und Waren daraus,120886000,122444000,243330000
2020,4,WA76,Aluminium und Waren daraus,891640000,928224000,1819864000
2020,4,WA78,Blei und Waren daraus,32676000,23642000,56318000
2020,4,WA79,Zink und Waren daraus,43213000,96873000,140086000
2020,4,WA80,Zinn und Waren daraus,5713000,25282000,30995000
2020,4,WA81,"Andere unedle Metalle, Cermets usw.",98744000,133295000,232039000
2020,4,WA82,"Werkzeuge, Schneidwaren, Essbestecke",526776000,349081000,875857000
2020,4,WA83,Verschiedene Waren aus unedlen Metallen,422873000,274748000,697621000
2020,4,WA84,"Maschinen, Apparate, mechanische Geräte",13737834000,9602980000,23340814000
2020,4,WA85,Elektrotechnische Erzeugnisse,8814627000,8446936000,17261563000
2020,4,WA86,Schienenfahrzeuge,229065000,271814000,500879000
2020,4,WA87,"Kraftfahrzeuge, Landfahrzeuge",4852534000,3870620000,8723154000
2020,4,WA88,"Luftfahrzeuge, Raumfahrzeuge",856374000,1651363000,2507737000
2020,4,WA89,Wasserfahrzeuge,234998000,67452000,302450000
2020,4,WA90,"Optische, photografische usw. Erzeugnisse",4471002000,2530988000,7001990000
2020,4,WA91,Uhrmacherwaren,60711000,59927000,120638000
2020,4,WA92,Musikinstrumente,43003000,47044000,90047000
2020,4,WA93,Waffen und Munition,28367000,19018000,47385000
2020,4,WA94,"Möbel, Beleuchtungskörper usw.",837493000,1053006000,1890499000
2020,4,WA95,"Spielzeug, Spiele usw., Sportgeräte",372686000,512128000,884814000
2020,4,WA96,Verschiedene Waren,282024000,205043000,487067000
2020,4,WA97,"Kunstgegenstände, Sammlungsstücke",27485000,26314000,53799000
2020,4,WA98,Vollständige Fabrikationsanlagen,98423000,0,98423000
2020,4,WA99,Zusammenstellungen verschiedener Waren,1175734000,846033000,2021767000
2020,5,WA01,Lebende Tiere,75882000,144818000,220700000
2020,5,WA02,Fleisch,583071000,449112000,1032183000
2020,5,WA03,"Fische, Krebs- und Weichtiere",85647000,269969000,355616000
2020,5,WA04,"Milch, Milcherzeugnisse, Eier, Honig",751470000,625001000,1376471000
2020,5,WA05,Andere Waren tierischen Ursprungs,68778000,67859000,136637000
2020,5,WA06,"Pflanzen, Waren des Blumenhandels",114184000,353334000,467518000
2020,5,WA07,"Gemüse, Pflanzen für Ernährung",94154000,594128000,688282000
2020,5,WA08,Genießbare Früchte und Nüsse,168619000,966046000,1134665000
2020,5,WA09,"Kaffee, Tee, Mate, Gewürze",193350000,340312000,533662000
2020,5,WA10,Getreide,219546000,228851000,448397000
2020,5,WA11,"Müllereierzeugnisse, Malz usw.",123624000,55960000,179584000
2020,5,WA12,"Ölsamen usw., Heilpflanzen usw.",86171000,461769000,547940000
2020,5,WA13,"Schellack, Gummen, Harz, Pflanzensaft",62431000,49515000,111946000
2020,5,WA14,Flechtstoffe usw. pflanzlichen Ursprungs,772000,2987000,3759000
2020,5,WA15,"Tierische und pflanzliche Fette, Öle, Wachs",216765000,297003000,513768000
2020,5,WA16,"Zubereitungen von Fleisch, Fisch usw.",257771000,245615000,503386000
2020,5,WA17,Zucker und Zuckerwaren,162702000,120547000,283249000
2020,5,WA18,Kakao und Zubereitungen aus Kakao,297571000,314524000,612095000
2020,5,WA19,"Zubereitungen aus Getreide usw., Backwaren",472719000,317109000,789828000
2020,5,WA20,"Zubereitungen von Gemüse, Früchten usw.",220366000,388722000,609088000
2020,5,WA21,Verschiedene Lebensmittelzubereitungen,509098000,306637000,815735000
2020,5,WA22,"Getränke, alkoholhaltige Flüssigkeiten, Essig",388279000,529514000,917793000
2020,5,WA23,"Rückstände der Lebensmittelindustrie, Futter",391546000,348629000,740175000
2020,5,WA24,Tabak,208632000,242385000,451017000
2020,5,WA25,"Salz, Schwefel, Steine, Erden usw.",144391000,142775000,287166000
2020,5,WA26,"Erze, Schlacken, Aschen",21041000,651546000,672587000
2020,5,WA27,Mineralische Brennstoffe usw.,1360830000,4165593000,5526423000
2020,5,WA28,Anorganische chemische Erzeugnisse,620132000,431028000,1051160000
2020,5,WA29,Organische chemische Erzeugnisse,1796400000,2803392000,4599792000
2020,5,WA30,Pharmazeutische Erzeugnisse,6908506000,4964943000,11873449000
2020,5,WA31,Düngemittel,139252000,67490000,206742000
2020,5,WA32,"Gerb- und Farbstoffe, Farben, Lacke usw.",738941000,453005000,1191946000
2020,5,WA33,"Etherische Öle, Riech-, Schönheitsmittel",604662000,414871000,1019533000
2020,5,WA34,"Seifen, Waschmittel usw.",537946000,332893000,870839000
2020,5,WA35,"Eiweißstoffe, Klebstoffe, Enzyme",261665000,165413000,427078000
2020,5,WA36,"Sprengstoffe, pyrotechnische Artikel usw.",13871000,12160000,26031000
2020,5,WA37,Photochemische Erzeugnisse,68707000,56616000,125323000
2020,5,WA38,Verschiedene Erzeugnisse der Chemischen Industrie,1648807000,1111125000,2759932000
2020,5,WA39,Kunststoffe und Waren daraus,3904745000,2806337000,6711082000
2020,5,WA40,Kautschuk und Waren daraus,793612000,789470000,1583082000
2020,5,WA41,"Häute, Felle, Leder",38090000,24545000,62635000
2020,5,WA42,"Lederwaren, Sattlerwaren",131413000,226740000,358153000
2020,5,WA43,"Pelzfelle, künstliches Pelzwerk",2205000,3695000,5900000
2020,5,WA44,"Holz, Holzwaren, Holzkohle",645386000,594286000,1239672000
2020,5,WA45,"Kork, Korkwaren",2255000,9938000,12193000
2020,5,WA46,"Flechtwaren, Korbmacherwaren",5205000,10204000,15409000
2020,5,WA47,"Halbstoffe aus Holz usw., Papierabfall",70306000,241498000,311804000
2020,5,WA48,"Papier, Pappe und Waren daraus",1199348000,879519000,2078867000
2020,5,WA49,"Bücher, Zeitungen, Bilddrucke usw.",244465000,186022000,430487000
2020,5,WA50,Seide,1826000,1414000,3240000
2020,5,WA51,"Wolle, feine und grobe Tierhaare",32436000,36348000,68784000
2020,5,WA52,Baumwolle,44797000,46746000,91543000
2020,5,WA53,"Andere pflanzliche Spinnstoffe, Papiergarn",1932000,2809000,4741000
2020,5,WA54,Synthetisches oder künstliches Filament,92310000,86034000,178344000
2020,5,WA55,Synthetische oder künstliche Spinnfaser,100324000,91987000,192311000
2020,5,WA56,"Watte, Filz, Vliesstoff usw., Tauwerk",182501000,123657000,306158000
2020,5,WA57,"Teppiche, Fußbodenbelag aus Spinnstoff",29406000,61610000,91016000
2020,5,WA58,"Spezialgewebe, Spitzen, Tapisserien",24022000,17530000,41552000
2020,5,WA59,"Getränkte, bestrichene usw. Gewebe",140089000,76997000,217086000
2020,5,WA60,Gewirke und Gestricke,40515000,31429000,71944000
2020,5,WA61,"Bekleidung usw. aus Gewirken, Gestricken",648362000,897966000,1546328000
2020,5,WA62,"Andere Bekleidung, Bekleidungszubehör",710901000,987777000,1698678000
2020,5,WA63,"Andere Konfektion, Spinnstoffwaren usw.",391919000,2533556000,2925475000
2020,5,WA64,"Schuhe, Gamaschen, ähnliche Waren",430382000,716974000,1147356000
2020,5,WA65,Kopfbedeckungen und Teile davon,38323000,44879000,83202000
2020,5,WA66,"Schirme, Gehstöcke usw., Peitschen",7733000,27162000,34895000
2020,5,WA67,"Zugerichtete Federn, Daunen, künstliche Blumen",6972000,12121000,19093000
2020,5,WA68,"Waren aus Steinen, Gips, Zement usw.",334800000,236143000,570943000
2020,5,WA69,Keramische Waren,206053000,178719000,384772000
2020,5,WA70,Glas und Glaswaren,419549000,300067000,719616000
2020,5,WA71,"Perlen, Edelsteine, Edelmetalle",1335010000,1547612000,2882622000
2020,5,WA72,Eisen und Stahl,1345729000,1381652000,2727381000
2020,5,WA73,Waren aus Eisen oder Stahl,1782881000,1420304000,3203185000
2020,5,WA74,Kupfer und Waren daraus,670687000,593555000,1264242000
2020,5,WA75,Nickel und Waren daraus,110507000,101453000,211960000
2020,5,WA76,Aluminium und Waren daraus,934040000,938083000,1872123000
2020,5,WA78,Blei und Waren daraus,33343000,19768000,53111000
2020,5,WA79,Zink und Waren daraus,41877000,78137000,120014000
2020,5,WA80,Zinn und Waren daraus,6229000,20941000,27170000
2020,5,WA81,"Andere unedle Metalle, Cermets usw.",81800000,105817000,187617000
2020,5,WA82,"Werkzeuge, Schneidwaren, Essbestecke",523104000,360130000,883234000
2020,5,WA83,Verschiedene Waren aus unedlen Metallen,420085000,301433000,721518000
2020,5,WA84,"Maschinen, Apparate, mechanische Geräte",14349070000,9282901000,23631971000
2020,5,WA85,Elektrotechnische Erzeugnisse,8852633000,8882781000,17735414000
2020,5,WA86,Schienenfahrzeuge,309875000,241729000,551604000
2020,5,WA87,"Kraftfahrzeuge, Landfahrzeuge",9125329000,5645563000,14770892000
2020,5,WA88,"Luftfahrzeuge, Raumfahrzeuge",1388785000,752151000,2140936000
2020,5,WA89,Wasserfahrzeuge,678282000,164794000,843076000
2020,5,WA90,"Optische, photografische usw. Erzeugnisse",4371947000,2663941000,7035888000
2020,5,WA91,Uhrmacherwaren,78226000,115965000,194191000
2020,5,WA92,Musikinstrumente,39335000,46238000,85573000
2020,5,WA93,Waffen und Munition,33085000,18926000,52011000
2020,5,WA94,"Möbel, Beleuchtungskörper usw.",989812000,1259776000,2249588000
2020,5,WA95,"Spielzeug, Spiele usw., Sportgeräte",288407000,459623000,748030000
2020,5,WA96,Verschiedene Waren,276269000,211667000,487936000
2020,5,WA97,"Kunstgegenstände, Sammlungsstücke",24432000,20697000,45129000
2020,5,WA98,Vollständige Fabrikationsanlagen,116630000,0,116630000
2020,5,WA99,Zusammenstellungen verschiedener Waren,830215000,880055000,1710270000
2020,6,WA01,Lebende Tiere,99220000,138608000,237828000
2020,6,WA02,Fleisch,583481000,484060000,1067541000
2020,6,WA03,"Fische, Krebs- und Weichtiere",99859000,305491000,405350000
2020,6,WA04,"Milch, Milcherzeugnisse, Eier, Honig",799839000,680380000,1480219000
2020,6,WA05,Andere Waren tierischen Ursprungs,72754000,83724000,156478000
2020,6,WA06,"Pflanzen, Waren des Blumenhandels",75532000,236937000,312469000
2020,6,WA07,"Gemüse, Pflanzen für Ernährung",80477000,518686000,599163000
2020,6,WA08,Genießbare Früchte und Nüsse,173950000,1007902000,1181852000
2020,6,WA09,"Kaffee, Tee, Mate, Gewürze",209625000,355658000,565283000
2020,6,WA10,Getreide,123963000,208758000,332721000
2020,6,WA11,"Müllereierzeugnisse, Malz usw.",134016000,53733000,187749000
2020,6,WA12,"Ölsamen usw., Heilpflanzen usw.",92928000,370641000,463569000
2020,6,WA13,"Schellack, Gummen, Harz, Pflanzensaft",54109000,59705000,113814000
2020,6,WA14,Flechtstoffe usw. pflanzlichen Ursprungs,780000,3805000,4585000
2020,6,WA15,"Tierische und pflanzliche Fette, Öle, Wachs",227861000,302588000,530449000
2020,6,WA16,"Zubereitungen von Fleisch, Fisch usw.",252740000,229357000,482097000
2020,6,WA17,Zucker und Zuckerwaren,168861000,124277000,293138000
2020,6,WA18,Kakao und Zubereitungen aus Kakao,366764000,344364000,711128000
2020,6,WA19,"Zubereitungen aus Getreide usw., Backwaren",524202000,339831000,864033000
2020,6,WA20,"Zubereitungen von Gemüse, Früchten usw.",224220000,375185000,599405000
2020,6,WA21,Verschiedene Lebensmittelzubereitungen,528683000,318527000,847210000
2020,6,WA22,"Getränke, alkoholhaltige Flüssigkeiten, Essig",457879000,590590000,1048469000
2020,6,WA23,"Rückstände der Lebensmittelindustrie, Futter",367729000,329447000,697176000
2020,6,WA24,Tabak,203761000,246021000,449782000
2020,6,WA25,"Salz, Schwefel, Steine, Erden usw.",157049000,131590000,288639000
2020,6,WA26,"Erze, Schlacken, Aschen",32569000,513046000,545615000
2020,6,WA27,Mineralische Brennstoffe usw.,1524334000,4474820000,5999154000
2020,6,WA28,Anorganische chemische Erzeugnisse,651204000,414624000,1065828000
2020,6,WA29,Organische chemische Erzeugnisse,1817145000,3264647000,5081792000
2020,6,WA30,Pharmazeutische Erzeugnisse,6980245000,4876862000,11857107000
2020,6,WA31,Düngemittel,164805000,72867000,237672000
2020,6,WA32,"Gerb- und Farbstoffe, Farben, Lacke usw.",801720000,462154000,1263874000
2020,6,WA33,"Etherische Öle, Riech-, Schönheitsmittel",670321000,478803000,1149124000
2020,6,WA34,"Seifen, Waschmittel usw.",561104000,326533000,887637000
2020,6,WA35,"Eiweißstoffe, Klebstoffe, Enzyme",270262000,148986000,419248000
2020,6,WA36,"Sprengstoffe, pyrotechnische Artikel usw.",17468000,23290000,40758000
2020,6,WA37,Photochemische Erzeugnisse,77224000,51957000,129181000
2020,6,WA38,Verschiedene Erzeugnisse der Chemischen Industrie,1849145000,1217760000,3066905000
2020,6,WA39,Kunststoffe und Waren daraus,4465213000,2985581000,7450794000
2020,6,WA40,Kautschuk und Waren daraus,1050773000,917313000,1968086000
2020,6,WA41,"Häute, Felle, Leder",37575000,31022000,68597000
2020,6,WA42,"Lederwaren, Sattlerwaren",170701000,290510000,461211000
2020,6,WA43,"Pelzfelle, künstliches Pelzwerk",2525000,3382000,5907000
2020,6,WA44,"Holz, Holzwaren, Holzkohle",725317000,655792000,1381109000
2020,6,WA45,"Kork, Korkwaren",1849000,6110000,7959000
2020,6,WA46,"Flechtwaren, Korbmacherwaren",5437000,9389000,14826000
2020,6,WA47,"Halbstoffe aus Holz usw., Papierabfall",74783000,223994000,298777000
2020,6,WA48,"Papier, Pappe und Waren daraus",1311311000,859079000,2170390000
2020,6,WA49,"Bücher, Zeitungen, Bilddrucke usw.",282789000,214432000,497221000
2020,6,WA50,Seide,1725000,3982000,5707000
2020,6,WA51,"Wolle, feine und grobe Tierhaare",31143000,33039000,64182000
2020,6,WA52,Baumwolle,47911000,55991000,103902000
2020,6,WA53,"Andere pflanzliche Spinnstoffe, Papiergarn",2043000,3405000,5448000
2020,6,WA54,Synthetisches oder künstliches Filament,101400000,84945000,186345000
2020,6,WA55,Synthetische oder künstliche Spinnfaser,108412000,90913000,199325000
2020,6,WA56,"Watte, Filz, Vliesstoff usw., Tauwerk",193756000,116657000,310413000
2020,6,WA57,"Teppiche, Fußbodenbelag aus Spinnstoff",36753000,72175000,108928000
2020,6,WA58,"Spezialgewebe, Spitzen, Tapisserien",32024000,18305000,50329000
2020,6,WA59,"Getränkte, bestrichene usw. Gewebe",163273000,77228000,240501000
2020,6,WA60,Gewirke und Gestricke,46463000,31923000,78386000
2020,6,WA61,"Bekleidung usw. aus Gewirken, Gestricken",760913000,1079979000,1840892000
2020,6,WA62,"Andere Bekleidung, Bekleidungszubehör",779334000,1121525000,1900859000
2020,6,WA63,"Andere Konfektion, Spinnstoffwaren usw.",363352000,1167503000,1530855000
2020,6,WA64,"Schuhe, Gamaschen, ähnliche Waren",530100000,840089000,1370189000
2020,6,WA65,Kopfbedeckungen und Teile davon,41406000,51206000,92612000
2020,6,WA66,"Schirme, Gehstöcke usw., Peitschen",9585000,21887000,31472000
2020,6,WA67,"Zugerichtete Federn, Daunen, künstliche Blumen",9759000,15335000,25094000
2020,6,WA68,"Waren aus Steinen, Gips, Zement usw.",369981000,253902000,623883000
2020,6,WA69,Keramische Waren,253636000,219951000,473587000
2020,6,WA70,Glas und Glaswaren,465900000,352332000,818232000
2020,6,WA71,"Perlen, Edelsteine, Edelmetalle",1434789000,1641352000,3076141000
2020,6,WA72,Eisen und Stahl,1460687000,1401209000,2861896000
2020,6,WA73,Waren aus Eisen oder Stahl,2187059000,1538116000,3725175000
2020,6,WA74,Kupfer und Waren daraus,770915000,636120000,1407035000
2020,6,WA75,Nickel und Waren daraus,105281000,103000000,208281000
2020,6,WA76,Aluminium und Waren daraus,1006839000,991901000,1998740000
2020,6,WA78,Blei und Waren daraus,26486000,19324000,45810000
2020,6,WA79,Zink und Waren daraus,50034000,81499000,131533000
2020,6,WA80,Zinn und Waren daraus,5972000,19962000,25934000
2020,6,WA81,"Andere unedle Metalle, Cermets usw.",78676000,110746000,189422000
2020,6,WA82,"Werkzeuge, Schneidwaren, Essbestecke",608341000,373072000,981413000
2020,6,WA83,Verschiedene Waren aus unedlen Metallen,517573000,359214000,876787000
2020,6,WA84,"Maschinen, Apparate, mechanische Geräte",16946785000,10542380000,27489165000
2020,6,WA85,Elektrotechnische Erzeugnisse,10291453000,10207774000,20499227000
2020,6,WA86,Schienenfahrzeuge,279438000,282055000,561493000
2020,6,WA87,"Kraftfahrzeuge, Landfahrzeuge",15260907000,9022233000,24283140000
2020,6,WA88,"Luftfahrzeuge, Raumfahrzeuge",2274027000,629677000,2903704000
2020,6,WA89,Wasserfahrzeuge,342932000,144998000,487930000
2020,6,WA90,"Optische, photografische usw. Erzeugnisse",5129403000,3010276000,8139679000
2020,6,WA91,Uhrmacherwaren,105368000,157183000,262551000
2020,6,WA92,Musikinstrumente,45697000,50377000,96074000
2020,6,WA93,Waffen und Munition,37039000,24571000,61610000
2020,6,WA94,"Möbel, Beleuchtungskörper usw.",1173433000,1463396000,2636829000
2020,6,WA95,"Spielzeug, Spiele usw., Sportgeräte",376178000,565984000,942162000
2020,6,WA96,Verschiedene Waren,311556000,227425000,538981000
2020,6,WA97,"Kunstgegenstände, Sammlungsstücke",60524000,25745000,86269000
2020,6,WA98,Vollständige Fabrikationsanlagen,112021000,0,112021000
2020,6,WA99,Zusammenstellungen verschiedener Waren,990797000,955537000,1946334000
2020,7,WA01,Lebende Tiere,84819000,117931000,202750000
2020,7,WA02,Fleisch,547116000,457462000,1004578000
2020,7,WA03,"Fische, Krebs- und Weichtiere",107088000,280332000,387420000
2020,7,WA04,"Milch, Milcherzeugnisse, Eier, Honig",810672000,671743000,1482415000
2020,7,WA05,Andere Waren tierischen Ursprungs,71276000,75741000,147017000
2020,7,WA06,"Pflanzen, Waren des Blumenhandels",52042000,173173000,225215000
2020,7,WA07,"Gemüse, Pflanzen für Ernährung",83511000,452640000,536151000
2020,7,WA08,Genießbare Früchte und Nüsse,183122000,1005600000,1188722000
2020,7,WA09,"Kaffee, Tee, Mate, Gewürze",252028000,316002000,568030000
2020,7,WA10,Getreide,137076000,200652000,337728000
2020,7,WA11,"Müllereierzeugnisse, Malz usw.",130208000,55817000,186025000
2020,7,WA12,"Ölsamen usw., Heilpflanzen usw.",93918000,386909000,480827000
2020,7,WA13,"Schellack, Gummen, Harz, Pflanzensaft",52048000,46817000,98865000
2020,7,WA14,Flechtstoffe usw. pflanzlichen Ursprungs,731000,4202000,4933000
2020,7,WA15,"Tierische und pflanzliche Fette, Öle, Wachs",221239000,300718000,521957000
2020,7,WA16,"Zubereitungen von Fleisch, Fisch usw.",238289000,259759000,498048000
2020,7,WA17,Zucker und Zuckerwaren,192342000,136293000,328635000
2020,7,WA18,Kakao und Zubereitungen aus Kakao,404716000,399790000,804506000
2020,7,WA19,"Zubereitungen aus Getreide usw., Backwaren",565754000,375409000,941163000
2020,7,WA20,"Zubereitungen von Gemüse, Früchten usw.",254673000,408399000,663072000
2020,7,WA21,Verschiedene Lebensmittelzubereitungen,560482000,332734000,893216000
2020,7,WA22,"Getränke, alkoholhaltige Flüssigkeiten, Essig",505647000,639320000,1144967000
2020,7,WA23,"Rückstände der Lebensmittelindustrie, Futter",367973000,323529000,691502000
2020,7,WA24,Tabak,219552000,225043000,444595000
2020,7,WA25,"Salz, Schwefel, Steine, Erden usw.",155474000,130573000,286047000
2020,7,WA26,"Erze, Schlacken, Aschen",29320000,688898000,718218000
2020,7,WA27,Mineralische Brennstoffe usw.,1624065000,4669120000,6293185000
2020,7,WA28,Anorganische chemische Erzeugnisse,861199000,484201000,1345400000
2020,7,WA29,Organische chemische Erzeugnisse,1753297000,2178011000,3931308000
2020,7,WA30,Pharmazeutische Erzeugnisse,7903772000,4922961000,12826733000
2020,7,WA31,Düngemittel,165770000,64706000,230476000
2020,7,WA32,"Gerb- und Farbstoffe, Farben, Lacke usw.",854925000,487235000,1342160000
2020,7,WA33,"Etherische Öle, Riech-, Schönheitsmittel",699782000,494124000,1193906000
2020,7,WA34,"Seifen, Waschmittel usw.",607578000,333923000,941501000
2020,7,WA35,"Eiweißstoffe, Klebstoffe, Enzyme",305753000,182575000,488328000
2020,7,WA36,"Sprengstoffe, pyrotechnische Artikel usw.",15141000,32387000,47528000
2020,7,WA37,Photochemische Erzeugnisse,77189000,48938000,126127000
2020,7,WA38,Verschiedene Erzeugnisse der Chemischen Industrie,1864208000,1220585000,3084793000
2020,7,WA39,Kunststoffe und Waren daraus,4674995000,3013298000,7688293000
2020,7,WA40,Kautschuk und Waren daraus,1143029000,1034847000,2177876000
2020,7,WA41,"Häute, Felle, Leder",42065000,32857000,74922000
2020,7,WA42,"Lederwaren, Sattlerwaren",183785000,330912000,514697000
2020,7,WA43,"Pelzfelle, künstliches Pelzwerk",3640000,6107000,9747000
2020,7,WA44,"Holz, Holzwaren, Holzkohle",764882000,630869000,1395751000
2020,7,WA45,"Kork, Korkwaren",2663000,5686000,8349000
2020,7,WA46,"Flechtwaren, Korbmacherwaren",4880000,12246000,17126000
2020,7,WA47,"Halbstoffe aus Holz usw., Papierabfall",82533000,217142000,299675000
2020,7,WA48,"Papier, Pappe und Waren daraus",1389141000,899591000,2288732000
2020,7,WA49,"Bücher, Zeitungen, Bilddrucke usw.",295899000,202314000,498213000
2020,7,WA50,Seide,1892000,1968000,3860000
2020,7,WA51,"Wolle, feine und grobe Tierhaare",25945000,33734000,59679000
2020,7,WA52,Baumwolle,42153000,56318000,98471000
2020,7,WA53,"Andere pflanzliche Spinnstoffe, Papiergarn",2173000,3834000,6007000
2020,7,WA54,Synthetisches oder künstliches Filament,108028000,86096000,194124000
2020,7,WA55,Synthetische oder künstliche Spinnfaser,118886000,83931000,202817000
2020,7,WA56,"Watte, Filz, Vliesstoff usw., Tauwerk",204101000,121141000,325242000
2020,7,WA57,"Teppiche, Fußbodenbelag aus Spinnstoff",41896000,87282000,129178000
2020,7,WA58,"Spezialgewebe, Spitzen, Tapisserien",38046000,18719000,56765000
2020,7,WA59,"Getränkte, bestrichene usw. Gewebe",180852000,82027000,262879000
2020,7,WA60,Gewirke und Gestricke,49443000,31367000,80810000
2020,7,WA61,"Bekleidung usw. aus Gewirken, Gestricken",772802000,1420183000,2192985000
2020,7,WA62,"Andere Bekleidung, Bekleidungszubehör",757120000,1429868000,2186988000
2020,7,WA63,"Andere Konfektion, Spinnstoffwaren usw.",336680000,983501000,1320181000
2020,7,WA64,"Schuhe, Gamaschen, ähnliche Waren",713855000,1043130000,1756985000
2020,7,WA65,Kopfbedeckungen und Teile davon,40485000,66581000,107066000
2020,7,WA66,"Schirme, Gehstöcke usw., Peitschen",7328000,18357000,25685000
2020,7,WA67,"Zugerichtete Federn, Daunen, künstliche Blumen",13862000,22989000,36851000
2020,7,WA68,"Waren aus Steinen, Gips, Zement usw.",385705000,256045000,641750000
2020,7,WA69,Keramische Waren,270778000,247150000,517928000
2020,7,WA70,Glas und Glaswaren,536320000,374781000,911101000
2020,7,WA71,"Perlen, Edelsteine, Edelmetalle",1590677000,1882233000,3472910000
2020,7,WA72,Eisen und Stahl,1466437000,1512434000,2978871000
2020,7,WA73,Waren aus Eisen oder Stahl,2070942000,1634550000,3705492000
2020,7,WA74,Kupfer und Waren daraus,809273000,728440000,1537713000
2020,7,WA75,Nickel und Waren daraus,101050000,91369000,192419000
2020,7,WA76,Aluminium und Waren daraus,1040873000,1038641000,2079514000
2020,7,WA78,Blei und Waren daraus,29281000,32605000,61886000
2020,7,WA79,Zink und Waren daraus,54345000,90236000,144581000
2020,7,WA80,Zinn und Waren daraus,5136000,16124000,21260000
2020,7,WA81,"Andere unedle Metalle, Cermets usw.",81009000,94892000,175901000
2020,7,WA82,"Werkzeuge, Schneidwaren, Essbestecke",650401000,413039000,1063440000
2020,7,WA83,Verschiedene Waren aus unedlen Metallen,592684000,405572000,998256000
2020,7,WA84,"Maschinen, Apparate, mechanische Geräte",18040153000,10858322000,28898475000
2020,7,WA85,Elektrotechnische Erzeugnisse,11304671000,10810076000,22114747000
2020,7,WA86,Schienenfahrzeuge,236503000,227064000,463567000
2020,7,WA87,"Kraftfahrzeuge, Landfahrzeuge",16882284000,8968833000,25851117000
2020,7,WA88,"Luftfahrzeuge, Raumfahrzeuge",1981271000,828892000,2810163000
2020,7,WA89,Wasserfahrzeuge,621546000,75595000,697141000
2020,7,WA90,"Optische, photografische usw. Erzeugnisse",5569697000,3099401000,8669098000
2020,7,WA91,Uhrmacherwaren,113162000,186655000,299817000
2020,7,WA92,Musikinstrumente,50127000,53949000,104076000
2020,7,WA93,Waffen und Munition,42138000,23110000,65248000
2020,7,WA94,"Möbel, Beleuchtungskörper usw.",1229646000,1614046000,2843692000
2020,7,WA95,"Spielzeug, Spiele usw., Sportgeräte",390907000,593729000,984636000
2020,7,WA96,Verschiedene Waren,320501000,249882000,570383000
2020,7,WA97,"Kunstgegenstände, Sammlungsstücke",43213000,107331000,150544000
2020,7,WA98,Vollständige Fabrikationsanlagen,98752000,0,98752000
2020,7,WA99,Zusammenstellungen verschiedener Waren,1070508000,1046150000,2116658000
2020,8,WA01,Lebende Tiere,106897000,120507000,227404000
2020,8,WA02,Fleisch,594817000,469356000,1064173000
2020,8,WA03,"Fische, Krebs- und Weichtiere",106728000,285013000,391741000
2020,8,WA04,"Milch, Milcherzeugnisse, Eier, Honig",759487000,669387000,1428874000
2020,8,WA05,Andere Waren tierischen Ursprungs,65905000,70490000,136395000
2020,8,WA06,"Pflanzen, Waren des Blumenhandels",77622000,201902000,279524000
2020,8,WA07,"Gemüse, Pflanzen für Ernährung",98090000,382877000,480967000
2020,8,WA08,Genießbare Früchte und Nüsse,159298000,863676000,1022974000
2020,8,WA09,"Kaffee, Tee, Mate, Gewürze",229763000,263726000,493489000
2020,8,WA10,Getreide,134376000,229951000,364327000
2020,8,WA11,"Müllereierzeugnisse, Malz usw.",126609000,56419000,183028000
2020,8,WA12,"Ölsamen usw., Heilpflanzen usw.",105410000,500182000,605592000
2020,8,WA13,"Schellack, Gummen, Harz, Pflanzensaft",46577000,38981000,85558000
2020,8,WA14,Flechtstoffe usw. pflanzlichen Ursprungs,795000,3445000,4240000
2020,8,WA15,"Tierische und pflanzliche Fette, Öle, Wachs",238651000,287984000,526635000
2020,8,WA16,"Zubereitungen von Fleisch, Fisch usw.",279788000,234954000,514742000
2020,8,WA17,Zucker und Zuckerwaren,183272000,127632000,310904000
2020,8,WA18,Kakao und Zubereitungen aus Kakao,438178000,370259000,808437000
2020,8,WA19,"Zubereitungen aus Getreide usw., Backwaren",557447000,343953000,901400000
2020,8,WA20,"Zubereitungen von Gemüse, Früchten usw.",233177000,378281000,611458000
2020,8,WA21,Verschiedene Lebensmittelzubereitungen,506570000,306603000,813173000
2020,8,WA22,"Getränke, alkoholhaltige Flüssigkeiten, Essig",488139000,596569000,1084708000
2020,8,WA23,"Rückstände der Lebensmittelindustrie, Futter",407730000,332401000,740131000
2020,8,WA24,Tabak,216109000,205403000,421512000
2020,8,WA25,"Salz, Schwefel, Steine, Erden usw.",140316000,137860000,278176000
2020,8,WA26,"Erze, Schlacken, Aschen",28828000,574666000,603494000
2020,8,WA27,Mineralische Brennstoffe usw.,1772243000,4836950000,6609193000
2020,8,WA28,Anorganische chemische Erzeugnisse,746461000,439786000,1186247000
2020,8,WA29,Organische chemische Erzeugnisse,1745150000,2681253000,4426403000
2020,8,WA30,Pharmazeutische Erzeugnisse,6478064000,4164891000,10642955000
2020,8,WA31,Düngemittel,128205000,47928000,176133000
2020,8,WA32,"Gerb- und Farbstoffe, Farben, Lacke usw.",797085000,410007000,1207092000
2020,8,WA33,"Etherische Öle, Riech-, Schönheitsmittel",766894000,588095000,1354989000
2020,8,WA34,"Seifen, Waschmittel usw.",569297000,318595000,887892000
2020,8,WA35,"Eiweißstoffe, Klebstoffe, Enzyme",276987000,169683000,446670000
2020,8,WA36,"Sprengstoffe, pyrotechnische Artikel usw.",19186000,26278000,45464000
2020,8,WA37,Photochemische Erzeugnisse,73943000,46244000,120187000
2020,8,WA38,Verschiedene Erzeugnisse der Chemischen Industrie,1770300000,1202647000,2972947000
2020,8,WA39,Kunststoffe und Waren daraus,4273899000,2830264000,7104163000
2020,8,WA40,Kautschuk und Waren daraus,1075873000,1021910000,2097783000
2020,8,WA41,"Häute, Felle, Leder",32435000,24337000,56772000
2020,8,WA42,"Lederwaren, Sattlerwaren",178613000,300216000,478829000
2020,8,WA43,"Pelzfelle, künstliches Pelzwerk",3871000,7305000,11176000
2020,8,WA44,"Holz, Holzwaren, Holzkohle",703881000,621879000,1325760000
2020,8,WA45,"Kork, Korkwaren",2356000,10931000,13287000
2020,8,WA46,"Flechtwaren, Korbmacherwaren",4695000,12535000,17230000
2020,8,WA47,"Halbstoffe aus Holz usw., Papierabfall",72746000,215892000,288638000
2020,8,WA48,"Papier, Pappe und Waren daraus",1304475000,881689000,2186164000
2020,8,WA49,"Bücher, Zeitungen, Bilddrucke usw.",288266000,214142000,502408000
2020,8,WA50,Seide,593000,2162000,2755000
2020,8,WA51,"Wolle, feine und grobe Tierhaare",19473000,27470000,46943000
2020,8,WA52,Baumwolle,40970000,47060000,88030000
2020,8,WA53,"Andere pflanzliche Spinnstoffe, Papiergarn",1736000,4119000,5855000
2020,8,WA54,Synthetisches oder künstliches Filament,97742000,76107000,173849000
2020,8,WA55,Synthetische oder künstliche Spinnfaser,102160000,80539000,182699000
2020,8,WA56,"Watte, Filz, Vliesstoff usw., Tauwerk",182738000,115138000,297876000
2020,8,WA57,"Teppiche, Fußbodenbelag aus Spinnstoff",38325000,87051000,125376000
2020,8,WA58,"Spezialgewebe, Spitzen, Tapisserien",30633000,16266000,46899000
2020,8,WA59,"Getränkte, bestrichene usw. Gewebe",156522000,76710000,233232000
2020,8,WA60,Gewirke und Gestricke,41082000,26501000,67583000
2020,8,WA61,"Bekleidung usw. aus Gewirken, Gestricken",948411000,1703040000,2651451000
2020,8,WA62,"Andere Bekleidung, Bekleidungszubehör",980357000,1597184000,2577541000
2020,8,WA63,"Andere Konfektion, Spinnstoffwaren usw.",302219000,543599000,845818000
2020,8,WA64,"Schuhe, Gamaschen, ähnliche Waren",684621000,1023851000,1708472000
2020,8,WA65,Kopfbedeckungen und Teile davon,41344000,63687000,105031000
2020,8,WA66,"Schirme, Gehstöcke usw., Peitschen",6357000,13909000,20266000
2020,8,WA67,"Zugerichtete Federn, Daunen, künstliche Blumen",11883000,22636000,34519000
2020,8,WA68,"Waren aus Steinen, Gips, Zement usw.",349687000,249038000,598725000
2020,8,WA69,Keramische Waren,259707000,225260000,484967000
2020,8,WA70,Glas und Glaswaren,467551000,350984000,818535000
2020,8,WA71,"Perlen, Edelsteine, Edelmetalle",1769394000,1660734000,3430128000
2020,8,WA72,Eisen und Stahl,1423639000,1354687000,2778326000
2020,8,WA73,Waren aus Eisen oder Stahl,1883401000,1492739000,3376140000
2020,8,WA74,Kupfer und Waren daraus,812894000,784274000,1597168000
2020,8,WA75,Nickel und Waren daraus,95684000,84207000,179891000
2020,8,WA76,Aluminium und Waren daraus,990730000,991195000,1981925000
2020,8,WA78,Blei und Waren daraus,23675000,27062000,50737000
2020,8,WA79,Zink und Waren daraus,42353000,84340000,126693000
2020,8,WA80,Zinn und Waren daraus,6265000,22082000,28347000
2020,8,WA81,"Andere unedle Metalle, Cermets usw.",78744000,88625000,167369000
2020,8,WA82,"Werkzeuge, Schneidwaren, Essbestecke",564697000,397617000,962314000
2020,8,WA83,Verschiedene Waren aus unedlen Metallen,552053000,349929000,901982000
2020,8,WA84,"Maschinen, Apparate, mechanische Geräte",15550356000,9510878000,25061234000
2020,8,WA85,Elektrotechnische Erzeugnisse,10465897000,10268649000,20734546000
2020,8,WA86,Schienenfahrzeuge,227802000,249090000,476892000
2020,8,WA87,"Kraftfahrzeuge, Landfahrzeuge",12640713000,8762253000,21402966000
2020,8,WA88,"Luftfahrzeuge, Raumfahrzeuge",1379220000,1185063000,2564283000
2020,8,WA89,Wasserfahrzeuge,402224000,32773000,434997000
2020,8,WA90,"Optische, photografische usw. Erzeugnisse",5046277000,2963200000,8009477000
2020,8,WA91,Uhrmacherwaren,110491000,159776000,270267000
2020,8,WA92,Musikinstrumente,43029000,51237000,94266000
2020,8,WA93,Waffen und Munition,35642000,21707000,57349000
2020,8,WA94,"Möbel, Beleuchtungskörper usw.",1106556000,1456107000,2562663000
2020,8,WA95,"Spielzeug, Spiele usw., Sportgeräte",431928000,623627000,1055555000
2020,8,WA96,Verschiedene Waren,307257000,224727000,531984000
2020,8,WA97,"Kunstgegenstände, Sammlungsstücke",42384000,139594000,181978000
2020,8,WA98,Vollständige Fabrikationsanlagen,58617000,0,58617000
2020,8,WA99,Zusammenstellungen verschiedener Waren,971093000,834093000,1805186000
2020,9,WA01,Lebende Tiere,98187000,99153000,197340000
2020,9,WA02,Fleisch,613707000,530437000,1144144000
2020,9,WA03,"Fische, Krebs- und Weichtiere",117708000,329614000,447322000
2020,9,WA04,"Milch, Milcherzeugnisse, Eier, Honig",749766000,697189000,1446955000
2020,9,WA05,Andere Waren tierischen Ursprungs,70181000,73699000,143880000
2020,9,WA06,"Pflanzen, Waren des Blumenhandels",84461000,202677000,287138000
2020,9,WA07,"Gemüse, Pflanzen für Ernährung",93110000,470562000,563672000
2020,9,WA08,Genießbare Früchte und Nüsse,160567000,929944000,1090511000
2020,9,WA09,"Kaffee, Tee, Mate, Gewürze",254803000,305279000,560082000
2020,9,WA10,Getreide,125035000,245611000,370646000
2020,9,WA11,"Müllereierzeugnisse, Malz usw.",142600000,56863000,199463000
2020,9,WA12,"Ölsamen usw., Heilpflanzen usw.",91518000,511901000,603419000
2020,9,WA13,"Schellack, Gummen, Harz, Pflanzensaft",53652000,43491000,97143000
2020,9,WA14,Flechtstoffe usw. pflanzlichen Ursprungs,730000,2705000,3435000
2020,9,WA15,"Tierische und pflanzliche Fette, Öle, Wachs",257339000,301290000,558629000
2020,9,WA16,"Zubereitungen von Fleisch, Fisch usw.",250322000,247281000,497603000
2020,9,WA17,Zucker und Zuckerwaren,203707000,132248000,335955000
2020,9,WA18,Kakao und Zubereitungen aus Kakao,568483000,415195000,983678000
2020,9,WA19,"Zubereitungen aus Getreide usw., Backwaren",564725000,414984000,979709000
2020,9,WA20,"Zubereitungen von Gemüse, Früchten usw.",250053000,434666000,684719000
2020,9,WA21,Verschiedene Lebensmittelzubereitungen,509404000,324273000,833677000
2020,9,WA22,"Getränke, alkoholhaltige Flüssigkeiten, Essig",463535000,696714000,1160249000
2020,9,WA23,"Rückstände der Lebensmittelindustrie, Futter",398511000,289274000,687785000
2020,9,WA24,Tabak,205255000,233959000,439214000
2020,9,WA25,"Salz, Schwefel, Steine, Erden usw.",154795000,130849000,285644000
2020,9,WA26,"Erze, Schlacken, Aschen",35878000,703703000,739581000
2020,9,WA27,Mineralische Brennstoffe usw.,1876062000,5463831000,7339893000
2020,9,WA28,Anorganische chemische Erzeugnisse,890000000,431921000,1321921000
2020,9,WA29,Organische chemische Erzeugnisse,1968599000,2886486000,4855085000
2020,9,WA30,Pharmazeutische Erzeugnisse,7310284000,4623241000,11933525000
2020,9,WA31,Düngemittel,176844000,62292000,239136000
2020,9,WA32,"Gerb- und Farbstoffe, Farben, Lacke usw.",968507000,493242000,1461749000
2020,9,WA33,"Etherische Öle, Riech-, Schönheitsmittel",813676000,596398000,1410074000
2020,9,WA34,"Seifen, Waschmittel usw.",650660000,368371000,1019031000
2020,9,WA35,"Eiweißstoffe, Klebstoffe, Enzyme",324253000,178476000,502729000
2020,9,WA36,"Sprengstoffe, pyrotechnische Artikel usw.",25623000,20758000,46381000
2020,9,WA37,Photochemische Erzeugnisse,86492000,61418000,147910000
2020,9,WA38,Verschiedene Erzeugnisse der Chemischen Industrie,2020590000,1268116000,3288706000
2020,9,WA39,Kunststoffe und Waren daraus,5011880000,3053134000,8065014000
2020,9,WA40,Kautschuk und Waren daraus,1266544000,1170536000,2437080000
2020,9,WA41,"Häute, Felle, Leder",53996000,35054000,89050000
2020,9,WA42,"Lederwaren, Sattlerwaren",202363000,308052000,510415000
2020,9,WA43,"Pelzfelle, künstliches Pelzwerk",6854000,9612000,16466000
2020,9,WA44,"Holz, Holzwaren, Holzkohle",803616000,648555000,1452171000
2020,9,WA45,"Kork, Korkwaren",2892000,7983000,10875000
2020,9,WA46,"Flechtwaren, Korbmacherwaren",4837000,10630000,15467000
2020,9,WA47,"Halbstoffe aus Holz usw., Papierabfall",77564000,228127000,305691000
2020,9,WA48,"Papier, Pappe und Waren daraus",1451952000,899871000,2351823000
2020,9,WA49,"Bücher, Zeitungen, Bilddrucke usw.",350272000,231246000,581518000
2020,9,WA50,Seide,2338000,1544000,3882000
2020,9,WA51,"Wolle, feine und grobe Tierhaare",26702000,27032000,53734000
2020,9,WA52,Baumwolle,49307000,50471000,99778000
2020,9,WA53,"Andere pflanzliche Spinnstoffe, Papiergarn",2395000,4626000,7021000
2020,9,WA54,Synthetisches oder künstliches Filament,125071000,95245000,220316000
2020,9,WA55,Synthetische oder künstliche Spinnfaser,124945000,95560000,220505000
2020,9,WA56,"Watte, Filz, Vliesstoff usw., Tauwerk",210315000,122405000,332720000
2020,9,WA57,"Teppiche, Fußbodenbelag aus Spinnstoff",46219000,93600000,139819000
2020,9,WA58,"Spezialgewebe, Spitzen, Tapisserien",41906000,18216000,60122000
2020,9,WA59,"Getränkte, bestrichene usw. Gewebe",192778000,85354000,278132000
2020,9,WA60,Gewirke und Gestricke,54613000,34695000,89308000
2020,9,WA61,"Bekleidung usw. aus Gewirken, Gestricken",1036546000,1763570000,2800116000
2020,9,WA62,"Andere Bekleidung, Bekleidungszubehör",1060888000,1663051000,2723939000
2020,9,WA63,"Andere Konfektion, Spinnstoffwaren usw.",325970000,568925000,894895000
2020,9,WA64,"Schuhe, Gamaschen, ähnliche Waren",734418000,1011146000,1745564000
2020,9,WA65,Kopfbedeckungen und Teile davon,47510000,66406000,113916000
2020,9,WA66,"Schirme, Gehstöcke usw., Peitschen",7036000,12385000,19421000
2020,9,WA67,"Zugerichtete Federn, Daunen, künstliche Blumen",16054000,21930000,37984000
2020,9,WA68,"Waren aus Steinen, Gips, Zement usw.",407384000,273727000,681111000
2020,9,WA69,Keramische Waren,294301000,239987000,534288000
2020,9,WA70,Glas und Glaswaren,577590000,439021000,1016611000
2020,9,WA71,"Perlen, Edelsteine, Edelmetalle",2044868000,1974107000,4018975000
2020,9,WA72,Eisen und Stahl,1685579000,1641629000,3327208000
2020,9,WA73,Waren aus Eisen oder Stahl,2163137000,1661153000,3824290000
2020,9,WA74,Kupfer und Waren daraus,940163000,749872000,1690035000
2020,9,WA75,Nickel und Waren daraus,104794000,104476000,209270000
2020,9,WA76,Aluminium und Waren daraus,1164657000,1065325000,2229982000
2020,9,WA78,Blei und Waren daraus,25235000,22778000,48013000
2020,9,WA79,Zink und Waren daraus,62318000,104611000,166929000
2020,9,WA80,Zinn und Waren daraus,7111000,22272000,29383000
2020,9,WA81,"Andere unedle Metalle, Cermets usw.",80651000,98139000,178790000
2020,9,WA82,"Werkzeuge, Schneidwaren, Essbestecke",670744000,412036000,1082780000
2020,9,WA83,Verschiedene Waren aus unedlen Metallen,633956000,416055000,1050011000
2020,9,WA84,"Maschinen, Apparate, mechanische Geräte",18450070000,11070241000,29520311000
2020,9,WA85,Elektrotechnische Erzeugnisse,12146934000,11671729000,23818663000
2020,9,WA86,Schienenfahrzeuge,255896000,228974000,484870000
2020,9,WA87,"Kraftfahrzeuge, Landfahrzeuge",18767587000,11075845000,29843432000
2020,9,WA88,"Luftfahrzeuge, Raumfahrzeuge",2111052000,1132564000,3243616000
2020,9,WA89,Wasserfahrzeuge,773615000,230705000,1004320000
2020,9,WA90,"Optische, photografische usw. Erzeugnisse",5948225000,3179526000,9127751000
2020,9,WA91,Uhrmacherwaren,135290000,187725000,323015000
2020,9,WA92,Musikinstrumente,67149000,65721000,132870000
2020,9,WA93,Waffen und Munition,34021000,19441000,53462000
2020,9,WA94,"Möbel, Beleuchtungskörper usw.",1341551000,1707346000,3048897000
2020,9,WA95,"Spielzeug, Spiele usw., Sportgeräte",522185000,710988000,1233173000
2020,9,WA96,Verschiedene Waren,333325000,242442000,575767000
2020,9,WA97,"Kunstgegenstände, Sammlungsstücke",36390000,593036000,629426000
2020,9,WA98,Vollständige Fabrikationsanlagen,90712000,0,90712000
2020,9,WA99,Zusammenstellungen verschiedener Waren,1098331000,976393000,2074724000
2020,10,WA01,Lebende Tiere,102723000,95612000,198335000
2020,10,WA02,Fleisch,563948000,516160000,1080108000
2020,10,WA03,"Fische, Krebs- und Weichtiere",121180000,334127000,455307000
2020,10,WA04,"Milch, Milcherzeugnisse, Eier, Honig",764143000,720496000,1484639000
2020,10,WA05,Andere Waren tierischen Ursprungs,72710000,71447000,144157000
2020,10,WA06,"Pflanzen, Waren des Blumenhandels",79334000,212651000,291985000
2020,10,WA07,"Gemüse, Pflanzen für Ernährung",99134000,465433000,564567000
2020,10,WA08,Genießbare Früchte und Nüsse,166195000,864581000,1030776000
2020,10,WA09,"Kaffee, Tee, Mate, Gewürze",250822000,333289000,584111000
2020,10,WA10,Getreide,172092000,250136000,422228000
2020,10,WA11,"Müllereierzeugnisse, Malz usw.",137950000,57774000,195724000
2020,10,WA12,"Ölsamen usw., Heilpflanzen usw.",98033000,528664000,626697000
2020,10,WA13,"Schellack, Gummen, Harz, Pflanzensaft",52772000,45201000,97973000
2020,10,WA14,Flechtstoffe usw. pflanzlichen Ursprungs,813000,4998000,5811000
2020,10,WA15,"Tierische und pflanzliche Fette, Öle, Wachs",245053000,296312000,541365000
2020,10,WA16,"Zubereitungen von Fleisch, Fisch usw.",261582000,276161000,537743000
2020,10,WA17,Zucker und Zuckerwaren,225522000,137407000,362929000
2020,10,WA18,Kakao und Zubereitungen aus Kakao,574750000,456537000,1031287000
2020,10,WA19,"Zubereitungen aus Getreide usw., Backwaren",623424000,366783000,990207000
2020,10,WA20,"Zubereitungen von Gemüse, Früchten usw.",237871000,457869000,695740000
2020,10,WA21,Verschiedene Lebensmittelzubereitungen,502439000,327401000,829840000
2020,10,WA22,"Getränke, alkoholhaltige Flüssigkeiten, Essig",484297000,690986000,1175283000
2020,10,WA23,"Rückstände der Lebensmittelindustrie, Futter",442548000,346683000,789231000
2020,10,WA24,Tabak,212084000,255983000,468067000
2020,10,WA25,"Salz, Schwefel, Steine, Erden usw.",176691000,139943000,316634000
2020,10,WA26,"Erze, Schlacken, Aschen",39191000,970791000,1009982000
2020,10,WA27,Mineralische Brennstoffe usw.,1951427000,5574931000,7526358000
2020,10,WA28,Anorganische chemische Erzeugnisse,934538000,463284000,1397822000
2020,10,WA29,Organische chemische Erzeugnisse,1813898000,2569298000,4383196000
2020,10,WA30,Pharmazeutische Erzeugnisse,7239415000,5105081000,12344496000
2020,10,WA31,Düngemittel,156587000,77554000,234141000
2020,10,WA32,"Gerb- und Farbstoffe, Farben, Lacke usw.",977589000,508238000,1485827000
2020,10,WA33,"Etherische Öle, Riech-, Schönheitsmittel",846663000,595978000,1442641000
2020,10,WA34,"Seifen, Waschmittel usw.",686124000,383758000,1069882000
2020,10,WA35,"Eiweißstoffe, Klebstoffe, Enzyme",325667000,181771000,507438000
2020,10,WA36,"Sprengstoffe, pyrotechnische Artikel usw.",25352000,14455000,39807000
2020,10,WA37,Photochemische Erzeugnisse,95361000,65538000,160899000
2020,10,WA38,Verschiedene Erzeugnisse der Chemischen Industrie,2105456000,1308608000,3414064000
2020,10,WA39,Kunststoffe und Waren daraus,5092475000,3129992000,8222467000
2020,10,WA40,Kautschuk und Waren daraus,1302298000,1212569000,2514867000
2020,10,WA41,"Häute, Felle, Leder",46555000,35557000,82112000
2020,10,WA42,"Lederwaren, Sattlerwaren",189603000,314863000,504466000
2020,10,WA43,"Pelzfelle, künstliches Pelzwerk",7093000,10340000,17433000
2020,10,WA44,"Holz, Holzwaren, Holzkohle",836132000,675050000,1511182000
2020,10,WA45,"Kork, Korkwaren",1902000,8554000,10456000
2020,10,WA46,"Flechtwaren, Korbmacherwaren",4334000,9741000,14075000
2020,10,WA47,"Halbstoffe aus Holz usw., Papierabfall",76771000,245075000,321846000
2020,10,WA48,"Papier, Pappe und Waren daraus",1461533000,944353000,2405886000
2020,10,WA49,"Bücher, Zeitungen, Bilddrucke usw.",340052000,242218000,582270000
2020,10,WA50,Seide,1721000,1874000,3595000
2020,10,WA51,"Wolle, feine und grobe Tierhaare",26259000,35589000,61848000
2020,10,WA52,Baumwolle,57340000,60120000,117460000
2020,10,WA53,"Andere pflanzliche Spinnstoffe, Papiergarn",3305000,6644000,9949000
2020,10,WA54,Synthetisches oder künstliches Filament,124235000,108393000,232628000
2020,10,WA55,Synthetische oder künstliche Spinnfaser,134643000,108536000,243179000
2020,10,WA56,"Watte, Filz, Vliesstoff usw., Tauwerk",216605000,126026000,342631000
2020,10,WA57,"Teppiche, Fußbodenbelag aus Spinnstoff",52924000,107718000,160642000
2020,10,WA58,"Spezialgewebe, Spitzen, Tapisserien",45630000,21617000,67247000
2020,10,WA59,"Getränkte, bestrichene usw. Gewebe",204059000,89806000,293865000
2020,10,WA60,Gewirke und Gestricke,55669000,37748000,93417000
2020,10,WA61,"Bekleidung usw. aus Gewirken, Gestricken",982147000,1697640000,2679787000
2020,10,WA62,"Andere Bekleidung, Bekleidungszubehör",995684000,1431000000,2426684000
2020,10,WA63,"Andere Konfektion, Spinnstoffwaren usw.",323198000,555617000,878815000
2020,10,WA64,"Schuhe, Gamaschen, ähnliche Waren",654614000,928205000,1582819000
2020,10,WA65,Kopfbedeckungen und Teile davon,52457000,66319000,118776000
2020,10,WA66,"Schirme, Gehstöcke usw., Peitschen",7018000,11484000,18502000
2020,10,WA67,"Zugerichtete Federn, Daunen, künstliche Blumen",17206000,19157000,36363000
2020,10,WA68,"Waren aus Steinen, Gips, Zement usw.",424385000,292674000,717059000
2020,10,WA69,Keramische Waren,312018000,240967000,552985000
2020,10,WA70,Glas und Glaswaren,588695000,432282000,1020977000
2020,10,WA71,"Perlen, Edelsteine, Edelmetalle",1808372000,2336520000,4144892000
2020,10,WA72,Eisen und Stahl,1766982000,1685933000,3452915000
2020,10,WA73,Waren aus Eisen oder Stahl,2217293000,1725782000,3943075000
2020,10,WA74,Kupfer und Waren daraus,932100000,850241000,1782341000
2020,10,WA75,Nickel und Waren daraus,104710000,122023000,226733000
2020,10,WA76,Aluminium und Waren daraus,1177519000,1201713000,2379232000
2020,10,WA78,Blei und Waren daraus,31749000,35494000,67243000
2020,10,WA79,Zink und Waren daraus,60712000,99310000,160022000
2020,10,WA80,Zinn und Waren daraus,8506000,26501000,35007000
2020,10,WA81,"Andere unedle Metalle, Cermets usw.",88625000,113277000,201902000
2020,10,WA82,"Werkzeuge, Schneidwaren, Essbestecke",677832000,432895000,1110727000
2020,10,WA83,Verschiedene Waren aus unedlen Metallen,684187000,440571000,1124758000
2020,10,WA84,"Maschinen, Apparate, mechanische Geräte",18676585000,11898100000,30574685000
2020,10,WA85,Elektrotechnische Erzeugnisse,12393428000,12497400000,24890828000
2020,10,WA86,Schienenfahrzeuge,428693000,227586000,656279000
2020,10,WA87,"Kraftfahrzeuge, Landfahrzeuge",20361441000,11236077000,31597518000
2020,10,WA88,"Luftfahrzeuge, Raumfahrzeuge",2320474000,678918000,2999392000
2020,10,WA89,Wasserfahrzeuge,152580000,32484000,185064000
2020,10,WA90,"Optische, photografische usw. Erzeugnisse",5789449000,3361586000,9151035000
2020,10,WA91,Uhrmacherwaren,151783000,211407000,363190000
2020,10,WA92,Musikinstrumente,62541000,69513000,132054000
2020,10,WA93,Waffen und Munition,46313000,19980000,66293000
2020,10,WA94,"Möbel, Beleuchtungskörper usw.",1415577000,1780345000,3195922000
2020,10,WA95,"Spielzeug, Spiele usw., Sportgeräte",627461000,886731000,1514192000
2020,10,WA96,Verschiedene Waren,339472000,258941000,598413000
2020,10,WA97,"Kunstgegenstände, Sammlungsstücke",50470000,39343000,89813000
2020,10,WA98,Vollständige Fabrikationsanlagen,76379000,838000,77217000
2020,10,WA99,Zusammenstellungen verschiedener Waren,1238197000,994220000,2232417000
2020,11,WA01,Lebende Tiere,92843000,91590000,184433000
2020,11,WA02,Fleisch,495026000,519087000,1014113000
2020,11,WA03,"Fische, Krebs- und Weichtiere",113412000,324162000,437574000
2020,11,WA04,"Milch, Milcherzeugnisse, Eier, Honig",727096000,733793000,1460889000
2020,11,WA05,Andere Waren tierischen Ursprungs,72110000,77274000,149384000
2020,11,WA06,"Pflanzen, Waren des Blumenhandels",64273000,238940000,303213000
2020,11,WA07,"Gemüse, Pflanzen für Ernährung",85426000,518813000,604239000
2020,11,WA08,Genießbare Früchte und Nüsse,167758000,883613000,1051371000
2020,11,WA09,"Kaffee, Tee, Mate, Gewürze",238065000,342328000,580393000
2020,11,WA10,Getreide,259437000,269799000,529236000
2020,11,WA11,"Müllereierzeugnisse, Malz usw.",142347000,62405000,204752000
2020,11,WA12,"Ölsamen usw., Heilpflanzen usw.",120794000,520733000,641527000
2020,11,WA13,"Schellack, Gummen, Harz, Pflanzensaft",53138000,45792000,98930000
2020,11,WA14,Flechtstoffe usw. pflanzlichen Ursprungs,646000,2301000,2947000
2020,11,WA15,"Tierische und pflanzliche Fette, Öle, Wachs",241168000,322636000,563804000
2020,11,WA16,"Zubereitungen von Fleisch, Fisch usw.",241610000,280616000,522226000
2020,11,WA17,Zucker und Zuckerwaren,236770000,132521000,369291000
2020,11,WA18,Kakao und Zubereitungen aus Kakao,500262000,409719000,909981000
2020,11,WA19,"Zubereitungen aus Getreide usw., Backwaren",565342000,413139000,978481000
2020,11,WA20,"Zubereitungen von Gemüse, Früchten usw.",241516000,462609000,704125000
2020,11,WA21,Verschiedene Lebensmittelzubereitungen,505611000,325101000,830712000
2020,11,WA22,"Getränke, alkoholhaltige Flüssigkeiten, Essig",450175000,717090000,1167265000
2020,11,WA23,"Rückstände der Lebensmittelindustrie, Futter",473806000,381863000,855669000
2020,11,WA24,Tabak,208931000,233833000,442764000
2020,11,WA25,"Salz, Schwefel, Steine, Erden usw.",172713000,148101000,320814000
2020,11,WA26,"Erze, Schlacken, Aschen",49330000,849083000,898413000
2020,11,WA27,Mineralische Brennstoffe usw.,2043333000,5629585000,7672918000
2020,11,WA28,Anorganische chemische Erzeugnisse,1035891000,455356000,1491247000
2020,11,WA29,Organische chemische Erzeugnisse,2038354000,1947206000,3985560000
2020,11,WA30,Pharmazeutische Erzeugnisse,7509214000,5137486000,12646700000
2020,11,WA31,Düngemittel,168088000,83623000,251711000
2020,11,WA32,"Gerb- und Farbstoffe, Farben, Lacke usw.",996765000,487598000,1484363000
2020,11,WA33,"Etherische Öle, Riech-, Schönheitsmittel",828808000,621370000,1450178000
2020,11,WA34,"Seifen, Waschmittel usw.",679373000,386411000,1065784000
2020,11,WA35,"Eiweißstoffe, Klebstoffe, Enzyme",340828000,193037000,533865000
2020,11,WA36,"Sprengstoffe, pyrotechnische Artikel usw.",27398000,22384000,49782000
2020,11,WA37,Photochemische Erzeugnisse,96837000,68634000,165471000
2020,11,WA38,Verschiedene Erzeugnisse der Chemischen Industrie,2202918000,1482451000,3685369000
2020,11,WA39,Kunststoffe und Waren daraus,5122218000,3286954000,8409172000
2020,11,WA40,Kautschuk und Waren daraus,1246546000,1207396000,2453942000
2020,11,WA41,"Häute, Felle, Leder",53182000,41722000,94904000
2020,11,WA42,"Lederwaren, Sattlerwaren",198171000,336429000,534600000
2020,11,WA43,"Pelzfelle, künstliches Pelzwerk",5628000,9260000,14888000
2020,11,WA44,"Holz, Holzwaren, Holzkohle",814663000,714053000,1528716000
2020,11,WA45,"Kork, Korkwaren",2888000,7245000,10133000
2020,11,WA46,"Flechtwaren, Korbmacherwaren",3918000,9257000,13175000
2020,11,WA47,"Halbstoffe aus Holz usw., Papierabfall",78285000,252684000,330969000
2020,11,WA48,"Papier, Pappe und Waren daraus",1525108000,984187000,2509295000
2020,11,WA49,"Bücher, Zeitungen, Bilddrucke usw.",355716000,267986000,623702000
2020,11,WA50,Seide,2435000,1873000,4308000
2020,11,WA51,"Wolle, feine und grobe Tierhaare",30514000,34200000,64714000
2020,11,WA52,Baumwolle,58320000,60773000,119093000
2020,11,WA53,"Andere pflanzliche Spinnstoffe, Papiergarn",4938000,7899000,12837000
2020,11,WA54,Synthetisches oder künstliches Filament,133470000,100011000,233481000
2020,11,WA55,Synthetische oder künstliche Spinnfaser,130206000,102647000,232853000
2020,11,WA56,"Watte, Filz, Vliesstoff usw., Tauwerk",214706000,131978000,346684000
2020,11,WA57,"Teppiche, Fußbodenbelag aus Spinnstoff",48934000,109562000,158496000
2020,11,WA58,"Spezialgewebe, Spitzen, Tapisserien",41248000,19456000,60704000
2020,11,WA59,"Getränkte, bestrichene usw. Gewebe",198393000,91657000,290050000
2020,11,WA60,Gewirke und Gestricke,58807000,39144000,97951000
2020,11,WA61,"Bekleidung usw. aus Gewirken, Gestricken",808990000,1518342000,2327332000
2020,11,WA62,"Andere Bekleidung, Bekleidungszubehör",738870000,1214287000,1953157000
2020,11,WA63,"Andere Konfektion, Spinnstoffwaren usw.",364402000,567435000,931837000
2020,11,WA64,"Schuhe, Gamaschen, ähnliche Waren",554109000,809345000,1363454000
2020,11,WA65,Kopfbedeckungen und Teile davon,42931000,62992000,105923000
2020,11,WA66,"Schirme, Gehstöcke usw., Peitschen",5064000,12770000,17834000
2020,11,WA67,"Zugerichtete Federn, Daunen, künstliche Blumen",11547000,16487000,28034000
2020,11,WA68,"Waren aus Steinen, Gips, Zement usw.",424490000,291226000,715716000
2020,11,WA69,Keramische Waren,310412000,276186000,586598000
2020,11,WA70,Glas und Glaswaren,557593000,434486000,992079000
2020,11,WA71,"Perlen, Edelsteine, Edelmetalle",1858183000,2534672000,4392855000
2020,11,WA72,Eisen und Stahl,1843331000,1774250000,3617581000
2020,11,WA73,Waren aus Eisen oder Stahl,2251967000,1735706000,3987673000
2020,11,WA74,Kupfer und Waren daraus,922589000,856807000,1779396000
2020,11,WA75,Nickel und Waren daraus,94242000,108913000,203155000
2020,11,WA76,Aluminium und Waren daraus,1141717000,1240054000,2381771000
2020,11,WA78,Blei und Waren daraus,41731000,37158000,78889000
2020,11,WA79,Zink und Waren daraus,61838000,123850000,185688000
2020,11,WA80,Zinn und Waren daraus,6895000,23484000,30379000
2020,11,WA81,"Andere unedle Metalle, Cermets usw.",95517000,104231000,199748000
2020,11,WA82,"Werkzeuge, Schneidwaren, Essbestecke",724594000,442152000,1166746000
2020,11,WA83,Verschiedene Waren aus unedlen Metallen,659392000,431163000,1090555000
2020,11,WA84,"Maschinen, Apparate, mechanische Geräte",19103940000,12212016000,31315956000
2020,11,WA85,Elektrotechnische Erzeugnisse,12756442000,13606549000,26362991000
2020,11,WA86,Schienenfahrzeuge,249714000,188896000,438610000
2020,11,WA87,"Kraftfahrzeuge, Landfahrzeuge",18854398000,11655687000,30510085000
2020,11,WA88,"Luftfahrzeuge, Raumfahrzeuge",2398522000,1351834000,3750356000
2020,11,WA89,Wasserfahrzeuge,70854000,99623000,170477000
2020,11,WA90,"Optische, photografische usw. Erzeugnisse",6086154000,3449967000,9536121000
2020,11,WA91,Uhrmacherwaren,151688000,227807000,379495000
2020,11,WA92,Musikinstrumente,65482000,73230000,138712000
2020,11,WA93,Waffen und Munition,47095000,17880000,64975000
2020,11,WA94,"Möbel, Beleuchtungskörper usw.",1445924000,1777201000,3223125000
2020,11,WA95,"Spielzeug, Spiele usw., Sportgeräte",696120000,1031704000,1727824000
2020,11,WA96,Verschiedene Waren,341290000,272179000,613469000
2020,11,WA97,"Kunstgegenstände, Sammlungsstücke",84414000,39464000,123878000
2020,11,WA98,Vollständige Fabrikationsanlagen,95883000,0,95883000
2020,11,WA99,Zusammenstellungen verschiedener Waren,1295095000,1034276000,2329371000
2020,12,WA01,Lebende Tiere,99533000,91237000,190770000
2020,12,WA02,Fleisch,520414000,514212000,1034626000
2020,12,WA03,"Fische, Krebs- und Weichtiere",122966000,336204000,459170000
2020,12,WA04,"Milch, Milcherzeugnisse, Eier, Honig",744784000,733493000,1478277000
2020,12,WA05,Andere Waren tierischen Ursprungs,57234000,80711000,137945000
2020,12,WA06,"Pflanzen, Waren des Blumenhandels",59344000,188252000,247596000
2020,12,WA07,"Gemüse, Pflanzen für Ernährung",75727000,552643000,628370000
2020,12,WA08,Genießbare Früchte und Nüsse,156512000,842647000,999159000
2020,12,WA09,"Kaffee, Tee, Mate, Gewürze",270361000,291108000,561469000
2020,12,WA10,Getreide,297615000,242593000,540208000
2020,12,WA11,"Müllereierzeugnisse, Malz usw.",123304000,56071000,179375000
2020,12,WA12,"Ölsamen usw., Heilpflanzen usw.",100488000,541992000,642480000
2020,12,WA13,"Schellack, Gummen, Harz, Pflanzensaft",43880000,44199000,88079000
2020,12,WA14,Flechtstoffe usw. pflanzlichen Ursprungs,577000,2867000,3444000
2020,12,WA15,"Tierische und pflanzliche Fette, Öle, Wachs",240490000,286634000,527124000
2020,12,WA16,"Zubereitungen von Fleisch, Fisch usw.",237919000,260563000,498482000
2020,12,WA17,Zucker und Zuckerwaren,191377000,114525000,305902000
2020,12,WA18,Kakao und Zubereitungen aus Kakao,429074000,299107000,728181000
2020,12,WA19,"Zubereitungen aus Getreide usw., Backwaren",507431000,351854000,859285000
2020,12,WA20,"Zubereitungen von Gemüse, Früchten usw.",238611000,394929000,633540000
2020,12,WA21,Verschiedene Lebensmittelzubereitungen,489152000,282799000,771951000
2020,12,WA22,"Getränke, alkoholhaltige Flüssigkeiten, Essig",394593000,619741000,1014334000
2020,12,WA23,"Rückstände der Lebensmittelindustrie, Futter",444734000,338581000,783315000
2020,12,WA24,Tabak,163438000,201150000,364588000
2020,12,WA25,"Salz, Schwefel, Steine, Erden usw.",128923000,119594000,248517000
2020,12,WA26,"Erze, Schlacken, Aschen",46070000,874696000,920766000
2020,12,WA27,Mineralische Brennstoffe usw.,2163770000,5791897000,7955667000
2020,12,WA28,Anorganische chemische Erzeugnisse,844790000,446669000,1291459000
2020,12,WA29,Organische chemische Erzeugnisse,1878836000,2787826000,4666662000
2020,12,WA30,Pharmazeutische Erzeugnisse,6404999000,4167037000,10572036000
2020,12,WA31,Düngemittel,158139000,73187000,231326000
2020,12,WA32,"Gerb- und Farbstoffe, Farben, Lacke usw.",785316000,434111000,1219427000
2020,12,WA33,"Etherische Öle, Riech-, Schönheitsmittel",675087000,529333000,1204420000
2020,12,WA34,"Seifen, Waschmittel usw.",570523000,337549000,908072000
2020,12,WA35,"Eiweißstoffe, Klebstoffe, Enzyme",270906000,164546000,435452000
2020,12,WA36,"Sprengstoffe, pyrotechnische Artikel usw.",24897000,12785000,37682000
2020,12,WA37,Photochemische Erzeugnisse,87219000,62469000,149688000
2020,12,WA38,Verschiedene Erzeugnisse der Chemischen Industrie,2061435000,1602330000,3663765000
2020,12,WA39,Kunststoffe und Waren daraus,4128749000,2748002000,6876751000
2020,12,WA40,Kautschuk und Waren daraus,1023043000,923759000,1946802000
2020,12,WA41,"Häute, Felle, Leder",39186000,31833000,71019000
2020,12,WA42,"Lederwaren, Sattlerwaren",180785000,312322000,493107000
2020,12,WA43,"Pelzfelle, künstliches Pelzwerk",5128000,7613000,12741000
2020,12,WA44,"Holz, Holzwaren, Holzkohle",643968000,542784000,1186752000
2020,12,WA45,"Kork, Korkwaren",2303000,8103000,10406000
2020,12,WA46,"Flechtwaren, Korbmacherwaren",3637000,10924000,14561000
2020,12,WA47,"Halbstoffe aus Holz usw., Papierabfall",67686000,246319000,314005000
2020,12,WA48,"Papier, Pappe und Waren daraus",1268458000,885738000,2154196000
2020,12,WA49,"Bücher, Zeitungen, Bilddrucke usw.",340132000,290222000,630354000
2020,12,WA50,Seide,1156000,1941000,3097000
2020,12,WA51,"Wolle, feine und grobe Tierhaare",26608000,25942000,52550000
2020,12,WA52,Baumwolle,45180000,48081000,93261000
2020,12,WA53,"Andere pflanzliche Spinnstoffe, Papiergarn",3101000,5820000,8921000
2020,12,WA54,Synthetisches oder künstliches Filament,100067000,83763000,183830000
2020,12,WA55,Synthetische oder künstliche Spinnfaser,112199000,79771000,191970000
2020,12,WA56,"Watte, Filz, Vliesstoff usw., Tauwerk",168130000,112030000,280160000
2020,12,WA57,"Teppiche, Fußbodenbelag aus Spinnstoff",39503000,97030000,136533000
2020,12,WA58,"Spezialgewebe, Spitzen, Tapisserien",33571000,16510000,50081000
2020,12,WA59,"Getränkte, bestrichene usw. Gewebe",159458000,76983000,236441000
2020,12,WA60,Gewirke und Gestricke,44489000,29554000,74043000
2020,12,WA61,"Bekleidung usw. aus Gewirken, Gestricken",830307000,1314800000,2145107000
2020,12,WA62,"Andere Bekleidung, Bekleidungszubehör",727660000,1084741000,1812401000
2020,12,WA63,"Andere Konfektion, Spinnstoffwaren usw.",275100000,598962000,874062000
2020,12,WA64,"Schuhe, Gamaschen, ähnliche Waren",507985000,767441000,1275426000
2020,12,WA65,Kopfbedeckungen und Teile davon,37801000,53533000,91334000
2020,12,WA66,"Schirme, Gehstöcke usw., Peitschen",5141000,15575000,20716000
2020,12,WA67,"Zugerichtete Federn, Daunen, künstliche Blumen",10465000,19746000,30211000
2020,12,WA68,"Waren aus Steinen, Gips, Zement usw.",318850000,218401000,537251000
2020,12,WA69,Keramische Waren,260860000,211993000,472853000
2020,12,WA70,Glas und Glaswaren,433195000,360404000,793599000
2020,12,WA71,"Perlen, Edelsteine, Edelmetalle",1699320000,2377668000,4076988000
2020,12,WA72,Eisen und Stahl,1491425000,1306737000,2798162000
2020,12,WA73,Waren aus Eisen oder Stahl,1790422000,1520981000,3311403000
2020,12,WA74,Kupfer und Waren daraus,706740000,655284000,1362024000
2020,12,WA75,Nickel und Waren daraus,81340000,88977000,170317000
2020,12,WA76,Aluminium und Waren daraus,961230000,975574000,1936804000
2020,12,WA78,Blei und Waren daraus,27547000,36194000,63741000
2020,12,WA79,Zink und Waren daraus,50157000,86333000,136490000
2020,12,WA80,Zinn und Waren daraus,6316000,24230000,30546000
2020,12,WA81,"Andere unedle Metalle, Cermets usw.",78506000,99145000,177651000
2020,12,WA82,"Werkzeuge, Schneidwaren, Essbestecke",613789000,401745000,1015534000
2020,12,WA83,Verschiedene Waren aus unedlen Metallen,502063000,365094000,867157000
2020,12,WA84,"Maschinen, Apparate, mechanische Geräte",17819741000,11532954000,29352695000
2020,12,WA85,Elektrotechnische Erzeugnisse,11396233000,11892534000,23288767000
2020,12,WA86,Schienenfahrzeuge,338483000,370817000,709300000
2020,12,WA87,"Kraftfahrzeuge, Landfahrzeuge",16370588000,9315661000,25686249000
2020,12,WA88,"Luftfahrzeuge, Raumfahrzeuge",3982521000,783409000,4765930000
2020,12,WA89,Wasserfahrzeuge,309167000,656723000,965890000
2020,12,WA90,"Optische, photografische usw. Erzeugnisse",5573451000,3220046000,8793497000
2020,12,WA91,Uhrmacherwaren,162787000,207376000,370163000
2020,12,WA92,Musikinstrumente,62024000,62448000,124472000
2020,12,WA93,Waffen und Munition,57007000,20150000,77157000
2020,12,WA94,"Möbel, Beleuchtungskörper usw.",1121262000,1601237000,2722499000
2020,12,WA95,"Spielzeug, Spiele usw., Sportgeräte",450846000,789744000,1240590000
2020,12,WA96,Verschiedene Waren,300824000,259307000,560131000
2020,12,WA97,"Kunstgegenstände, Sammlungsstücke",63433000,74248000,137681000
2020,12,WA98,Vollständige Fabrikationsanlagen,70955000,6511000,77466000
2020,12,WA99,Zusammenstellungen verschiedener Waren,1169065000,1062083000,2231148000
2021,1,WA01,Lebende Tiere,84016000,93580000,177596000
2021,1,WA02,Fleisch,477048000,410051000,887099000
2021,1,WA03,"Fische, Krebs- und Weichtiere",92442000,275321000,367763000
2021,1,WA04,"Milch, Milcherzeugnisse, Eier, Honig",728368000,642568000,1370936000
2021,1,WA05,Andere Waren tierischen Ursprungs,67586000,68727000,136313000
2021,1,WA06,"Pflanzen, Waren des Blumenhandels",36713000,181232000,217945000
2021,1,WA07,"Gemüse, Pflanzen für Ernährung",74766000,636986000,711752000
2021,1,WA08,Genießbare Früchte und Nüsse,151013000,831955000,982968000
2021,1,WA09,"Kaffee, Tee, Mate, Gewürze",228223000,351243000,579466000
2021,1,WA10,Getreide,221165000,237997000,459162000
2021,1,WA11,"Müllereierzeugnisse, Malz usw.",135850000,53643000,189493000
2021,1,WA12,"Ölsamen usw., Heilpflanzen usw.",132682000,488046000,620728000
2021,1,WA13,"Schellack, Gummen, Harz, Pflanzensaft",49567000,44738000,94305000
2021,1,WA14,Flechtstoffe usw. pflanzlichen Ursprungs,778000,2398000,3176000
2021,1,WA15,"Tierische und pflanzliche Fette, Öle, Wachs",309281000,294876000,604157000
2021,1,WA16,"Zubereitungen von Fleisch, Fisch usw.",220211000,229700000,449911000
2021,1,WA17,Zucker und Zuckerwaren,184958000,114109000,299067000
2021,1,WA18,Kakao und Zubereitungen aus Kakao,436159000,368362000,804521000
2021,1,WA19,"Zubereitungen aus Getreide usw., Backwaren",481745000,336311000,818056000
2021,1,WA20,"Zubereitungen von Gemüse, Früchten usw.",199821000,398122000,597943000
2021,1,WA21,Verschiedene Lebensmittelzubereitungen,476980000,309935000,786915000
2021,1,WA22,"Getränke, alkoholhaltige Flüssigkeiten, Essig",361243000,481529000,842772000
2021,1,WA23,"Rückstände der Lebensmittelindustrie, Futter",511235000,377350000,888585000
2021,1,WA24,Tabak,192838000,234124000,426962000
2021,1,WA25,"Salz, Schwefel, Steine, Erden usw.",162067000,117144000,279211000
2021,1,WA26,"Erze, Schlacken, Aschen",49564000,995311000,1044875000
2021,1,WA27,Mineralische Brennstoffe usw.,1664959000,5511869000,7176828000
2021,1,WA28,Anorganische chemische Erzeugnisse,1021776000,454858000,1476634000
2021,1,WA29,Organische chemische Erzeugnisse,2237042000,2150252000,4387294000
2021,1,WA30,Pharmazeutische Erzeugnisse,7312045000,4071334000,11383379000
2021,1,WA31,Düngemittel,180250000,80781000,261031000
2021,1,WA32,"Gerb- und Farbstoffe, Farben, Lacke usw.",884944000,452726000,1337670000
2021,1,WA33,"Etherische Öle, Riech-, Schönheitsmittel",721529000,466398000,1187927000
2021,1,WA34,"Seifen, Waschmittel usw.",639722000,333246000,972968000
2021,1,WA35,"Eiweißstoffe, Klebstoffe, Enzyme",313567000,166952000,480519000
2021,1,WA36,"Sprengstoffe, pyrotechnische Artikel usw.",23638000,11959000,35597000
2021,1,WA37,Photochemische Erzeugnisse,87366000,50701000,138067000
2021,1,WA38,Verschiedene Erzeugnisse der Chemischen Industrie,2333128000,1452297000,3785425000
2021,1,WA39,Kunststoffe und Waren daraus,5137619000,3085085000,8222704000
2021,1,WA40,Kautschuk und Waren daraus,1149404000,1098077000,2247481000
2021,1,WA41,"Häute, Felle, Leder",43500000,34778000,78278000
2021,1,WA42,"Lederwaren, Sattlerwaren",180167000,289794000,469961000
2021,1,WA43,"Pelzfelle, künstliches Pelzwerk",4156000,5762000,9918000
2021,1,WA44,"Holz, Holzwaren, Holzkohle",706071000,659825000,1365896000
2021,1,WA45,"Kork, Korkwaren",2049000,8956000,11005000
2021,1,WA46,"Flechtwaren, Korbmacherwaren",4579000,11783000,16362000
2021,1,WA47,"Halbstoffe aus Holz usw., Papierabfall",76118000,247799000,323917000
2021,1,WA48,"Papier, Pappe und Waren daraus",1389350000,888690000,2278040000
2021,1,WA49,"Bücher, Zeitungen, Bilddrucke usw.",289677000,221297000,510974000
2021,1,WA50,Seide,2608000,1591000,4199000
2021,1,WA51,"Wolle, feine und grobe Tierhaare",32031000,34486000,66517000
2021,1,WA52,Baumwolle,49454000,49524000,98978000
2021,1,WA53,"Andere pflanzliche Spinnstoffe, Papiergarn",3991000,5423000,9414000
2021,1,WA54,Synthetisches oder künstliches Filament,118356000,99737000,218093000
2021,1,WA55,Synthetische oder künstliche Spinnfaser,123615000,100261000,223876000
2021,1,WA56,"Watte, Filz, Vliesstoff usw., Tauwerk",194236000,129724000,323960000
2021,1,WA57,"Teppiche, Fußbodenbelag aus Spinnstoff",41578000,92843000,134421000
2021,1,WA58,"Spezialgewebe, Spitzen, Tapisserien",37276000,17686000,54962000
2021,1,WA59,"Getränkte, bestrichene usw. Gewebe",184830000,86189000,271019000
2021,1,WA60,Gewirke und Gestricke,47588000,33362000,80950000
2021,1,WA61,"Bekleidung usw. aus Gewirken, Gestricken",789069000,1394752000,2183821000
2021,1,WA62,"Andere Bekleidung, Bekleidungszubehör",763047000,1194777000,1957824000
2021,1,WA63,"Andere Konfektion, Spinnstoffwaren usw.",280464000,625376000,905840000
2021,1,WA64,"Schuhe, Gamaschen, ähnliche Waren",627803000,869896000,1497699000
2021,1,WA65,Kopfbedeckungen und Teile davon,37381000,58982000,96363000
2021,1,WA66,"Schirme, Gehstöcke usw., Peitschen",5491000,24249000,29740000
2021,1,WA67,"Zugerichtete Federn, Daunen, künstliche Blumen",10478000,18613000,29091000
2021,1,WA68,"Waren aus Steinen, Gips, Zement usw.",347379000,254282000,601661000
2021,1,WA69,Keramische Waren,268264000,241089000,509353000
2021,1,WA70,Glas und Glaswaren,526828000,372810000,899638000
2021,1,WA71,"Perlen, Edelsteine, Edelmetalle",1755504000,2485090000,4240594000
2021,1,WA72,Eisen und Stahl,1925270000,1718221000,3643491000
2021,1,WA73,Waren aus Eisen oder Stahl,2004907000,1631209000,3636116000
2021,1,WA74,Kupfer und Waren daraus,984727000,816672000,1801399000
2021,1,WA75,Nickel und Waren daraus,96373000,109560000,205933000
2021,1,WA76,Aluminium und Waren daraus,1075971000,1134470000,2210441000
2021,1,WA78,Blei und Waren daraus,50527000,28807000,79334000
2021,1,WA79,Zink und Waren daraus,55202000,104889000,160091000
2021,1,WA80,Zinn und Waren daraus,7799000,26445000,34244000
2021,1,WA81,"Andere unedle Metalle, Cermets usw.",84780000,86977000,171757000
2021,1,WA82,"Werkzeuge, Schneidwaren, Essbestecke",633192000,454242000,1087434000
2021,1,WA83,Verschiedene Waren aus unedlen Metallen,609137000,402438000,1011575000
2021,1,WA84,"Maschinen, Apparate, mechanische Geräte",16243347000,11267460000,27510807000
2021,1,WA85,Elektrotechnische Erzeugnisse,11193247000,11759272000,22952519000
2021,1,WA86,Schienenfahrzeuge,264342000,185351000,449693000
2021,1,WA87,"Kraftfahrzeuge, Landfahrzeuge",15000440000,8178197000,23178637000
2021,1,WA88,"Luftfahrzeuge, Raumfahrzeuge",995262000,561692000,1556954000
2021,1,WA89,Wasserfahrzeuge,113516000,70223000,183739000
2021,1,WA90,"Optische, photografische usw. Erzeugnisse",4935627000,2907207000,7842834000
2021,1,WA91,Uhrmacherwaren,102270000,159711000,261981000
2021,1,WA92,Musikinstrumente,46523000,61593000,108116000
2021,1,WA93,Waffen und Munition,28872000,14595000,43467000
2021,1,WA94,"Möbel, Beleuchtungskörper usw.",1164053000,1629725000,2793778000
2021,1,WA95,"Spielzeug, Spiele usw., Sportgeräte",409553000,630016000,1039569000
2021,1,WA96,Verschiedene Waren,288140000,240186000,528326000
2021,1,WA97,"Kunstgegenstände, Sammlungsstücke",50837000,33373000,84210000
2021,1,WA98,Vollständige Fabrikationsanlagen,60729000,0,60729000
2021,1,WA99,Zusammenstellungen verschiedener Waren,1033559000,870279000,1903838000
2021,2,WA01,Lebende Tiere,85375000,94521000,179896000
2021,2,WA02,Fleisch,513620000,409085000,922705000
2021,2,WA03,"Fische, Krebs- und Weichtiere",101432000,290262000,391694000
2021,2,WA04,"Milch, Milcherzeugnisse, Eier, Honig",747351000,664359000,1411710000
2021,2,WA05,Andere Waren tierischen Ursprungs,68367000,72478000,140845000
2021,2,WA06,"Pflanzen, Waren des Blumenhandels",72932000,308851000,381783000
2021,2,WA07,"Gemüse, Pflanzen für Ernährung",82117000,681200000,763317000
2021,2,WA08,Genießbare Früchte und Nüsse,152734000,825361000,978095000
2021,2,WA09,"Kaffee, Tee, Mate, Gewürze",207878000,293930000,501808000
2021,2,WA10,Getreide,236572000,295738000,532310000
2021,2,WA11,"Müllereierzeugnisse, Malz usw.",138237000,55468000,193705000
2021,2,WA12,"Ölsamen usw., Heilpflanzen usw.",175026000,457222000,632248000
2021,2,WA13,"Schellack, Gummen, Harz, Pflanzensaft",58683000,53535000,112218000
2021,2,WA14,Flechtstoffe usw. pflanzlichen Ursprungs,891000,2541000,3432000
2021,2,WA15,"Tierische und pflanzliche Fette, Öle, Wachs",295915000,310811000,606726000
2021,2,WA16,"Zubereitungen von Fleisch, Fisch usw.",237066000,251570000,488636000
2021,2,WA17,Zucker und Zuckerwaren,187327000,121592000,308919000
2021,2,WA18,Kakao und Zubereitungen aus Kakao,444252000,345192000,789444000
2021,2,WA19,"Zubereitungen aus Getreide usw., Backwaren",515450000,380568000,896018000
2021,2,WA20,"Zubereitungen von Gemüse, Früchten usw.",230342000,414729000,645071000
2021,2,WA21,Verschiedene Lebensmittelzubereitungen,489300000,322095000,811395000
2021,2,WA22,"Getränke, alkoholhaltige Flüssigkeiten, Essig",393309000,552165000,945474000
2021,2,WA23,"Rückstände der Lebensmittelindustrie, Futter",525974000,345559000,871533000
2021,2,WA24,Tabak,209465000,205210000,414675000
2021,2,WA25,"Salz, Schwefel, Steine, Erden usw.",154966000,144035000,299001000
2021,2,WA26,"Erze, Schlacken, Aschen",51139000,1017535000,1068674000
2021,2,WA27,Mineralische Brennstoffe usw.,1575756000,5598442000,7174198000
2021,2,WA28,Anorganische chemische Erzeugnisse,1147378000,459043000,1606421000
2021,2,WA29,Organische chemische Erzeugnisse,1925521000,2715201000,4640722000
2021,2,WA30,Pharmazeutische Erzeugnisse,6799927000,4394580000,11194507000
2021,2,WA31,Düngemittel,204456000,102279000,306735000
2021,2,WA32,"Gerb- und Farbstoffe, Farben, Lacke usw.",977756000,468814000,1446570000
2021,2,WA33,"Etherische Öle, Riech-, Schönheitsmittel",759298000,522941000,1282239000
2021,2,WA34,"Seifen, Waschmittel usw.",648667000,345245000,993912000
2021,2,WA35,"Eiweißstoffe, Klebstoffe, Enzyme",321714000,185087000,506801000
2021,2,WA36,"Sprengstoffe, pyrotechnische Artikel usw.",20372000,10108000,30480000
2021,2,WA37,Photochemische Erzeugnisse,81018000,50724000,131742000
2021,2,WA38,Verschiedene Erzeugnisse der Chemischen Industrie,2235069000,1385526000,3620595000
2021,2,WA39,Kunststoffe und Waren daraus,5359427000,3504028000,8863455000
2021,2,WA40,Kautschuk und Waren daraus,1226013000,1254365000,2480378000
2021,2,WA41,"Häute, Felle, Leder",46752000,36298000,83050000
2021,2,WA42,"Lederwaren, Sattlerwaren",177660000,308363000,486023000
2021,2,WA43,"Pelzfelle, künstliches Pelzwerk",3193000,4720000,7913000
2021,2,WA44,"Holz, Holzwaren, Holzkohle",788308000,702757000,1491065000
2021,2,WA45,"Kork, Korkwaren",3090000,7552000,10642000
2021,2,WA46,"Flechtwaren, Korbmacherwaren",4835000,13741000,18576000
2021,2,WA47,"Halbstoffe aus Holz usw., Papierabfall",76913000,262854000,339767000
2021,2,WA48,"Papier, Pappe und Waren daraus",1417651000,887144000,2304795000
2021,2,WA49,"Bücher, Zeitungen, Bilddrucke usw.",301389000,223047000,524436000
2021,2,WA50,Seide,1566000,975000,2541000
2021,2,WA51,"Wolle, feine und grobe Tierhaare",34885000,34383000,69268000
2021,2,WA52,Baumwolle,48544000,55464000,104008000
2021,2,WA53,"Andere pflanzliche Spinnstoffe, Papiergarn",3961000,6822000,10783000
2021,2,WA54,Synthetisches oder künstliches Filament,127232000,100350000,227582000
2021,2,WA55,Synthetische oder künstliche Spinnfaser,118740000,108273000,227013000
2021,2,WA56,"Watte, Filz, Vliesstoff usw., Tauwerk",218268000,136390000,354658000
2021,2,WA57,"Teppiche, Fußbodenbelag aus Spinnstoff",44297000,92012000,136309000
2021,2,WA58,"Spezialgewebe, Spitzen, Tapisserien",40463000,19631000,60094000
2021,2,WA59,"Getränkte, bestrichene usw. Gewebe",192265000,94983000,287248000
2021,2,WA60,Gewirke und Gestricke,58123000,37151000,95274000
2021,2,WA61,"Bekleidung usw. aus Gewirken, Gestricken",821180000,1390328000,2211508000
2021,2,WA62,"Andere Bekleidung, Bekleidungszubehör",820839000,1278822000,2099661000
2021,2,WA63,"Andere Konfektion, Spinnstoffwaren usw.",303419000,661510000,964929000
2021,2,WA64,"Schuhe, Gamaschen, ähnliche Waren",680197000,981330000,1661527000
2021,2,WA65,Kopfbedeckungen und Teile davon,48252000,63736000,111988000
2021,2,WA66,"Schirme, Gehstöcke usw., Peitschen",6777000,32904000,39681000
2021,2,WA67,"Zugerichtete Federn, Daunen, künstliche Blumen",13049000,15851000,28900000
2021,2,WA68,"Waren aus Steinen, Gips, Zement usw.",403142000,261479000,664621000
2021,2,WA69,Keramische Waren,285709000,267105000,552814000
2021,2,WA70,Glas und Glaswaren,518117000,408356000,926473000
2021,2,WA71,"Perlen, Edelsteine, Edelmetalle",1708170000,2660615000,4368785000
2021,2,WA72,Eisen und Stahl,2032004000,2025061000,4057065000
2021,2,WA73,Waren aus Eisen oder Stahl,2263760000,1805809000,4069569000
2021,2,WA74,Kupfer und Waren daraus,1021489000,885386000,1906875000
2021,2,WA75,Nickel und Waren daraus,100060000,131422000,231482000
2021,2,WA76,Aluminium und Waren daraus,1207888000,1344687000,2552575000
2021,2,WA78,Blei und Waren daraus,45579000,33785000,79364000
2021,2,WA79,Zink und Waren daraus,64264000,112546000,176810000
2021,2,WA80,Zinn und Waren daraus,10465000,35417000,45882000
2021,2,WA81,"Andere unedle Metalle, Cermets usw.",96355000,110500000,206855000
2021,2,WA82,"Werkzeuge, Schneidwaren, Essbestecke",754970000,456818000,1211788000
2021,2,WA83,Verschiedene Waren aus unedlen Metallen,651114000,433074000,1084188000
2021,2,WA84,"Maschinen, Apparate, mechanische Geräte",17975656000,11778906000,29754562000
2021,2,WA85,Elektrotechnische Erzeugnisse,11849053000,11463828000,23312881000
2021,2,WA86,Schienenfahrzeuge,269320000,221352000,490672000
2021,2,WA87,"Kraftfahrzeuge, Landfahrzeuge",18096979000,9529478000,27626457000
2021,2,WA88,"Luftfahrzeuge, Raumfahrzeuge",1473002000,719587000,2192589000
2021,2,WA89,Wasserfahrzeuge,1453245000,84431000,1537676000
2021,2,WA90,"Optische, photografische usw. Erzeugnisse",5471178000,3183457000,8654635000
2021,2,WA91,Uhrmacherwaren,114962000,157913000,272875000
2021,2,WA92,Musikinstrumente,52915000,55250000,108165000
2021,2,WA93,Waffen und Munition,41065000,18137000,59202000
2021,2,WA94,"Möbel, Beleuchtungskörper usw.",1285163000,1782877000,3068040000
2021,2,WA95,"Spielzeug, Spiele usw., Sportgeräte",401397000,636034000,1037431000
2021,2,WA96,Verschiedene Waren,312519000,239010000,551529000
2021,2,WA97,"Kunstgegenstände, Sammlungsstücke",78377000,31708000,110085000
2021,2,WA98,Vollständige Fabrikationsanlagen,36020000,4884000,40904000
2021,2,WA99,Zusammenstellungen verschiedener Waren,1129160000,901216000,2030376000
2021,3,WA01,Lebende Tiere,94381000,117696000,212077000
2021,3,WA02,Fleisch,589328000,540935000,1130263000
2021,3,WA03,"Fische, Krebs- und Weichtiere",103468000,331374000,434842000
2021,3,WA04,"Milch, Milcherzeugnisse, Eier, Honig",896115000,774810000,1670925000
2021,3,WA05,Andere Waren tierischen Ursprungs,85333000,85696000,171029000
2021,3,WA06,"Pflanzen, Waren des Blumenhandels",121292000,417158000,538450000
2021,3,WA07,"Gemüse, Pflanzen für Ernährung",110478000,799869000,910347000
2021,3,WA08,Genießbare Früchte und Nüsse,191892000,915910000,1107802000
2021,3,WA09,"Kaffee, Tee, Mate, Gewürze",245356000,346832000,592188000
2021,3,WA10,Getreide,295859000,298420000,594279000
2021,3,WA11,"Müllereierzeugnisse, Malz usw.",157570000,65893000,223463000
2021,3,WA12,"Ölsamen usw., Heilpflanzen usw.",190655000,598885000,789540000
2021,3,WA13,"Schellack, Gummen, Harz, Pflanzensaft",67126000,63319000,130445000
2021,3,WA14,Flechtstoffe usw. pflanzlichen Ursprungs,1257000,3174000,4431000
2021,3,WA15,"Tierische und pflanzliche Fette, Öle, Wachs",307274000,312342000,619616000
2021,3,WA16,"Zubereitungen von Fleisch, Fisch usw.",252409000,262365000,514774000
2021,3,WA17,Zucker und Zuckerwaren,219690000,137315000,357005000
2021,3,WA18,Kakao und Zubereitungen aus Kakao,436857000,388308000,825165000
2021,3,WA19,"Zubereitungen aus Getreide usw., Backwaren",614256000,420135000,1034391000
2021,3,WA20,"Zubereitungen von Gemüse, Früchten usw.",256203000,456574000,712777000
2021,3,WA21,Verschiedene Lebensmittelzubereitungen,591016000,377559000,968575000
2021,3,WA22,"Getränke, alkoholhaltige Flüssigkeiten, Essig",504139000,669741000,1173880000
2021,3,WA23,"Rückstände der Lebensmittelindustrie, Futter",510226000,402087000,912313000
2021,3,WA24,Tabak,228140000,277394000,505534000
2021,3,WA25,"Salz, Schwefel, Steine, Erden usw.",192830000,158711000,351541000
2021,3,WA26,"Erze, Schlacken, Aschen",38290000,1122890000,1161180000
2021,3,WA27,Mineralische Brennstoffe usw.,1897178000,6700616000,8597794000
2021,3,WA28,Anorganische chemische Erzeugnisse,1372800000,564214000,1937014000
2021,3,WA29,Organische chemische Erzeugnisse,2441205000,3244467000,5685672000
2021,3,WA30,Pharmazeutische Erzeugnisse,8689782000,6189352000,14879134000
2021,3,WA31,Düngemittel,223660000,120476000,344136000
2021,3,WA32,"Gerb- und Farbstoffe, Farben, Lacke usw.",1079047000,545011000,1624058000
2021,3,WA33,"Etherische Öle, Riech-, Schönheitsmittel",864118000,586194000,1450312000
2021,3,WA34,"Seifen, Waschmittel usw.",742425000,368144000,1110569000
2021,3,WA35,"Eiweißstoffe, Klebstoffe, Enzyme",384705000,208326000,593031000
2021,3,WA36,"Sprengstoffe, pyrotechnische Artikel usw.",27838000,15357000,43195000
2021,3,WA37,Photochemische Erzeugnisse,96944000,49975000,146919000
2021,3,WA38,Verschiedene Erzeugnisse der Chemischen Industrie,2549421000,1743995000,4293416000
2021,3,WA39,Kunststoffe und Waren daraus,6260827000,3928692000,10189519000
2021,3,WA40,Kautschuk und Waren daraus,1449302000,1445061000,2894363000
2021,3,WA41,"Häute, Felle, Leder",62310000,46397000,108707000
2021,3,WA42,"Lederwaren, Sattlerwaren",215123000,328683000,543806000
2021,3,WA43,"Pelzfelle, künstliches Pelzwerk",5606000,6989000,12595000
2021,3,WA44,"Holz, Holzwaren, Holzkohle",955899000,823146000,1779045000
2021,3,WA45,"Kork, Korkwaren",2383000,11762000,14145000
2021,3,WA46,"Flechtwaren, Korbmacherwaren",6228000,15540000,21768000
2021,3,WA47,"Halbstoffe aus Holz usw., Papierabfall",89632000,293570000,383202000
2021,3,WA48,"Papier, Pappe und Waren daraus",1617180000,1008964000,2626144000
2021,3,WA49,"Bücher, Zeitungen, Bilddrucke usw.",357348000,257377000,614725000
2021,3,WA50,Seide,2384000,2469000,4853000
2021,3,WA51,"Wolle, feine und grobe Tierhaare",35090000,37712000,72802000
2021,3,WA52,Baumwolle,54774000,54119000,108893000
2021,3,WA53,"Andere pflanzliche Spinnstoffe, Papiergarn",3278000,6318000,9596000
2021,3,WA54,Synthetisches oder künstliches Filament,143035000,119043000,262078000
2021,3,WA55,Synthetische oder künstliche Spinnfaser,153456000,124483000,277939000
2021,3,WA56,"Watte, Filz, Vliesstoff usw., Tauwerk",245002000,159404000,404406000
2021,3,WA57,"Teppiche, Fußbodenbelag aus Spinnstoff",49907000,97012000,146919000
2021,3,WA58,"Spezialgewebe, Spitzen, Tapisserien",45274000,20569000,65843000
2021,3,WA59,"Getränkte, bestrichene usw. Gewebe",229223000,110937000,340160000
2021,3,WA60,Gewirke und Gestricke,66065000,43930000,109995000
2021,3,WA61,"Bekleidung usw. aus Gewirken, Gestricken",945893000,1539043000,2484936000
2021,3,WA62,"Andere Bekleidung, Bekleidungszubehör",999528000,1495378000,2494906000
2021,3,WA63,"Andere Konfektion, Spinnstoffwaren usw.",328556000,521659000,850215000
2021,3,WA64,"Schuhe, Gamaschen, ähnliche Waren",799119000,1061588000,1860707000
2021,3,WA65,Kopfbedeckungen und Teile davon,50160000,71403000,121563000
2021,3,WA66,"Schirme, Gehstöcke usw., Peitschen",9669000,43133000,52802000
2021,3,WA67,"Zugerichtete Federn, Daunen, künstliche Blumen",12307000,18017000,30324000
2021,3,WA68,"Waren aus Steinen, Gips, Zement usw.",477316000,320772000,798088000
2021,3,WA69,Keramische Waren,342628000,295873000,638501000
2021,3,WA70,Glas und Glaswaren,618128000,471897000,1090025000
2021,3,WA71,"Perlen, Edelsteine, Edelmetalle",1999457000,3235358000,5234815000
2021,3,WA72,Eisen und Stahl,2373026000,2372657000,4745683000
2021,3,WA73,Waren aus Eisen oder Stahl,2686894000,2129762000,4816656000
2021,3,WA74,Kupfer und Waren daraus,1315883000,987757000,2303640000
2021,3,WA75,Nickel und Waren daraus,100613000,134080000,234693000
2021,3,WA76,Aluminium und Waren daraus,1409130000,1471903000,2881033000
2021,3,WA78,Blei und Waren daraus,44740000,42281000,87021000
2021,3,WA79,Zink und Waren daraus,71693000,123690000,195383000
2021,3,WA80,Zinn und Waren daraus,11188000,33852000,45040000
2021,3,WA81,"Andere unedle Metalle, Cermets usw.",125293000,122741000,248034000
2021,3,WA82,"Werkzeuge, Schneidwaren, Essbestecke",799309000,522542000,1321851000
2021,3,WA83,Verschiedene Waren aus unedlen Metallen,737655000,487030000,1224685000
2021,3,WA84,"Maschinen, Apparate, mechanische Geräte",21707936000,13878872000,35586808000
2021,3,WA85,Elektrotechnische Erzeugnisse,13694809000,13166638000,26861447000
2021,3,WA86,Schienenfahrzeuge,322022000,313184000,635206000
2021,3,WA87,"Kraftfahrzeuge, Landfahrzeuge",22495943000,11930882000,34426825000
2021,3,WA88,"Luftfahrzeuge, Raumfahrzeuge",2274397000,942209000,3216606000
2021,3,WA89,Wasserfahrzeuge,316392000,125777000,442169000
2021,3,WA90,"Optische, photografische usw. Erzeugnisse",6541814000,3863054000,10404868000
2021,3,WA91,Uhrmacherwaren,126813000,173795000,300608000
2021,3,WA92,Musikinstrumente,59062000,65182000,124244000
2021,3,WA93,Waffen und Munition,59590000,22060000,81650000
2021,3,WA94,"Möbel, Beleuchtungskörper usw.",1537797000,1949436000,3487233000
2021,3,WA95,"Spielzeug, Spiele usw., Sportgeräte",414425000,713995000,1128420000
2021,3,WA96,Verschiedene Waren,365676000,273029000,638705000
2021,3,WA97,"Kunstgegenstände, Sammlungsstücke",91219000,56066000,147285000
2021,3,WA98,Vollständige Fabrikationsanlagen,31576000,0,31576000
2021,3,WA99,Zusammenstellungen verschiedener Waren,1341991000,1078438000,2420429000
2021,4,WA01,Lebende Tiere,90803000,118275000,209078000
2021,4,WA02,Fleisch,492899000,454912000,947811000
2021,4,WA03,"Fische, Krebs- und Weichtiere",94017000,258914000,352931000
2021,4,WA04,"Milch, Milcherzeugnisse, Eier, Honig",775537000,681296000,1456833000
2021,4,WA05,Andere Waren tierischen Ursprungs,75894000,74452000,150346000
2021,4,WA06,"Pflanzen, Waren des Blumenhandels",132405000,426659000,559064000
2021,4,WA07,"Gemüse, Pflanzen für Ernährung",99071000,733524000,832595000
2021,4,WA08,Genießbare Früchte und Nüsse,164860000,954432000,1119292000
2021,4,WA09,"Kaffee, Tee, Mate, Gewürze",239619000,366357000,605976000
2021,4,WA10,Getreide,221698000,241874000,463572000
2021,4,WA11,"Müllereierzeugnisse, Malz usw.",138650000,58772000,197422000
2021,4,WA12,"Ölsamen usw., Heilpflanzen usw.",113289000,477869000,591158000
2021,4,WA13,"Schellack, Gummen, Harz, Pflanzensaft",58695000,51577000,110272000
2021,4,WA14,Flechtstoffe usw. pflanzlichen Ursprungs,1117000,3346000,4463000
2021,4,WA15,"Tierische und pflanzliche Fette, Öle, Wachs",303785000,346063000,649848000
2021,4,WA16,"Zubereitungen von Fleisch, Fisch usw.",228187000,219950000,448137000
2021,4,WA17,Zucker und Zuckerwaren,211772000,129380000,341152000
2021,4,WA18,Kakao und Zubereitungen aus Kakao,344369000,307218000,651587000
2021,4,WA19,"Zubereitungen aus Getreide usw., Backwaren",523805000,351116000,874921000
2021,4,WA20,"Zubereitungen von Gemüse, Früchten usw.",245389000,408893000,654282000
2021,4,WA21,Verschiedene Lebensmittelzubereitungen,556498000,349234000,905732000
2021,4,WA22,"Getränke, alkoholhaltige Flüssigkeiten, Essig",469293000,631681000,1100974000
2021,4,WA23,"Rückstände der Lebensmittelindustrie, Futter",445892000,339433000,785325000
2021,4,WA24,Tabak,210997000,253512000,464509000
2021,4,WA25,"Salz, Schwefel, Steine, Erden usw.",167413000,146713000,314126000
2021,4,WA26,"Erze, Schlacken, Aschen",89286000,1002626000,1091912000
2021,4,WA27,Mineralische Brennstoffe usw.,1760099000,6464324000,8224423000
2021,4,WA28,Anorganische chemische Erzeugnisse,1230548000,485322000,1715870000
2021,4,WA29,Organische chemische Erzeugnisse,2322954000,2480690000,4803644000
2021,4,WA30,Pharmazeutische Erzeugnisse,8130697000,6033052000,14163749000
2021,4,WA31,Düngemittel,186909000,85289000,272198000
2021,4,WA32,"Gerb- und Farbstoffe, Farben, Lacke usw.",1018083000,494165000,1512248000
2021,4,WA33,"Etherische Öle, Riech-, Schönheitsmittel",778486000,510605000,1289091000
2021,4,WA34,"Seifen, Waschmittel usw.",667461000,361793000,1029254000
2021,4,WA35,"Eiweißstoffe, Klebstoffe, Enzyme",326358000,203196000,529554000
2021,4,WA36,"Sprengstoffe, pyrotechnische Artikel usw.",22154000,11404000,33558000
2021,4,WA37,Photochemische Erzeugnisse,86409000,53033000,139442000
2021,4,WA38,Verschiedene Erzeugnisse der Chemischen Industrie,2319615000,1864887000,4184502000
2021,4,WA39,Kunststoffe und Waren daraus,5695572000,3791026000,9486598000
2021,4,WA40,Kautschuk und Waren daraus,1270972000,1361942000,2632914000
2021,4,WA41,"Häute, Felle, Leder",49756000,40124000,89880000
2021,4,WA42,"Lederwaren, Sattlerwaren",184946000,269231000,454177000
2021,4,WA43,"Pelzfelle, künstliches Pelzwerk",2797000,4038000,6835000
2021,4,WA44,"Holz, Holzwaren, Holzkohle",914157000,760467000,1674624000
2021,4,WA45,"Kork, Korkwaren",2253000,7814000,10067000
2021,4,WA46,"Flechtwaren, Korbmacherwaren",5965000,13396000,19361000
2021,4,WA47,"Halbstoffe aus Holz usw., Papierabfall",91235000,304274000,395509000
2021,4,WA48,"Papier, Pappe und Waren daraus",1464991000,881554000,2346545000
2021,4,WA49,"Bücher, Zeitungen, Bilddrucke usw.",296178000,235259000,531437000
2021,4,WA50,Seide,1602000,2091000,3693000
2021,4,WA51,"Wolle, feine und grobe Tierhaare",37199000,37673000,74872000
2021,4,WA52,Baumwolle,48044000,53188000,101232000
2021,4,WA53,"Andere pflanzliche Spinnstoffe, Papiergarn",3174000,6847000,10021000
2021,4,WA54,Synthetisches oder künstliches Filament,114632000,104234000,218866000
2021,4,WA55,Synthetische oder künstliche Spinnfaser,135678000,101398000,237076000
2021,4,WA56,"Watte, Filz, Vliesstoff usw., Tauwerk",216919000,137550000,354469000
2021,4,WA57,"Teppiche, Fußbodenbelag aus Spinnstoff",45947000,94352000,140299000
2021,4,WA58,"Spezialgewebe, Spitzen, Tapisserien",38549000,18262000,56811000
2021,4,WA59,"Getränkte, bestrichene usw. Gewebe",201219000,93607000,294826000
2021,4,WA60,Gewirke und Gestricke,58385000,36193000,94578000
2021,4,WA61,"Bekleidung usw. aus Gewirken, Gestricken",801496000,1384399000,2185895000
2021,4,WA62,"Andere Bekleidung, Bekleidungszubehör",809764000,1250036000,2059800000
2021,4,WA63,"Andere Konfektion, Spinnstoffwaren usw.",282860000,434432000,717292000
2021,4,WA64,"Schuhe, Gamaschen, ähnliche Waren",604191000,841849000,1446040000
2021,4,WA65,Kopfbedeckungen und Teile davon,47413000,60911000,108324000
2021,4,WA66,"Schirme, Gehstöcke usw., Peitschen",11003000,32440000,43443000
2021,4,WA67,"Zugerichtete Federn, Daunen, künstliche Blumen",10085000,12772000,22857000
2021,4,WA68,"Waren aus Steinen, Gips, Zement usw.",435787000,280080000,715867000
2021,4,WA69,Keramische Waren,322320000,275250000,597570000
2021,4,WA70,Glas und Glaswaren,547534000,409747000,957281000
2021,4,WA71,"Perlen, Edelsteine, Edelmetalle",2092690000,3582062000,5674752000
2021,4,WA72,Eisen und Stahl,2266690000,2152154000,4418844000
2021,4,WA73,Waren aus Eisen oder Stahl,2318860000,1882102000,4200962000
2021,4,WA74,Kupfer und Waren daraus,1202762000,1068292000,2271054000
2021,4,WA75,Nickel und Waren daraus,123037000,154411000,277448000
2021,4,WA76,Aluminium und Waren daraus,1312871000,1359905000,2672776000
2021,4,WA78,Blei und Waren daraus,50764000,32511000,83275000
2021,4,WA79,Zink und Waren daraus,62663000,110743000,173406000
2021,4,WA80,Zinn und Waren daraus,10993000,45908000,56901000
2021,4,WA81,"Andere unedle Metalle, Cermets usw.",102367000,122338000,224705000
2021,4,WA82,"Werkzeuge, Schneidwaren, Essbestecke",747516000,449205000,1196721000
2021,4,WA83,Verschiedene Waren aus unedlen Metallen,636816000,416340000,1053156000
2021,4,WA84,"Maschinen, Apparate, mechanische Geräte",19225828000,12142694000,31368522000
2021,4,WA85,Elektrotechnische Erzeugnisse,11915408000,12233785000,24149193000
2021,4,WA86,Schienenfahrzeuge,268507000,206966000,475473000
2021,4,WA87,"Kraftfahrzeuge, Landfahrzeuge",18630215000,10043975000,28674190000
2021,4,WA88,"Luftfahrzeuge, Raumfahrzeuge",1644649000,989536000,2634185000
2021,4,WA89,Wasserfahrzeuge,119036000,116235000,235271000
2021,4,WA90,"Optische, photografische usw. Erzeugnisse",5702601000,3465654000,9168255000
2021,4,WA91,Uhrmacherwaren,114199000,163075000,277274000
2021,4,WA92,Musikinstrumente,52054000,56807000,108861000
2021,4,WA93,Waffen und Munition,48771000,19335000,68106000
2021,4,WA94,"Möbel, Beleuchtungskörper usw.",1364645000,1711482000,3076127000
2021,4,WA95,"Spielzeug, Spiele usw., Sportgeräte",409028000,603211000,1012239000
2021,4,WA96,Verschiedene Waren,326231000,231038000,557269000
2021,4,WA97,"Kunstgegenstände, Sammlungsstücke",125381000,49768000,175149000
2021,4,WA98,Vollständige Fabrikationsanlagen,24261000,0,24261000
2021,4,WA99,Zusammenstellungen verschiedener Waren,1240369000,1018187000,2258556000
2021,5,WA01,Lebende Tiere,91466000,123225000,214691000
2021,5,WA02,Fleisch,523882000,505211000,1029093000
2021,5,WA03,"Fische, Krebs- und Weichtiere",99327000,287972000,387299000
2021,5,WA04,"Milch, Milcherzeugnisse, Eier, Honig",842347000,687987000,1530334000
2021,5,WA05,Andere Waren tierischen Ursprungs,75572000,83446000,159018000
2021,5,WA06,"Pflanzen, Waren des Blumenhandels",135806000,424753000,560559000
2021,5,WA07,"Gemüse, Pflanzen für Ernährung",106356000,638902000,745258000
2021,5,WA08,Genießbare Früchte und Nüsse,159295000,959407000,1118702000
2021,5,WA09,"Kaffee, Tee, Mate, Gewürze",244740000,332444000,577184000
2021,5,WA10,Getreide,257348000,222777000,480125000
2021,5,WA11,"Müllereierzeugnisse, Malz usw.",140220000,56689000,196909000
2021,5,WA12,"Ölsamen usw., Heilpflanzen usw.",101355000,534116000,635471000
2021,5,WA13,"Schellack, Gummen, Harz, Pflanzensaft",58559000,45438000,103997000
2021,5,WA14,Flechtstoffe usw. pflanzlichen Ursprungs,868000,2794000,3662000
2021,5,WA15,"Tierische und pflanzliche Fette, Öle, Wachs",332358000,356256000,688614000
2021,5,WA16,"Zubereitungen von Fleisch, Fisch usw.",250882000,303202000,554084000
2021,5,WA17,Zucker und Zuckerwaren,220726000,135803000,356529000
2021,5,WA18,Kakao und Zubereitungen aus Kakao,397770000,377404000,775174000
2021,5,WA19,"Zubereitungen aus Getreide usw., Backwaren",532763000,391565000,924328000
2021,5,WA20,"Zubereitungen von Gemüse, Früchten usw.",231170000,398063000,629233000
2021,5,WA21,Verschiedene Lebensmittelzubereitungen,559843000,349836000,909679000
2021,5,WA22,"Getränke, alkoholhaltige Flüssigkeiten, Essig",529854000,627122000,1156976000
2021,5,WA23,"Rückstände der Lebensmittelindustrie, Futter",450328000,375975000,826303000
2021,5,WA24,Tabak,211950000,248243000,460193000
2021,5,WA25,"Salz, Schwefel, Steine, Erden usw.",184419000,144747000,329166000
2021,5,WA26,"Erze, Schlacken, Aschen",62896000,1198846000,1261742000
2021,5,WA27,Mineralische Brennstoffe usw.,1871349000,7080933000,8952282000
2021,5,WA28,Anorganische chemische Erzeugnisse,1170947000,548118000,1719065000
2021,5,WA29,Organische chemische Erzeugnisse,2248103000,3297813000,5545916000
2021,5,WA30,Pharmazeutische Erzeugnisse,7837917000,6222636000,14060553000
2021,5,WA31,Düngemittel,164470000,84745000,249215000
2021,5,WA32,"Gerb- und Farbstoffe, Farben, Lacke usw.",1019135000,532559000,1551694000
2021,5,WA33,"Etherische Öle, Riech-, Schönheitsmittel",775087000,542734000,1317821000
2021,5,WA34,"Seifen, Waschmittel usw.",658284000,354982000,1013266000
2021,5,WA35,"Eiweißstoffe, Klebstoffe, Enzyme",363764000,207819000,571583000
2021,5,WA36,"Sprengstoffe, pyrotechnische Artikel usw.",22312000,10654000,32966000
2021,5,WA37,Photochemische Erzeugnisse,93609000,53377000,146986000
2021,5,WA38,Verschiedene Erzeugnisse der Chemischen Industrie,2269644000,1750744000,4020388000
2021,5,WA39,Kunststoffe und Waren daraus,5774979000,3942930000,9717909000
2021,5,WA40,Kautschuk und Waren daraus,1247413000,1263292000,2510705000
2021,5,WA41,"Häute, Felle, Leder",56980000,38921000,95901000
2021,5,WA42,"Lederwaren, Sattlerwaren",194106000,284573000,478679000
2021,5,WA43,"Pelzfelle, künstliches Pelzwerk",2067000,5007000,7074000
2021,5,WA44,"Holz, Holzwaren, Holzkohle",969745000,879203000,1848948000
2021,5,WA45,"Kork, Korkwaren",2169000,7341000,9510000
2021,5,WA46,"Flechtwaren, Korbmacherwaren",6466000,12828000,19294000
2021,5,WA47,"Halbstoffe aus Holz usw., Papierabfall",94869000,323749000,418618000
2021,5,WA48,"Papier, Pappe und Waren daraus",1524979000,968170000,2493149000
2021,5,WA49,"Bücher, Zeitungen, Bilddrucke usw.",286980000,235034000,522014000
2021,5,WA50,Seide,1907000,1681000,3588000
2021,5,WA51,"Wolle, feine und grobe Tierhaare",33535000,41046000,74581000
2021,5,WA52,Baumwolle,50157000,56003000,106160000
2021,5,WA53,"Andere pflanzliche Spinnstoffe, Papiergarn",2824000,7007000,9831000
2021,5,WA54,Synthetisches oder künstliches Filament,128042000,106908000,234950000
2021,5,WA55,Synthetische oder künstliche Spinnfaser,140847000,121707000,262554000
2021,5,WA56,"Watte, Filz, Vliesstoff usw., Tauwerk",227648000,150714000,378362000
2021,5,WA57,"Teppiche, Fußbodenbelag aus Spinnstoff",42675000,85170000,127845000
2021,5,WA58,"Spezialgewebe, Spitzen, Tapisserien",40534000,20812000,61346000
2021,5,WA59,"Getränkte, bestrichene usw. Gewebe",200059000,101610000,301669000
2021,5,WA60,Gewirke und Gestricke,58295000,38804000,97099000
2021,5,WA61,"Bekleidung usw. aus Gewirken, Gestricken",830557000,1309916000,2140473000
2021,5,WA62,"Andere Bekleidung, Bekleidungszubehör",799042000,1151630000,1950672000
2021,5,WA63,"Andere Konfektion, Spinnstoffwaren usw.",283191000,396212000,679403000
2021,5,WA64,"Schuhe, Gamaschen, ähnliche Waren",583995000,838460000,1422455000
2021,5,WA65,Kopfbedeckungen und Teile davon,47375000,62338000,109713000
2021,5,WA66,"Schirme, Gehstöcke usw., Peitschen",11129000,27895000,39024000
2021,5,WA67,"Zugerichtete Federn, Daunen, künstliche Blumen",14127000,12786000,26913000
2021,5,WA68,"Waren aus Steinen, Gips, Zement usw.",435486000,304274000,739760000
2021,5,WA69,Keramische Waren,331781000,299677000,631458000
2021,5,WA70,Glas und Glaswaren,567391000,413106000,980497000
2021,5,WA71,"Perlen, Edelsteine, Edelmetalle",1866054000,3395294000,5261348000
2021,5,WA72,Eisen und Stahl,2243397000,2331729000,4575126000
2021,5,WA73,Waren aus Eisen oder Stahl,2336527000,1997250000,4333777000
2021,5,WA74,Kupfer und Waren daraus,1205200000,1131327000,2336527000
2021,5,WA75,Nickel und Waren daraus,108707000,132623000,241330000
2021,5,WA76,Aluminium und Waren daraus,1309137000,1464140000,2773277000
2021,5,WA78,Blei und Waren daraus,60198000,46090000,106288000
2021,5,WA79,Zink und Waren daraus,66733000,130548000,197281000
2021,5,WA80,Zinn und Waren daraus,9396000,39383000,48779000
2021,5,WA81,"Andere unedle Metalle, Cermets usw.",102618000,127828000,230446000
2021,5,WA82,"Werkzeuge, Schneidwaren, Essbestecke",741735000,473808000,1215543000
2021,5,WA83,Verschiedene Waren aus unedlen Metallen,677330000,413547000,1090877000
2021,5,WA84,"Maschinen, Apparate, mechanische Geräte",18539657000,11971467000,30511124000
2021,5,WA85,Elektrotechnische Erzeugnisse,11880937000,11637405000,23518342000
2021,5,WA86,Schienenfahrzeuge,249311000,229663000,478974000
2021,5,WA87,"Kraftfahrzeuge, Landfahrzeuge",16434532000,9196157000,25630689000
2021,5,WA88,"Luftfahrzeuge, Raumfahrzeuge",2132306000,578636000,2710942000
2021,5,WA89,Wasserfahrzeuge,151555000,135549000,287104000
2021,5,WA90,"Optische, photografische usw. Erzeugnisse",5608379000,3380118000,8988497000
2021,5,WA91,Uhrmacherwaren,121221000,176940000,298161000
2021,5,WA92,Musikinstrumente,52761000,51316000,104077000
2021,5,WA93,Waffen und Munition,50379000,21449000,71828000
2021,5,WA94,"Möbel, Beleuchtungskörper usw.",1381927000,1708850000,3090777000
2021,5,WA95,"Spielzeug, Spiele usw., Sportgeräte",403280000,667815000,1071095000
2021,5,WA96,Verschiedene Waren,323089000,244060000,567149000
2021,5,WA97,"Kunstgegenstände, Sammlungsstücke",136391000,46661000,183052000
2021,5,WA98,Vollständige Fabrikationsanlagen,27821000,0,27821000
2021,5,WA99,Zusammenstellungen verschiedener Waren,1304350000,919646000,2223996000
2021,6,WA01,Lebende Tiere,98034000,137306000,235340000
2021,6,WA02,Fleisch,493787000,512388000,1006175000
2021,6,WA03,"Fische, Krebs- und Weichtiere",112715000,282251000,394966000
2021,6,WA04,"Milch, Milcherzeugnisse, Eier, Honig",807418000,761047000,1568465000
2021,6,WA05,Andere Waren tierischen Ursprungs,78046000,89131000,167177000
2021,6,WA06,"Pflanzen, Waren des Blumenhandels",76591000,267154000,343745000
2021,6,WA07,"Gemüse, Pflanzen für Ernährung",86391000,515954000,602345000
2021,6,WA08,Genießbare Früchte und Nüsse,165455000,1006044000,1171499000
2021,6,WA09,"Kaffee, Tee, Mate, Gewürze",250881000,365299000,616180000
2021,6,WA10,Getreide,179359000,242419000,421778000
2021,6,WA11,"Müllereierzeugnisse, Malz usw.",147505000,68943000,216448000
2021,6,WA12,"Ölsamen usw., Heilpflanzen usw.",98969000,512220000,611189000
2021,6,WA13,"Schellack, Gummen, Harz, Pflanzensaft",63481000,51925000,115406000
2021,6,WA14,Flechtstoffe usw. pflanzlichen Ursprungs,1022000,4606000,5628000
2021,6,WA15,"Tierische und pflanzliche Fette, Öle, Wachs",302793000,376860000,679653000
2021,6,WA16,"Zubereitungen von Fleisch, Fisch usw.",257240000,257924000,515164000
2021,6,WA17,Zucker und Zuckerwaren,232438000,142797000,375235000
2021,6,WA18,Kakao und Zubereitungen aus Kakao,397962000,356875000,754837000
2021,6,WA19,"Zubereitungen aus Getreide usw., Backwaren",562251000,388786000,951037000
2021,6,WA20,"Zubereitungen von Gemüse, Früchten usw.",236807000,436894000,673701000
2021,6,WA21,Verschiedene Lebensmittelzubereitungen,582292000,373833000,956125000
2021,6,WA22,"Getränke, alkoholhaltige Flüssigkeiten, Essig",609688000,686886000,1296574000
2021,6,WA23,"Rückstände der Lebensmittelindustrie, Futter",461222000,422704000,883926000
2021,6,WA24,Tabak,235114000,263094000,498208000
2021,6,WA25,"Salz, Schwefel, Steine, Erden usw.",180517000,177019000,357536000
2021,6,WA26,"Erze, Schlacken, Aschen",67272000,1298606000,1365878000
2021,6,WA27,Mineralische Brennstoffe usw.,2004348000,7066165000,9070513000
2021,6,WA28,Anorganische chemische Erzeugnisse,1085300000,588925000,1674225000
2021,6,WA29,Organische chemische Erzeugnisse,2431287000,3293207000,5724494000
2021,6,WA30,Pharmazeutische Erzeugnisse,8913938000,6262273000,15176211000
2021,6,WA31,Düngemittel,176201000,90953000,267154000
2021,6,WA32,"Gerb- und Farbstoffe, Farben, Lacke usw.",1039220000,535840000,1575060000
2021,6,WA33,"Etherische Öle, Riech-, Schönheitsmittel",820296000,625070000,1445366000
2021,6,WA34,"Seifen, Waschmittel usw.",684684000,378403000,1063087000
2021,6,WA35,"Eiweißstoffe, Klebstoffe, Enzyme",372494000,230794000,603288000
2021,6,WA36,"Sprengstoffe, pyrotechnische Artikel usw.",28961000,11616000,40577000
2021,6,WA37,Photochemische Erzeugnisse,91417000,60790000,152207000
2021,6,WA38,Verschiedene Erzeugnisse der Chemischen Industrie,2367107000,1703436000,4070543000
2021,6,WA39,Kunststoffe und Waren daraus,6222229000,4188533000,10410762000
2021,6,WA40,Kautschuk und Waren daraus,1358527000,1368681000,2727208000
2021,6,WA41,"Häute, Felle, Leder",55948000,48250000,104198000
2021,6,WA42,"Lederwaren, Sattlerwaren",208676000,342758000,551434000
2021,6,WA43,"Pelzfelle, künstliches Pelzwerk",5506000,9021000,14527000
2021,6,WA44,"Holz, Holzwaren, Holzkohle",1045159000,923778000,1968937000
2021,6,WA45,"Kork, Korkwaren",2864000,11262000,14126000
2021,6,WA46,"Flechtwaren, Korbmacherwaren",5767000,14105000,19872000
2021,6,WA47,"Halbstoffe aus Holz usw., Papierabfall",106009000,338954000,444963000
2021,6,WA48,"Papier, Pappe und Waren daraus",1646925000,978522000,2625447000
2021,6,WA49,"Bücher, Zeitungen, Bilddrucke usw.",300226000,238792000,539018000
2021,6,WA50,Seide,2619000,3254000,5873000
2021,6,WA51,"Wolle, feine und grobe Tierhaare",41032000,41634000,82666000
2021,6,WA52,Baumwolle,52115000,56605000,108720000
2021,6,WA53,"Andere pflanzliche Spinnstoffe, Papiergarn",3292000,5713000,9005000
2021,6,WA54,Synthetisches oder künstliches Filament,138216000,115855000,254071000
2021,6,WA55,Synthetische oder künstliche Spinnfaser,136889000,120716000,257605000
2021,6,WA56,"Watte, Filz, Vliesstoff usw., Tauwerk",232346000,149524000,381870000
2021,6,WA57,"Teppiche, Fußbodenbelag aus Spinnstoff",45824000,90009000,135833000
2021,6,WA58,"Spezialgewebe, Spitzen, Tapisserien",42364000,21533000,63897000
2021,6,WA59,"Getränkte, bestrichene usw. Gewebe",215493000,103021000,318514000
2021,6,WA60,Gewirke und Gestricke,61397000,38893000,100290000
2021,6,WA61,"Bekleidung usw. aus Gewirken, Gestricken",912665000,1466940000,2379605000
2021,6,WA62,"Andere Bekleidung, Bekleidungszubehör",840007000,1268585000,2108592000
2021,6,WA63,"Andere Konfektion, Spinnstoffwaren usw.",286437000,432637000,719074000
2021,6,WA64,"Schuhe, Gamaschen, ähnliche Waren",698005000,922604000,1620609000
2021,6,WA65,Kopfbedeckungen und Teile davon,50840000,69470000,120310000
2021,6,WA66,"Schirme, Gehstöcke usw., Peitschen",12202000,25621000,37823000
2021,6,WA67,"Zugerichtete Federn, Daunen, künstliche Blumen",12138000,16353000,28491000
2021,6,WA68,"Waren aus Steinen, Gips, Zement usw.",459167000,321405000,780572000
2021,6,WA69,Keramische Waren,338002000,287083000,625085000
2021,6,WA70,Glas und Glaswaren,591587000,437664000,1029251000
2021,6,WA71,"Perlen, Edelsteine, Edelmetalle",2016255000,3215422000,5231677000
2021,6,WA72,Eisen und Stahl,2407678000,2576609000,4984287000
2021,6,WA73,Waren aus Eisen oder Stahl,2446101000,2091761000,4537862000
2021,6,WA74,Kupfer und Waren daraus,1260227000,1028208000,2288435000
2021,6,WA75,Nickel und Waren daraus,119200000,133236000,252436000
2021,6,WA76,Aluminium und Waren daraus,1395600000,1489521000,2885121000
2021,6,WA78,Blei und Waren daraus,54023000,40956000,94979000
2021,6,WA79,Zink und Waren daraus,67090000,122167000,189257000
2021,6,WA80,Zinn und Waren daraus,12279000,50604000,62883000
2021,6,WA81,"Andere unedle Metalle, Cermets usw.",106562000,139004000,245566000
2021,6,WA82,"Werkzeuge, Schneidwaren, Essbestecke",773966000,501972000,1275938000
2021,6,WA83,Verschiedene Waren aus unedlen Metallen,685461000,446471000,1131932000
2021,6,WA84,"Maschinen, Apparate, mechanische Geräte",19874790000,12935719000,32810509000
2021,6,WA85,Elektrotechnische Erzeugnisse,12675787000,12446481000,25122268000
2021,6,WA86,Schienenfahrzeuge,289847000,241524000,531371000
2021,6,WA87,"Kraftfahrzeuge, Landfahrzeuge",18072802000,10202305000,28275107000
2021,6,WA88,"Luftfahrzeuge, Raumfahrzeuge",2517570000,1062936000,3580506000
2021,6,WA89,Wasserfahrzeuge,818125000,309540000,1127665000
2021,6,WA90,"Optische, photografische usw. Erzeugnisse",6063261000,3673937000,9737198000
2021,6,WA91,Uhrmacherwaren,152047000,208830000,360877000
2021,6,WA92,Musikinstrumente,60766000,64850000,125616000
2021,6,WA93,Waffen und Munition,51008000,20117000,71125000
2021,6,WA94,"Möbel, Beleuchtungskörper usw.",1459188000,1817218000,3276406000
2021,6,WA95,"Spielzeug, Spiele usw., Sportgeräte",450449000,743673000,1194122000
2021,6,WA96,Verschiedene Waren,338112000,265656000,603768000
2021,6,WA97,"Kunstgegenstände, Sammlungsstücke",139797000,116588000,256385000
2021,6,WA98,Vollständige Fabrikationsanlagen,26171000,0,26171000
2021,6,WA99,Zusammenstellungen verschiedener Waren,1247608000,971064000,2218672000
2021,7,WA01,Lebende Tiere,99200000,106174000,205374000
2021,7,WA02,Fleisch,482933000,512851000,995784000
2021,7,WA03,"Fische, Krebs- und Weichtiere",112866000,292117000,404983000
2021,7,WA04,"Milch, Milcherzeugnisse, Eier, Honig",895284000,697349000,1592633000
2021,7,WA05,Andere Waren tierischen Ursprungs,76629000,89276000,165905000
2021,7,WA06,"Pflanzen, Waren des Blumenhandels",61416000,216407000,277823000
2021,7,WA07,"Gemüse, Pflanzen für Ernährung",91679000,499372000,591051000
2021,7,WA08,Genießbare Früchte und Nüsse,166302000,997042000,1163344000
2021,7,WA09,"Kaffee, Tee, Mate, Gewürze",249499000,327426000,576925000
2021,7,WA10,Getreide,143578000,192857000,336435000
2021,7,WA11,"Müllereierzeugnisse, Malz usw.",138103000,67466000,205569000
2021,7,WA12,"Ölsamen usw., Heilpflanzen usw.",113044000,383392000,496436000
2021,7,WA13,"Schellack, Gummen, Harz, Pflanzensaft",56831000,54323000,111154000
2021,7,WA14,Flechtstoffe usw. pflanzlichen Ursprungs,760000,3844000,4604000
2021,7,WA15,"Tierische und pflanzliche Fette, Öle, Wachs",294884000,385147000,680031000
2021,7,WA16,"Zubereitungen von Fleisch, Fisch usw.",245401000,243000000,488401000
2021,7,WA17,Zucker und Zuckerwaren,228563000,139291000,367854000
2021,7,WA18,Kakao und Zubereitungen aus Kakao,432018000,382459000,814477000
2021,7,WA19,"Zubereitungen aus Getreide usw., Backwaren",564324000,401898000,966222000
2021,7,WA20,"Zubereitungen von Gemüse, Früchten usw.",240970000,416461000,657431000
2021,7,WA21,Verschiedene Lebensmittelzubereitungen,606957000,385772000,992729000
2021,7,WA22,"Getränke, alkoholhaltige Flüssigkeiten, Essig",571655000,702681000,1274336000
2021,7,WA23,"Rückstände der Lebensmittelindustrie, Futter",448769000,353555000,802324000
2021,7,WA24,Tabak,204888000,265328000,470216000
2021,7,WA25,"Salz, Schwefel, Steine, Erden usw.",190460000,160588000,351048000
2021,7,WA26,"Erze, Schlacken, Aschen",52466000,945517000,997983000
2021,7,WA27,Mineralische Brennstoffe usw.,2166522000,7767324000,9933846000
2021,7,WA28,Anorganische chemische Erzeugnisse,1078602000,557975000,1636577000
2021,7,WA29,Organische chemische Erzeugnisse,2374929000,2547462000,4922391000
2021,7,WA30,Pharmazeutische Erzeugnisse,8857287000,5428259000,14285546000
2021,7,WA31,Düngemittel,191537000,76721000,268258000
2021,7,WA32,"Gerb- und Farbstoffe, Farben, Lacke usw.",988886000,510365000,1499251000
2021,7,WA33,"Etherische Öle, Riech-, Schönheitsmittel",845999000,615561000,1461560000
2021,7,WA34,"Seifen, Waschmittel usw.",712549000,360186000,1072735000
2021,7,WA35,"Eiweißstoffe, Klebstoffe, Enzyme",364254000,226391000,590645000
2021,7,WA36,"Sprengstoffe, pyrotechnische Artikel usw.",15802000,11017000,26819000
2021,7,WA37,Photochemische Erzeugnisse,97868000,54259000,152127000
2021,7,WA38,Verschiedene Erzeugnisse der Chemischen Industrie,2245024000,1380143000,3625167000
2021,7,WA39,Kunststoffe und Waren daraus,6013312000,4188354000,10201666000
2021,7,WA40,Kautschuk und Waren daraus,1283384000,1341272000,2624656000
2021,7,WA41,"Häute, Felle, Leder",55294000,44134000,99428000
2021,7,WA42,"Lederwaren, Sattlerwaren",208403000,320153000,528556000
2021,7,WA43,"Pelzfelle, künstliches Pelzwerk",5921000,9265000,15186000
2021,7,WA44,"Holz, Holzwaren, Holzkohle",1073149000,993319000,2066468000
2021,7,WA45,"Kork, Korkwaren",2496000,10832000,13328000
2021,7,WA46,"Flechtwaren, Korbmacherwaren",5105000,13094000,18199000
2021,7,WA47,"Halbstoffe aus Holz usw., Papierabfall",108456000,337058000,445514000
2021,7,WA48,"Papier, Pappe und Waren daraus",1622916000,1039087000,2662003000
2021,7,WA49,"Bücher, Zeitungen, Bilddrucke usw.",315774000,239246000,555020000
2021,7,WA50,Seide,2015000,2384000,4399000
2021,7,WA51,"Wolle, feine und grobe Tierhaare",30483000,37236000,67719000
2021,7,WA52,Baumwolle,49246000,57671000,106917000
2021,7,WA53,"Andere pflanzliche Spinnstoffe, Papiergarn",2887000,6080000,8967000
2021,7,WA54,Synthetisches oder künstliches Filament,122928000,108779000,231707000
2021,7,WA55,Synthetische oder künstliche Spinnfaser,137687000,117878000,255565000
2021,7,WA56,"Watte, Filz, Vliesstoff usw., Tauwerk",228186000,153956000,382142000
2021,7,WA57,"Teppiche, Fußbodenbelag aus Spinnstoff",45202000,90591000,135793000
2021,7,WA58,"Spezialgewebe, Spitzen, Tapisserien",39928000,21059000,60987000
2021,7,WA59,"Getränkte, bestrichene usw. Gewebe",199086000,99871000,298957000
2021,7,WA60,Gewirke und Gestricke,56771000,39440000,96211000
2021,7,WA61,"Bekleidung usw. aus Gewirken, Gestricken",905134000,1594373000,2499507000
2021,7,WA62,"Andere Bekleidung, Bekleidungszubehör",798372000,1316423000,2114795000
2021,7,WA63,"Andere Konfektion, Spinnstoffwaren usw.",291823000,415593000,707416000
2021,7,WA64,"Schuhe, Gamaschen, ähnliche Waren",670318000,860329000,1530647000
2021,7,WA65,Kopfbedeckungen und Teile davon,50109000,68501000,118610000
2021,7,WA66,"Schirme, Gehstöcke usw., Peitschen",10489000,19548000,30037000
2021,7,WA67,"Zugerichtete Federn, Daunen, künstliche Blumen",12337000,18650000,30987000
2021,7,WA68,"Waren aus Steinen, Gips, Zement usw.",468444000,310822000,779266000
2021,7,WA69,Keramische Waren,330883000,274771000,605654000
2021,7,WA70,Glas und Glaswaren,580720000,433740000,1014460000
2021,7,WA71,"Perlen, Edelsteine, Edelmetalle",1706394000,2632421000,4338815000
2021,7,WA72,Eisen und Stahl,2388346000,2793505000,5181851000
2021,7,WA73,Waren aus Eisen oder Stahl,2534324000,2108143000,4642467000
2021,7,WA74,Kupfer und Waren daraus,1241301000,1142171000,2383472000
2021,7,WA75,Nickel und Waren daraus,107180000,134748000,241928000
2021,7,WA76,Aluminium und Waren daraus,1374742000,1545469000,2920211000
2021,7,WA78,Blei und Waren daraus,44106000,47954000,92060000
2021,7,WA79,Zink und Waren daraus,68669000,144638000,213307000
2021,7,WA80,Zinn und Waren daraus,12356000,44913000,57269000
2021,7,WA81,"Andere unedle Metalle, Cermets usw.",109392000,129249000,238641000
2021,7,WA82,"Werkzeuge, Schneidwaren, Essbestecke",721085000,478340000,1199425000
2021,7,WA83,Verschiedene Waren aus unedlen Metallen,679127000,445147000,1124274000
2021,7,WA84,"Maschinen, Apparate, mechanische Geräte",19280142000,12102985000,31383127000
2021,7,WA85,Elektrotechnische Erzeugnisse,12378040000,12199738000,24577778000
2021,7,WA86,Schienenfahrzeuge,320095000,250157000,570252000
2021,7,WA87,"Kraftfahrzeuge, Landfahrzeuge",16702236000,8902273000,25604509000
2021,7,WA88,"Luftfahrzeuge, Raumfahrzeuge",1613060000,563034000,2176094000
2021,7,WA89,Wasserfahrzeuge,813552000,299588000,1113140000
2021,7,WA90,"Optische, photografische usw. Erzeugnisse",6066549000,3440336000,9506885000
2021,7,WA91,Uhrmacherwaren,139361000,204032000,343393000
2021,7,WA92,Musikinstrumente,57938000,56013000,113951000
2021,7,WA93,Waffen und Munition,59455000,22741000,82196000
2021,7,WA94,"Möbel, Beleuchtungskörper usw.",1327053000,1688239000,3015292000
2021,7,WA95,"Spielzeug, Spiele usw., Sportgeräte",425937000,651117000,1077054000
2021,7,WA96,Verschiedene Waren,346346000,248557000,594903000
2021,7,WA97,"Kunstgegenstände, Sammlungsstücke",101850000,91761000,193611000
2021,7,WA98,Vollständige Fabrikationsanlagen,38948000,0,38948000
2021,7,WA99,Zusammenstellungen verschiedener Waren,1697544000,887146000,2584690000
2021,8,WA01,Lebende Tiere,95522000,92254000,187776000
2021,8,WA02,Fleisch,541440000,510308000,1051748000
2021,8,WA03,"Fische, Krebs- und Weichtiere",98136000,301543000,399679000
2021,8,WA04,"Milch, Milcherzeugnisse, Eier, Honig",814655000,681780000,1496435000
2021,8,WA05,Andere Waren tierischen Ursprungs,64131000,79220000,143351000
2021,8,WA06,"Pflanzen, Waren des Blumenhandels",66717000,216692000,283409000
2021,8,WA07,"Gemüse, Pflanzen für Ernährung",73347000,416602000,489949000
2021,8,WA08,Genießbare Früchte und Nüsse,147428000,885670000,1033098000
2021,8,WA09,"Kaffee, Tee, Mate, Gewürze",258371000,340579000,598950000
2021,8,WA10,Getreide,233071000,242873000,475944000
2021,8,WA11,"Müllereierzeugnisse, Malz usw.",132089000,60079000,192168000
2021,8,WA12,"Ölsamen usw., Heilpflanzen usw.",115760000,684110000,799870000
2021,8,WA13,"Schellack, Gummen, Harz, Pflanzensaft",56323000,48232000,104555000
2021,8,WA14,Flechtstoffe usw. pflanzlichen Ursprungs,805000,3946000,4751000
2021,8,WA15,"Tierische und pflanzliche Fette, Öle, Wachs",309013000,388678000,697691000
2021,8,WA16,"Zubereitungen von Fleisch, Fisch usw.",263883000,256193000,520076000
2021,8,WA17,Zucker und Zuckerwaren,236525000,139940000,376465000
2021,8,WA18,Kakao und Zubereitungen aus Kakao,493078000,385067000,878145000
2021,8,WA19,"Zubereitungen aus Getreide usw., Backwaren",576942000,370638000,947580000
2021,8,WA20,"Zubereitungen von Gemüse, Früchten usw.",226902000,424342000,651244000
2021,8,WA21,Verschiedene Lebensmittelzubereitungen,519845000,339981000,859826000
2021,8,WA22,"Getränke, alkoholhaltige Flüssigkeiten, Essig",520987000,631242000,1152229000
2021,8,WA23,"Rückstände der Lebensmittelindustrie, Futter",467045000,328652000,795697000
2021,8,WA24,Tabak,207952000,233895000,441847000
2021,8,WA25,"Salz, Schwefel, Steine, Erden usw.",141373000,154824000,296197000
2021,8,WA26,"Erze, Schlacken, Aschen",65083000,1101571000,1166654000
2021,8,WA27,Mineralische Brennstoffe usw.,2361342000,7983426000,10344768000
2021,8,WA28,Anorganische chemische Erzeugnisse,1127990000,560502000,1688492000
2021,8,WA29,Organische chemische Erzeugnisse,2351786000,3276820000,5628606000
2021,8,WA30,Pharmazeutische Erzeugnisse,8710996000,4621288000,13332284000
2021,8,WA31,Düngemittel,187676000,61879000,249555000
2021,8,WA32,"Gerb- und Farbstoffe, Farben, Lacke usw.",949925000,523442000,1473367000
2021,8,WA33,"Etherische Öle, Riech-, Schönheitsmittel",852303000,604941000,1457244000
2021,8,WA34,"Seifen, Waschmittel usw.",676182000,371680000,1047862000
2021,8,WA35,"Eiweißstoffe, Klebstoffe, Enzyme",338776000,218859000,557635000
2021,8,WA36,"Sprengstoffe, pyrotechnische Artikel usw.",23112000,10487000,33599000
2021,8,WA37,Photochemische Erzeugnisse,82667000,48271000,130938000
2021,8,WA38,Verschiedene Erzeugnisse der Chemischen Industrie,2205658000,1411228000,3616886000
2021,8,WA39,Kunststoffe und Waren daraus,5472725000,3838650000,9311375000
2021,8,WA40,Kautschuk und Waren daraus,1168118000,1213322000,2381440000
2021,8,WA41,"Häute, Felle, Leder",44086000,35056000,79142000
2021,8,WA42,"Lederwaren, Sattlerwaren",207776000,351359000,559135000
2021,8,WA43,"Pelzfelle, künstliches Pelzwerk",5606000,8614000,14220000
2021,8,WA44,"Holz, Holzwaren, Holzkohle",951479000,892226000,1843705000
2021,8,WA45,"Kork, Korkwaren",2444000,10203000,12647000
2021,8,WA46,"Flechtwaren, Korbmacherwaren",4483000,14218000,18701000
2021,8,WA47,"Halbstoffe aus Holz usw., Papierabfall",107541000,355690000,463231000
2021,8,WA48,"Papier, Pappe und Waren daraus",1551596000,1027894000,2579490000
2021,8,WA49,"Bücher, Zeitungen, Bilddrucke usw.",349910000,246018000,595928000
2021,8,WA50,Seide,797000,828000,1625000
2021,8,WA51,"Wolle, feine und grobe Tierhaare",26452000,29261000,55713000
2021,8,WA52,Baumwolle,40545000,49951000,90496000
2021,8,WA53,"Andere pflanzliche Spinnstoffe, Papiergarn",1830000,4343000,6173000
2021,8,WA54,Synthetisches oder künstliches Filament,113985000,91112000,205097000
2021,8,WA55,Synthetische oder künstliche Spinnfaser,106153000,99550000,205703000
2021,8,WA56,"Watte, Filz, Vliesstoff usw., Tauwerk",200610000,138443000,339053000
2021,8,WA57,"Teppiche, Fußbodenbelag aus Spinnstoff",39240000,84939000,124179000
2021,8,WA58,"Spezialgewebe, Spitzen, Tapisserien",35435000,18860000,54295000
2021,8,WA59,"Getränkte, bestrichene usw. Gewebe",175759000,88625000,264384000
2021,8,WA60,Gewirke und Gestricke,45023000,28065000,73088000
2021,8,WA61,"Bekleidung usw. aus Gewirken, Gestricken",963082000,1778878000,2741960000
2021,8,WA62,"Andere Bekleidung, Bekleidungszubehör",852689000,1399542000,2252231000
2021,8,WA63,"Andere Konfektion, Spinnstoffwaren usw.",265089000,453187000,718276000
2021,8,WA64,"Schuhe, Gamaschen, ähnliche Waren",747273000,1054839000,1802112000
2021,8,WA65,Kopfbedeckungen und Teile davon,47760000,76654000,124414000
2021,8,WA66,"Schirme, Gehstöcke usw., Peitschen",6278000,17893000,24171000
2021,8,WA67,"Zugerichtete Federn, Daunen, künstliche Blumen",14605000,24590000,39195000
2021,8,WA68,"Waren aus Steinen, Gips, Zement usw.",396832000,277057000,673889000
2021,8,WA69,Keramische Waren,296167000,267417000,563584000
2021,8,WA70,Glas und Glaswaren,527006000,405735000,932741000
2021,8,WA71,"Perlen, Edelsteine, Edelmetalle",1591810000,2878384000,4470194000
2021,8,WA72,Eisen und Stahl,2172939000,2613498000,4786437000
2021,8,WA73,Waren aus Eisen oder Stahl,2269721000,1947467000,4217188000
2021,8,WA74,Kupfer und Waren daraus,1111446000,815863000,1927309000
2021,8,WA75,Nickel und Waren daraus,109942000,128806000,238748000
2021,8,WA76,Aluminium und Waren daraus,1214546000,1444487000,2659033000
2021,8,WA78,Blei und Waren daraus,43553000,38007000,81560000
2021,8,WA79,Zink und Waren daraus,53672000,116294000,169966000
2021,8,WA80,Zinn und Waren daraus,10158000,48802000,58960000
2021,8,WA81,"Andere unedle Metalle, Cermets usw.",94970000,118994000,213964000
2021,8,WA82,"Werkzeuge, Schneidwaren, Essbestecke",710410000,465728000,1176138000
2021,8,WA83,Verschiedene Waren aus unedlen Metallen,600186000,414452000,1014638000
2021,8,WA84,"Maschinen, Apparate, mechanische Geräte",17854883000,11168157000,29023040000
2021,8,WA85,Elektrotechnische Erzeugnisse,11945476000,11548422000,23493898000
2021,8,WA86,Schienenfahrzeuge,223766000,168086000,391852000
2021,8,WA87,"Kraftfahrzeuge, Landfahrzeuge",11344016000,6631176000,17975192000
2021,8,WA88,"Luftfahrzeuge, Raumfahrzeuge",1628929000,1378164000,3007093000
2021,8,WA89,Wasserfahrzeuge,136255000,164147000,300402000
2021,8,WA90,"Optische, photografische usw. Erzeugnisse",5694876000,3289743000,8984619000
2021,8,WA91,Uhrmacherwaren,128524000,173138000,301662000
2021,8,WA92,Musikinstrumente,55529000,60679000,116208000
2021,8,WA93,Waffen und Munition,38281000,21655000,59936000
2021,8,WA94,"Möbel, Beleuchtungskörper usw.",1181644000,1644925000,2826569000
2021,8,WA95,"Spielzeug, Spiele usw., Sportgeräte",430886000,748974000,1179860000
2021,8,WA96,Verschiedene Waren,311375000,274342000,585717000
2021,8,WA97,"Kunstgegenstände, Sammlungsstücke",86579000,48586000,135165000
2021,8,WA98,Vollständige Fabrikationsanlagen,53218000,0,53218000
2021,8,WA99,Zusammenstellungen verschiedener Waren,1374936000,824466000,2199402000
2021,9,WA01,Lebende Tiere,97704000,92438000,190142000
2021,9,WA02,Fleisch,534832000,539254000,1074086000
2021,9,WA03,"Fische, Krebs- und Weichtiere",114011000,307854000,421865000
2021,9,WA04,"Milch, Milcherzeugnisse, Eier, Honig",827955000,768272000,1596227000
2021,9,WA05,Andere Waren tierischen Ursprungs,85725000,89337000,175062000
2021,9,WA06,"Pflanzen, Waren des Blumenhandels",89987000,218564000,308551000
2021,9,WA07,"Gemüse, Pflanzen für Ernährung",104765000,459762000,564527000
2021,9,WA08,Genießbare Früchte und Nüsse,163772000,883260000,1047032000
2021,9,WA09,"Kaffee, Tee, Mate, Gewürze",272892000,390233000,663125000
2021,9,WA10,Getreide,257005000,314441000,571446000
2021,9,WA11,"Müllereierzeugnisse, Malz usw.",146508000,69804000,216312000
2021,9,WA12,"Ölsamen usw., Heilpflanzen usw.",100294000,529437000,629731000
2021,9,WA13,"Schellack, Gummen, Harz, Pflanzensaft",54306000,55015000,109321000
2021,9,WA14,Flechtstoffe usw. pflanzlichen Ursprungs,754000,3723000,4477000
2021,9,WA15,"Tierische und pflanzliche Fette, Öle, Wachs",341154000,397962000,739116000
2021,9,WA16,"Zubereitungen von Fleisch, Fisch usw.",249022000,248142000,497164000
2021,9,WA17,Zucker und Zuckerwaren,264019000,146731000,410750000
2021,9,WA18,Kakao und Zubereitungen aus Kakao,592706000,418759000,1011465000
2021,9,WA19,"Zubereitungen aus Getreide usw., Backwaren",626313000,425287000,1051600000
2021,9,WA20,"Zubereitungen von Gemüse, Früchten usw.",227139000,442001000,669140000
2021,9,WA21,Verschiedene Lebensmittelzubereitungen,540467000,336149000,876616000
2021,9,WA22,"Getränke, alkoholhaltige Flüssigkeiten, Essig",523390000,750575000,1273965000
2021,9,WA23,"Rückstände der Lebensmittelindustrie, Futter",476590000,362836000,839426000
2021,9,WA24,Tabak,210626000,249412000,460038000
2021,9,WA25,"Salz, Schwefel, Steine, Erden usw.",186343000,172739000,359082000
2021,9,WA26,"Erze, Schlacken, Aschen",71082000,1185311000,1256393000
2021,9,WA27,Mineralische Brennstoffe usw.,2897192000,8874279000,11771471000
2021,9,WA28,Anorganische chemische Erzeugnisse,1094514000,579277000,1673791000
2021,9,WA29,Organische chemische Erzeugnisse,2547345000,2994438000,5541783000
2021,9,WA30,Pharmazeutische Erzeugnisse,9016735000,4939964000,13956699000
2021,9,WA31,Düngemittel,231572000,89865000,321437000
2021,9,WA32,"Gerb- und Farbstoffe, Farben, Lacke usw.",1047004000,536173000,1583177000
2021,9,WA33,"Etherische Öle, Riech-, Schönheitsmittel",956846000,726224000,1683070000
2021,9,WA34,"Seifen, Waschmittel usw.",711125000,408797000,1119922000
2021,9,WA35,"Eiweißstoffe, Klebstoffe, Enzyme",389239000,228009000,617248000
2021,9,WA36,"Sprengstoffe, pyrotechnische Artikel usw.",22365000,11666000,34031000
2021,9,WA37,Photochemische Erzeugnisse,87284000,50778000,138062000
2021,9,WA38,Verschiedene Erzeugnisse der Chemischen Industrie,2313702000,1435224000,3748926000
2021,9,WA39,Kunststoffe und Waren daraus,6111526000,4068282000,10179808000
2021,9,WA40,Kautschuk und Waren daraus,1319346000,1319576000,2638922000
2021,9,WA41,"Häute, Felle, Leder",54424000,41661000,96085000
2021,9,WA42,"Lederwaren, Sattlerwaren",215906000,352843000,568749000
2021,9,WA43,"Pelzfelle, künstliches Pelzwerk",7499000,10785000,18284000
2021,9,WA44,"Holz, Holzwaren, Holzkohle",1014767000,898414000,1913181000
2021,9,WA45,"Kork, Korkwaren",1858000,5914000,7772000
2021,9,WA46,"Flechtwaren, Korbmacherwaren",3912000,14695000,18607000
2021,9,WA47,"Halbstoffe aus Holz usw., Papierabfall",110336000,375845000,486181000
2021,9,WA48,"Papier, Pappe und Waren daraus",1754323000,1072342000,2826665000
2021,9,WA49,"Bücher, Zeitungen, Bilddrucke usw.",371191000,253937000,625128000
2021,9,WA50,Seide,1790000,1944000,3734000
2021,9,WA51,"Wolle, feine und grobe Tierhaare",39007000,39055000,78062000
2021,9,WA52,Baumwolle,57214000,58947000,116161000
2021,9,WA53,"Andere pflanzliche Spinnstoffe, Papiergarn",3939000,6585000,10524000
2021,9,WA54,Synthetisches oder künstliches Filament,131995000,116304000,248299000
2021,9,WA55,Synthetische oder künstliche Spinnfaser,125978000,121471000,247449000
2021,9,WA56,"Watte, Filz, Vliesstoff usw., Tauwerk",227122000,142975000,370097000
2021,9,WA57,"Teppiche, Fußbodenbelag aus Spinnstoff",46620000,94983000,141603000
2021,9,WA58,"Spezialgewebe, Spitzen, Tapisserien",40846000,22052000,62898000
2021,9,WA59,"Getränkte, bestrichene usw. Gewebe",199505000,95701000,295206000
2021,9,WA60,Gewirke und Gestricke,53420000,35839000,89259000
2021,9,WA61,"Bekleidung usw. aus Gewirken, Gestricken",1043946000,1862167000,2906113000
2021,9,WA62,"Andere Bekleidung, Bekleidungszubehör",939263000,1529477000,2468740000
2021,9,WA63,"Andere Konfektion, Spinnstoffwaren usw.",279524000,475766000,755290000
2021,9,WA64,"Schuhe, Gamaschen, ähnliche Waren",716707000,979637000,1696344000
2021,9,WA65,Kopfbedeckungen und Teile davon,52926000,73829000,126755000
2021,9,WA66,"Schirme, Gehstöcke usw., Peitschen",6020000,16232000,22252000
2021,9,WA67,"Zugerichtete Federn, Daunen, künstliche Blumen",16121000,27288000,43409000
2021,9,WA68,"Waren aus Steinen, Gips, Zement usw.",461809000,319524000,781333000
2021,9,WA69,Keramische Waren,330395000,265336000,595731000
2021,9,WA70,Glas und Glaswaren,599909000,445244000,1045153000
2021,9,WA71,"Perlen, Edelsteine, Edelmetalle",1660132000,2094436000,3754568000
2021,9,WA72,Eisen und Stahl,2532074000,2847578000,5379652000
2021,9,WA73,Waren aus Eisen oder Stahl,2526018000,2132907000,4658925000
2021,9,WA74,Kupfer und Waren daraus,1286333000,1004548000,2290881000
2021,9,WA75,Nickel und Waren daraus,120860000,166583000,287443000
2021,9,WA76,Aluminium und Waren daraus,1424464000,1592705000,3017169000
2021,9,WA78,Blei und Waren daraus,38992000,43022000,82014000
2021,9,WA79,Zink und Waren daraus,71139000,136556000,207695000
2021,9,WA80,Zinn und Waren daraus,12707000,56817000,69524000
2021,9,WA81,"Andere unedle Metalle, Cermets usw.",125868000,142742000,268610000
2021,9,WA82,"Werkzeuge, Schneidwaren, Essbestecke",721501000,505434000,1226935000
2021,9,WA83,Verschiedene Waren aus unedlen Metallen,666615000,457756000,1124371000
2021,9,WA84,"Maschinen, Apparate, mechanische Geräte",19693729000,12649187000,32342916000
2021,9,WA85,Elektrotechnische Erzeugnisse,13007325000,13175526000,26182851000
2021,9,WA86,Schienenfahrzeuge,241368000,354646000,596014000
2021,9,WA87,"Kraftfahrzeuge, Landfahrzeuge",16537388000,9116593000,25653981000
2021,9,WA88,"Luftfahrzeuge, Raumfahrzeuge",1470711000,1018814000,2489525000
2021,9,WA89,Wasserfahrzeuge,341542000,296774000,638316000
2021,9,WA90,"Optische, photografische usw. Erzeugnisse",6255393000,3460377000,9715770000
2021,9,WA91,Uhrmacherwaren,156203000,218897000,375100000
2021,9,WA92,Musikinstrumente,67666000,64165000,131831000
2021,9,WA93,Waffen und Munition,49863000,21063000,70926000
2021,9,WA94,"Möbel, Beleuchtungskörper usw.",1446390000,1876033000,3322423000
2021,9,WA95,"Spielzeug, Spiele usw., Sportgeräte",549490000,840094000,1389584000
2021,9,WA96,Verschiedene Waren,347982000,286213000,634195000
2021,9,WA97,"Kunstgegenstände, Sammlungsstücke",121626000,50603000,172229000
2021,9,WA98,Vollständige Fabrikationsanlagen,44385000,0,44385000
2021,9,WA99,Zusammenstellungen verschiedener Waren,1345751000,875912000,2221663000
2021,10,WA01,Lebende Tiere,117410000,88822000,206232000
2021,10,WA02,Fleisch,539874000,605465000,1145339000
2021,10,WA03,"Fische, Krebs- und Weichtiere",137459000,353256000,490715000
2021,10,WA04,"Milch, Milcherzeugnisse, Eier, Honig",835384000,784282000,1619666000
2021,10,WA05,Andere Waren tierischen Ursprungs,75358000,94407000,169765000
2021,10,WA06,"Pflanzen, Waren des Blumenhandels",93029000,234875000,327904000
2021,10,WA07,"Gemüse, Pflanzen für Ernährung",118823000,496513000,615336000
2021,10,WA08,Genießbare Früchte und Nüsse,158788000,921924000,1080712000
2021,10,WA09,"Kaffee, Tee, Mate, Gewürze",288200000,409542000,697742000
2021,10,WA10,Getreide,230783000,273379000,504162000
2021,10,WA11,"Müllereierzeugnisse, Malz usw.",154217000,68109000,222326000
2021,10,WA12,"Ölsamen usw., Heilpflanzen usw.",112215000,579551000,691766000
2021,10,WA13,"Schellack, Gummen, Harz, Pflanzensaft",57165000,48560000,105725000
2021,10,WA14,Flechtstoffe usw. pflanzlichen Ursprungs,1162000,4976000,6138000
2021,10,WA15,"Tierische und pflanzliche Fette, Öle, Wachs",330130000,427765000,757895000
2021,10,WA16,"Zubereitungen von Fleisch, Fisch usw.",270107000,264686000,534793000
2021,10,WA17,Zucker und Zuckerwaren,249182000,145079000,394261000
2021,10,WA18,Kakao und Zubereitungen aus Kakao,621773000,399724000,1021497000
2021,10,WA19,"Zubereitungen aus Getreide usw., Backwaren",638136000,423390000,1061526000
2021,10,WA20,"Zubereitungen von Gemüse, Früchten usw.",259914000,466303000,726217000
2021,10,WA21,Verschiedene Lebensmittelzubereitungen,529547000,340089000,869636000
2021,10,WA22,"Getränke, alkoholhaltige Flüssigkeiten, Essig",561701000,734807000,1296508000
2021,10,WA23,"Rückstände der Lebensmittelindustrie, Futter",492957000,402092000,895049000
2021,10,WA24,Tabak,216119000,239294000,455413000
2021,10,WA25,"Salz, Schwefel, Steine, Erden usw.",192258000,151034000,343292000
2021,10,WA26,"Erze, Schlacken, Aschen",88729000,1106591000,1195320000
2021,10,WA27,Mineralische Brennstoffe usw.,3133072000,10911689000,14044761000
2021,10,WA28,Anorganische chemische Erzeugnisse,991476000,565059000,1556535000
2021,10,WA29,Organische chemische Erzeugnisse,2413059000,2477096000,4890155000
2021,10,WA30,Pharmazeutische Erzeugnisse,8260064000,6698474000,14958538000
2021,10,WA31,Düngemittel,274180000,109921000,384101000
2021,10,WA32,"Gerb- und Farbstoffe, Farben, Lacke usw.",996463000,471839000,1468302000
2021,10,WA33,"Etherische Öle, Riech-, Schönheitsmittel",939906000,648795000,1588701000
2021,10,WA34,"Seifen, Waschmittel usw.",712267000,423807000,1136074000
2021,10,WA35,"Eiweißstoffe, Klebstoffe, Enzyme",359599000,211899000,571498000
2021,10,WA36,"Sprengstoffe, pyrotechnische Artikel usw.",23029000,19339000,42368000
2021,10,WA37,Photochemische Erzeugnisse,95936000,50174000,146110000
2021,10,WA38,Verschiedene Erzeugnisse der Chemischen Industrie,2325627000,1422256000,3747883000
2021,10,WA39,Kunststoffe und Waren daraus,5974983000,4225641000,10200624000
2021,10,WA40,Kautschuk und Waren daraus,1341103000,1369563000,2710666000
2021,10,WA41,"Häute, Felle, Leder",53954000,46684000,100638000
2021,10,WA42,"Lederwaren, Sattlerwaren",215906000,346909000,562815000
2021,10,WA43,"Pelzfelle, künstliches Pelzwerk",7593000,10222000,17815000
2021,10,WA44,"Holz, Holzwaren, Holzkohle",1046956000,919030000,1965986000
2021,10,WA45,"Kork, Korkwaren",2478000,10443000,12921000
2021,10,WA46,"Flechtwaren, Korbmacherwaren",5037000,13406000,18443000
2021,10,WA47,"Halbstoffe aus Holz usw., Papierabfall",113871000,390769000,504640000
2021,10,WA48,"Papier, Pappe und Waren daraus",1745415000,1132239000,2877654000
2021,10,WA49,"Bücher, Zeitungen, Bilddrucke usw.",367264000,261797000,629061000
2021,10,WA50,Seide,1108000,2217000,3325000
2021,10,WA51,"Wolle, feine und grobe Tierhaare",35023000,44228000,79251000
2021,10,WA52,Baumwolle,60185000,63748000,123933000
2021,10,WA53,"Andere pflanzliche Spinnstoffe, Papiergarn",3947000,6877000,10824000
2021,10,WA54,Synthetisches oder künstliches Filament,131604000,119633000,251237000
2021,10,WA55,Synthetische oder künstliche Spinnfaser,135499000,115622000,251121000
2021,10,WA56,"Watte, Filz, Vliesstoff usw., Tauwerk",220063000,148020000,368083000
2021,10,WA57,"Teppiche, Fußbodenbelag aus Spinnstoff",46322000,106896000,153218000
2021,10,WA58,"Spezialgewebe, Spitzen, Tapisserien",43519000,23385000,66904000
2021,10,WA59,"Getränkte, bestrichene usw. Gewebe",204076000,101979000,306055000
2021,10,WA60,Gewirke und Gestricke,57596000,38772000,96368000
2021,10,WA61,"Bekleidung usw. aus Gewirken, Gestricken",1147459000,1950077000,3097536000
2021,10,WA62,"Andere Bekleidung, Bekleidungszubehör",1030931000,1556977000,2587908000
2021,10,WA63,"Andere Konfektion, Spinnstoffwaren usw.",284744000,468985000,753729000
2021,10,WA64,"Schuhe, Gamaschen, ähnliche Waren",701870000,988340000,1690210000
2021,10,WA65,Kopfbedeckungen und Teile davon,54164000,82079000,136243000
2021,10,WA66,"Schirme, Gehstöcke usw., Peitschen",6934000,16956000,23890000
2021,10,WA67,"Zugerichtete Federn, Daunen, künstliche Blumen",17085000,29525000,46610000
2021,10,WA68,"Waren aus Steinen, Gips, Zement usw.",436878000,316187000,753065000
2021,10,WA69,Keramische Waren,327715000,292605000,620320000
2021,10,WA70,Glas und Glaswaren,599550000,460201000,1059751000
2021,10,WA71,"Perlen, Edelsteine, Edelmetalle",1760695000,2318250000,4078945000
2021,10,WA72,Eisen und Stahl,2591949000,3076658000,5668607000
2021,10,WA73,Waren aus Eisen oder Stahl,2511103000,2268431000,4779534000
2021,10,WA74,Kupfer und Waren daraus,1245111000,1127172000,2372283000
2021,10,WA75,Nickel und Waren daraus,114161000,153376000,267537000
2021,10,WA76,Aluminium und Waren daraus,1467789000,1720234000,3188023000
2021,10,WA78,Blei und Waren daraus,35556000,49106000,84662000
2021,10,WA79,Zink und Waren daraus,69418000,119066000,188484000
2021,10,WA80,Zinn und Waren daraus,13600000,54223000,67823000
2021,10,WA81,"Andere unedle Metalle, Cermets usw.",115578000,148513000,264091000
2021,10,WA82,"Werkzeuge, Schneidwaren, Essbestecke",780190000,499170000,1279360000
2021,10,WA83,Verschiedene Waren aus unedlen Metallen,666135000,460212000,1126347000
2021,10,WA84,"Maschinen, Apparate, mechanische Geräte",19232124000,12949133000,32181257000
2021,10,WA85,Elektrotechnische Erzeugnisse,12964272000,13724816000,26689088000
2021,10,WA86,Schienenfahrzeuge,338400000,210431000,548831000
2021,10,WA87,"Kraftfahrzeuge, Landfahrzeuge",18855829000,9660226000,28516055000
2021,10,WA88,"Luftfahrzeuge, Raumfahrzeuge",2026510000,1155627000,3182137000
2021,10,WA89,Wasserfahrzeuge,1163697000,275058000,1438755000
2021,10,WA90,"Optische, photografische usw. Erzeugnisse",5991027000,3476825000,9467852000
2021,10,WA91,Uhrmacherwaren,173128000,221542000,394670000
2021,10,WA92,Musikinstrumente,69649000,75929000,145578000
2021,10,WA93,Waffen und Munition,59939000,26923000,86862000
2021,10,WA94,"Möbel, Beleuchtungskörper usw.",1461813000,1969601000,3431414000
2021,10,WA95,"Spielzeug, Spiele usw., Sportgeräte",653472000,1104044000,1757516000
2021,10,WA96,Verschiedene Waren,358218000,292788000,651006000
2021,10,WA97,"Kunstgegenstände, Sammlungsstücke",59201000,49530000,108731000
2021,10,WA98,Vollständige Fabrikationsanlagen,44156000,0,44156000
2021,10,WA99,Zusammenstellungen verschiedener Waren,1410924000,996508000,2407432000
2021,11,WA01,Lebende Tiere,103127000,93090000,196217000
2021,11,WA02,Fleisch,569375000,599329000,1168704000
2021,11,WA03,"Fische, Krebs- und Weichtiere",137030000,371347000,508377000
2021,11,WA04,"Milch, Milcherzeugnisse, Eier, Honig",856428000,873974000,1730402000
2021,11,WA05,Andere Waren tierischen Ursprungs,78615000,95241000,173856000
2021,11,WA06,"Pflanzen, Waren des Blumenhandels",72695000,234312000,307007000
2021,11,WA07,"Gemüse, Pflanzen für Ernährung",90912000,524534000,615446000
2021,11,WA08,Genießbare Früchte und Nüsse,177939000,933058000,1110997000
2021,11,WA09,"Kaffee, Tee, Mate, Gewürze",302621000,432801000,735422000
2021,11,WA10,Getreide,238689000,270411000,509100000
2021,11,WA11,"Müllereierzeugnisse, Malz usw.",164055000,70532000,234587000
2021,11,WA12,"Ölsamen usw., Heilpflanzen usw.",134448000,623750000,758198000
2021,11,WA13,"Schellack, Gummen, Harz, Pflanzensaft",58907000,55790000,114697000
2021,11,WA14,Flechtstoffe usw. pflanzlichen Ursprungs,767000,3109000,3876000
2021,11,WA15,"Tierische und pflanzliche Fette, Öle, Wachs",334391000,452672000,787063000
2021,11,WA16,"Zubereitungen von Fleisch, Fisch usw.",243657000,292908000,536565000
2021,11,WA17,Zucker und Zuckerwaren,294476000,154870000,449346000
2021,11,WA18,Kakao und Zubereitungen aus Kakao,617254000,470063000,1087317000
2021,11,WA19,"Zubereitungen aus Getreide usw., Backwaren",627235000,427479000,1054714000
2021,11,WA20,"Zubereitungen von Gemüse, Früchten usw.",243746000,486753000,730499000
2021,11,WA21,Verschiedene Lebensmittelzubereitungen,566355000,345846000,912201000
2021,11,WA22,"Getränke, alkoholhaltige Flüssigkeiten, Essig",546233000,824880000,1371113000
2021,11,WA23,"Rückstände der Lebensmittelindustrie, Futter",519049000,440416000,959465000
2021,11,WA24,Tabak,235290000,301391000,536681000
2021,11,WA25,"Salz, Schwefel, Steine, Erden usw.",186424000,156270000,342694000
2021,11,WA26,"Erze, Schlacken, Aschen",78324000,795371000,873695000
2021,11,WA27,Mineralische Brennstoffe usw.,3510912000,12358363000,15869275000
2021,11,WA28,Anorganische chemische Erzeugnisse,1086170000,602599000,1688769000
2021,11,WA29,Organische chemische Erzeugnisse,2664145000,2635296000,5299441000
2021,11,WA30,Pharmazeutische Erzeugnisse,8772108000,6699891000,15471999000
2021,11,WA31,Düngemittel,310609000,145054000,455663000
2021,11,WA32,"Gerb- und Farbstoffe, Farben, Lacke usw.",1028201000,592988000,1621189000
2021,11,WA33,"Etherische Öle, Riech-, Schönheitsmittel",1008186000,713474000,1721660000
2021,11,WA34,"Seifen, Waschmittel usw.",716133000,436908000,1153041000
2021,11,WA35,"Eiweißstoffe, Klebstoffe, Enzyme",378420000,221793000,600213000
2021,11,WA36,"Sprengstoffe, pyrotechnische Artikel usw.",27272000,18079000,45351000
2021,11,WA37,Photochemische Erzeugnisse,96056000,64229000,160285000
2021,11,WA38,Verschiedene Erzeugnisse der Chemischen Industrie,2526788000,1586121000,4112909000
2021,11,WA39,Kunststoffe und Waren daraus,6156185000,4184934000,10341119000
2021,11,WA40,Kautschuk und Waren daraus,1353883000,1297487000,2651370000
2021,11,WA41,"Häute, Felle, Leder",55123000,46986000,102109000
2021,11,WA42,"Lederwaren, Sattlerwaren",227298000,386442000,613740000
2021,11,WA43,"Pelzfelle, künstliches Pelzwerk",6821000,9374000,16195000
2021,11,WA44,"Holz, Holzwaren, Holzkohle",1059985000,857243000,1917228000
2021,11,WA45,"Kork, Korkwaren",2253000,9913000,12166000
2021,11,WA46,"Flechtwaren, Korbmacherwaren",4317000,13239000,17556000
2021,11,WA47,"Halbstoffe aus Holz usw., Papierabfall",104412000,352365000,456777000
2021,11,WA48,"Papier, Pappe und Waren daraus",1808269000,1188251000,2996520000
2021,11,WA49,"Bücher, Zeitungen, Bilddrucke usw.",382656000,293906000,676562000
2021,11,WA50,Seide,2868000,2446000,5314000
2021,11,WA51,"Wolle, feine und grobe Tierhaare",40424000,46084000,86508000
2021,11,WA52,Baumwolle,60265000,67144000,127409000
2021,11,WA53,"Andere pflanzliche Spinnstoffe, Papiergarn",5056000,9345000,14401000
2021,11,WA54,Synthetisches oder künstliches Filament,141870000,127871000,269741000
2021,11,WA55,Synthetische oder künstliche Spinnfaser,128476000,126884000,255360000
2021,11,WA56,"Watte, Filz, Vliesstoff usw., Tauwerk",221850000,147512000,369362000
2021,11,WA57,"Teppiche, Fußbodenbelag aus Spinnstoff",49677000,109519000,159196000
2021,11,WA58,"Spezialgewebe, Spitzen, Tapisserien",45298000,24338000,69636000
2021,11,WA59,"Getränkte, bestrichene usw. Gewebe",202218000,102402000,304620000
2021,11,WA60,Gewirke und Gestricke,65031000,45282000,110313000
2021,11,WA61,"Bekleidung usw. aus Gewirken, Gestricken",1140794000,1945814000,3086608000
2021,11,WA62,"Andere Bekleidung, Bekleidungszubehör",958501000,1418225000,2376726000
2021,11,WA63,"Andere Konfektion, Spinnstoffwaren usw.",289721000,479499000,769220000
2021,11,WA64,"Schuhe, Gamaschen, ähnliche Waren",630738000,947686000,1578424000
2021,11,WA65,Kopfbedeckungen und Teile davon,55537000,80782000,136319000
2021,11,WA66,"Schirme, Gehstöcke usw., Peitschen",7345000,16024000,23369000
2021,11,WA67,"Zugerichtete Federn, Daunen, künstliche Blumen",14315000,27492000,41807000
2021,11,WA68,"Waren aus Steinen, Gips, Zement usw.",444930000,308650000,753580000
2021,11,WA69,Keramische Waren,331979000,276918000,608897000
2021,11,WA70,Glas und Glaswaren,621930000,468169000,1090099000
2021,11,WA71,"Perlen, Edelsteine, Edelmetalle",1862673000,2538578000,4401251000
2021,11,WA72,Eisen und Stahl,2651137000,3004831000,5655968000
2021,11,WA73,Waren aus Eisen oder Stahl,2445380000,2289949000,4735329000
2021,11,WA74,Kupfer und Waren daraus,1301208000,1047813000,2349021000
2021,11,WA75,Nickel und Waren daraus,120167000,161560000,281727000
2021,11,WA76,Aluminium und Waren daraus,1543941000,1786104000,3330045000
2021,11,WA78,Blei und Waren daraus,41366000,46376000,87742000
2021,11,WA79,Zink und Waren daraus,78653000,121924000,200577000
2021,11,WA80,Zinn und Waren daraus,15999000,52599000,68598000
2021,11,WA81,"Andere unedle Metalle, Cermets usw.",128240000,169468000,297708000
2021,11,WA82,"Werkzeuge, Schneidwaren, Essbestecke",769798000,553261000,1323059000
2021,11,WA83,Verschiedene Waren aus unedlen Metallen,646930000,470694000,1117624000
2021,11,WA84,"Maschinen, Apparate, mechanische Geräte",20038338000,13560955000,33599293000
2021,11,WA85,Elektrotechnische Erzeugnisse,13573243000,15284805000,28858048000
2021,11,WA86,Schienenfahrzeuge,313690000,251468000,565158000
2021,11,WA87,"Kraftfahrzeuge, Landfahrzeuge",19726231000,10764050000,30490281000
2021,11,WA88,"Luftfahrzeuge, Raumfahrzeuge",2375080000,974505000,3349585000
2021,11,WA89,Wasserfahrzeuge,609614000,164663000,774277000
2021,11,WA90,"Optische, photografische usw. Erzeugnisse",6346338000,3773130000,10119468000
2021,11,WA91,Uhrmacherwaren,175900000,238355000,414255000
2021,11,WA92,Musikinstrumente,72194000,75401000,147595000
2021,11,WA93,Waffen und Munition,60872000,24486000,85358000
2021,11,WA94,"Möbel, Beleuchtungskörper usw.",1517187000,2050956000,3568143000
2021,11,WA95,"Spielzeug, Spiele usw., Sportgeräte",800736000,1196085000,1996821000
2021,11,WA96,Verschiedene Waren,358850000,320117000,678967000
2021,11,WA97,"Kunstgegenstände, Sammlungsstücke",133489000,64513000,198002000
2021,11,WA98,Vollständige Fabrikationsanlagen,34144000,13000,34157000
2021,11,WA99,Zusammenstellungen verschiedener Waren,1347259000,992359000,2339618000
2021,12,WA01,Lebende Tiere,119147000,94505000,213652000
2021,12,WA02,Fleisch,542360000,618001000,1160361000
2021,12,WA03,"Fische, Krebs- und Weichtiere",151066000,405055000,556121000
2021,12,WA04,"Milch, Milcherzeugnisse, Eier, Honig",913574000,876120000,1789694000
2021,12,WA05,Andere Waren tierischen Ursprungs,70039000,89963000,160002000
2021,12,WA06,"Pflanzen, Waren des Blumenhandels",65190000,250691000,315881000
2021,12,WA07,"Gemüse, Pflanzen für Ernährung",94238000,660894000,755132000
2021,12,WA08,Genießbare Früchte und Nüsse,161366000,929281000,1090647000
2021,12,WA09,"Kaffee, Tee, Mate, Gewürze",300185000,433706000,733891000
2021,12,WA10,Getreide,289254000,277820000,567074000
2021,12,WA11,"Müllereierzeugnisse, Malz usw.",163644000,68863000,232507000
2021,12,WA12,"Ölsamen usw., Heilpflanzen usw.",135934000,740133000,876067000
2021,12,WA13,"Schellack, Gummen, Harz, Pflanzensaft",55128000,51841000,106969000
2021,12,WA14,Flechtstoffe usw. pflanzlichen Ursprungs,882000,5008000,5890000
2021,12,WA15,"Tierische und pflanzliche Fette, Öle, Wachs",323116000,480150000,803266000
2021,12,WA16,"Zubereitungen von Fleisch, Fisch usw.",277271000,317302000,594573000
2021,12,WA17,Zucker und Zuckerwaren,237242000,134111000,371353000
2021,12,WA18,Kakao und Zubereitungen aus Kakao,476892000,343314000,820206000
2021,12,WA19,"Zubereitungen aus Getreide usw., Backwaren",552216000,430237000,982453000
2021,12,WA20,"Zubereitungen von Gemüse, Früchten usw.",236733000,446995000,683728000
2021,12,WA21,Verschiedene Lebensmittelzubereitungen,544580000,347287000,891867000
2021,12,WA22,"Getränke, alkoholhaltige Flüssigkeiten, Essig",467121000,739977000,1207098000
2021,12,WA23,"Rückstände der Lebensmittelindustrie, Futter",530437000,442227000,972664000
2021,12,WA24,Tabak,182994000,309455000,492449000
2021,12,WA25,"Salz, Schwefel, Steine, Erden usw.",185162000,155703000,340865000
2021,12,WA26,"Erze, Schlacken, Aschen",79382000,1176340000,1255722000
2021,12,WA27,Mineralische Brennstoffe usw.,4014076000,13695716000,17709792000
2021,12,WA28,Anorganische chemische Erzeugnisse,1123034000,647430000,1770464000
2021,12,WA29,Organische chemische Erzeugnisse,2585086000,3038875000,5623961000
2021,12,WA30,Pharmazeutische Erzeugnisse,8548669000,5518852000,14067521000
2021,12,WA31,Düngemittel,349085000,137827000,486912000
2021,12,WA32,"Gerb- und Farbstoffe, Farben, Lacke usw.",872411000,460640000,1333051000
2021,12,WA33,"Etherische Öle, Riech-, Schönheitsmittel",840566000,650054000,1490620000
2021,12,WA34,"Seifen, Waschmittel usw.",649861000,378154000,1028015000
2021,12,WA35,"Eiweißstoffe, Klebstoffe, Enzyme",327466000,214753000,542219000
2021,12,WA36,"Sprengstoffe, pyrotechnische Artikel usw.",24964000,14135000,39099000
2021,12,WA37,Photochemische Erzeugnisse,93633000,54381000,148014000
2021,12,WA38,Verschiedene Erzeugnisse der Chemischen Industrie,2408753000,1931587000,4340340000
2021,12,WA39,Kunststoffe und Waren daraus,5242016000,3744027000,8986043000
2021,12,WA40,Kautschuk und Waren daraus,1114439000,1036234000,2150673000
2021,12,WA41,"Häute, Felle, Leder",54734000,41788000,96522000
2021,12,WA42,"Lederwaren, Sattlerwaren",212706000,376793000,589499000
2021,12,WA43,"Pelzfelle, künstliches Pelzwerk",5875000,11126000,17001000
2021,12,WA44,"Holz, Holzwaren, Holzkohle",821895000,730317000,1552212000
2021,12,WA45,"Kork, Korkwaren",2455000,9844000,12299000
2021,12,WA46,"Flechtwaren, Korbmacherwaren",3860000,16361000,20221000
2021,12,WA47,"Halbstoffe aus Holz usw., Papierabfall",116921000,419224000,536145000
2021,12,WA48,"Papier, Pappe und Waren daraus",1694302000,1117065000,2811367000
2021,12,WA49,"Bücher, Zeitungen, Bilddrucke usw.",355316000,324925000,680241000
2021,12,WA50,Seide,1004000,1729000,2733000
2021,12,WA51,"Wolle, feine und grobe Tierhaare",36414000,35277000,71691000
2021,12,WA52,Baumwolle,54974000,61985000,116959000
2021,12,WA53,"Andere pflanzliche Spinnstoffe, Papiergarn",4544000,7715000,12259000
2021,12,WA54,Synthetisches oder künstliches Filament,110727000,99362000,210089000
2021,12,WA55,Synthetische oder künstliche Spinnfaser,111654000,101355000,213009000
2021,12,WA56,"Watte, Filz, Vliesstoff usw., Tauwerk",175809000,131350000,307159000
2021,12,WA57,"Teppiche, Fußbodenbelag aus Spinnstoff",40949000,108584000,149533000
2021,12,WA58,"Spezialgewebe, Spitzen, Tapisserien",33367000,21753000,55120000
2021,12,WA59,"Getränkte, bestrichene usw. Gewebe",172099000,89883000,261982000
2021,12,WA60,Gewirke und Gestricke,50184000,36386000,86570000
2021,12,WA61,"Bekleidung usw. aus Gewirken, Gestricken",1001493000,1775299000,2776792000
2021,12,WA62,"Andere Bekleidung, Bekleidungszubehör",833924000,1318375000,2152299000
2021,12,WA63,"Andere Konfektion, Spinnstoffwaren usw.",271535000,453222000,724757000
2021,12,WA64,"Schuhe, Gamaschen, ähnliche Waren",585702000,912350000,1498052000
2021,12,WA65,Kopfbedeckungen und Teile davon,50813000,74670000,125483000
2021,12,WA66,"Schirme, Gehstöcke usw., Peitschen",5816000,31059000,36875000
2021,12,WA67,"Zugerichtete Federn, Daunen, künstliche Blumen",12262000,27936000,40198000
2021,12,WA68,"Waren aus Steinen, Gips, Zement usw.",354484000,281073000,635557000
2021,12,WA69,Keramische Waren,290331000,273469000,563800000
2021,12,WA70,Glas und Glaswaren,509156000,415909000,925065000
2021,12,WA71,"Perlen, Edelsteine, Edelmetalle",1434299000,2578333000,4012632000
2021,12,WA72,Eisen und Stahl,2212117000,2412506000,4624623000
2021,12,WA73,Waren aus Eisen oder Stahl,2474960000,2008601000,4483561000
2021,12,WA74,Kupfer und Waren daraus,1034070000,947749000,1981819000
2021,12,WA75,Nickel und Waren daraus,102835000,134950000,237785000
2021,12,WA76,Aluminium und Waren daraus,1256596000,1526923000,2783519000
2021,12,WA78,Blei und Waren daraus,29273000,52560000,81833000
2021,12,WA79,Zink und Waren daraus,66270000,125076000,191346000
2021,12,WA80,Zinn und Waren daraus,11720000,48722000,60442000
2021,12,WA81,"Andere unedle Metalle, Cermets usw.",100681000,149166000,249847000
2021,12,WA82,"Werkzeuge, Schneidwaren, Essbestecke",645194000,479854000,1125048000
2021,12,WA83,Verschiedene Waren aus unedlen Metallen,537017000,424069000,961086000
2021,12,WA84,"Maschinen, Apparate, mechanische Geräte",19554028000,13319304000,32873332000
2021,12,WA85,Elektrotechnische Erzeugnisse,12426951000,14331714000,26758665000
2021,12,WA86,Schienenfahrzeuge,268980000,262978000,531958000
2021,12,WA87,"Kraftfahrzeuge, Landfahrzeuge",16681330000,9759061000,26440391000
2021,12,WA88,"Luftfahrzeuge, Raumfahrzeuge",3351726000,893267000,4244993000
2021,12,WA89,Wasserfahrzeuge,102358000,228267000,330625000
2021,12,WA90,"Optische, photografische usw. Erzeugnisse",6327119000,3615570000,9942689000
2021,12,WA91,Uhrmacherwaren,167345000,251185000,418530000
2021,12,WA92,Musikinstrumente,64847000,76096000,140943000
2021,12,WA93,Waffen und Munition,45173000,23517000,68690000
2021,12,WA94,"Möbel, Beleuchtungskörper usw.",1337852000,1894172000,3232024000
2021,12,WA95,"Spielzeug, Spiele usw., Sportgeräte",571686000,1024014000,1595700000
2021,12,WA96,Verschiedene Waren,342498000,296233000,638731000
2021,12,WA97,"Kunstgegenstände, Sammlungsstücke",61708000,75169000,136877000
2021,12,WA98,Vollständige Fabrikationsanlagen,38529000,645000,39174000
2021,12,WA99,Zusammenstellungen verschiedener Waren,1300007000,1045592000,2345599000
2022,1,WA01,Lebende Tiere,98487000,90405000,188892000
2022,1,WA02,Fleisch,492553000,488083000,980636000
2022,1,WA03,"Fische, Krebs- und Weichtiere",103871000,337910000,441781000
2022,1,WA04,"Milch, Milcherzeugnisse, Eier, Honig",911031000,709201000,1620232000
2022,1,WA05,Andere Waren tierischen Ursprungs,77240000,88430000,165670000
2022,1,WA06,"Pflanzen, Waren des Blumenhandels",58935000,252531000,311466000
2022,1,WA07,"Gemüse, Pflanzen für Ernährung",96929000,671386000,768315000
2022,1,WA08,Genießbare Früchte und Nüsse,159404000,879076000,1038480000
2022,1,WA09,"Kaffee, Tee, Mate, Gewürze",305997000,490603000,796600000
2022,1,WA10,Getreide,243169000,256505000,499674000
2022,1,WA11,"Müllereierzeugnisse, Malz usw.",165125000,66638000,231763000
2022,1,WA12,"Ölsamen usw., Heilpflanzen usw.",165551000,682818000,848369000
2022,1,WA13,"Schellack, Gummen, Harz, Pflanzensaft",62464000,64950000,127414000
2022,1,WA14,Flechtstoffe usw. pflanzlichen Ursprungs,1047000,4416000,5463000
2022,1,WA15,"Tierische und pflanzliche Fette, Öle, Wachs",344199000,470321000,814520000
2022,1,WA16,"Zubereitungen von Fleisch, Fisch usw.",250239000,249568000,499807000
2022,1,WA17,Zucker und Zuckerwaren,240227000,137185000,377412000
2022,1,WA18,Kakao und Zubereitungen aus Kakao,473963000,377602000,851565000
2022,1,WA19,"Zubereitungen aus Getreide usw., Backwaren",559616000,382175000,941791000
2022,1,WA20,"Zubereitungen von Gemüse, Früchten usw.",232707000,410270000,642977000
2022,1,WA21,Verschiedene Lebensmittelzubereitungen,554401000,334423000,888824000
2022,1,WA22,"Getränke, alkoholhaltige Flüssigkeiten, Essig",488715000,616428000,1105143000
2022,1,WA23,"Rückstände der Lebensmittelindustrie, Futter",512693000,410157000,922850000
2022,1,WA24,Tabak,227955000,194418000,422373000
2022,1,WA25,"Salz, Schwefel, Steine, Erden usw.",173513000,144418000,317931000
2022,1,WA26,"Erze, Schlacken, Aschen",78848000,1176328000,1255176000
2022,1,WA27,Mineralische Brennstoffe usw.,3923723000,13954979000,17878702000
2022,1,WA28,Anorganische chemische Erzeugnisse,1363453000,632916000,1996369000
2022,1,WA29,Organische chemische Erzeugnisse,2885010000,2955719000,5840729000
2022,1,WA30,Pharmazeutische Erzeugnisse,8024964000,5940714000,13965678000
2022,1,WA31,Düngemittel,373849000,176719000,550568000
2022,1,WA32,"Gerb- und Farbstoffe, Farben, Lacke usw.",1060757000,528941000,1589698000
2022,1,WA33,"Etherische Öle, Riech-, Schönheitsmittel",870878000,576754000,1447632000
2022,1,WA34,"Seifen, Waschmittel usw.",741252000,397746000,1138998000
2022,1,WA35,"Eiweißstoffe, Klebstoffe, Enzyme",392921000,246305000,639226000
2022,1,WA36,"Sprengstoffe, pyrotechnische Artikel usw.",22532000,15219000,37751000
2022,1,WA37,Photochemische Erzeugnisse,95116000,50578000,145694000
2022,1,WA38,Verschiedene Erzeugnisse der Chemischen Industrie,3133466000,2223359000,5356825000
2022,1,WA39,Kunststoffe und Waren daraus,6529837000,4195850000,10725687000
2022,1,WA40,Kautschuk und Waren daraus,1255725000,1187135000,2442860000
2022,1,WA41,"Häute, Felle, Leder",56462000,42092000,98554000
2022,1,WA42,"Lederwaren, Sattlerwaren",210269000,382726000,592995000
2022,1,WA43,"Pelzfelle, künstliches Pelzwerk",6492000,7501000,13993000
2022,1,WA44,"Holz, Holzwaren, Holzkohle",960261000,897843000,1858104000
2022,1,WA45,"Kork, Korkwaren",2463000,9409000,11872000
2022,1,WA46,"Flechtwaren, Korbmacherwaren",5903000,24009000,29912000
2022,1,WA47,"Halbstoffe aus Holz usw., Papierabfall",134489000,370877000,505366000
2022,1,WA48,"Papier, Pappe und Waren daraus",1899538000,1112736000,3012274000
2022,1,WA49,"Bücher, Zeitungen, Bilddrucke usw.",291440000,235327000,526767000
2022,1,WA50,Seide,2050000,3407000,5457000
2022,1,WA51,"Wolle, feine und grobe Tierhaare",44019000,48259000,92278000
2022,1,WA52,Baumwolle,61817000,70074000,131891000
2022,1,WA53,"Andere pflanzliche Spinnstoffe, Papiergarn",4694000,7668000,12362000
2022,1,WA54,Synthetisches oder künstliches Filament,141885000,126615000,268500000
2022,1,WA55,Synthetische oder künstliche Spinnfaser,132508000,123839000,256347000
2022,1,WA56,"Watte, Filz, Vliesstoff usw., Tauwerk",219353000,141079000,360432000
2022,1,WA57,"Teppiche, Fußbodenbelag aus Spinnstoff",48930000,100565000,149495000
2022,1,WA58,"Spezialgewebe, Spitzen, Tapisserien",45642000,23949000,69591000
2022,1,WA59,"Getränkte, bestrichene usw. Gewebe",203156000,97771000,300927000
2022,1,WA60,Gewirke und Gestricke,58948000,39604000,98552000
2022,1,WA61,"Bekleidung usw. aus Gewirken, Gestricken",1009042000,1886226000,2895268000
2022,1,WA62,"Andere Bekleidung, Bekleidungszubehör",866197000,1449726000,2315923000
2022,1,WA63,"Andere Konfektion, Spinnstoffwaren usw.",283736000,494537000,778273000
2022,1,WA64,"Schuhe, Gamaschen, ähnliche Waren",663297000,978402000,1641699000
2022,1,WA65,Kopfbedeckungen und Teile davon,50766000,73942000,124708000
2022,1,WA66,"Schirme, Gehstöcke usw., Peitschen",5926000,39841000,45767000
2022,1,WA67,"Zugerichtete Federn, Daunen, künstliche Blumen",14757000,31258000,46015000
2022,1,WA68,"Waren aus Steinen, Gips, Zement usw.",416524000,297321000,713845000
2022,1,WA69,Keramische Waren,307689000,276252000,583941000
2022,1,WA70,Glas und Glaswaren,602782000,433422000,1036204000
2022,1,WA71,"Perlen, Edelsteine, Edelmetalle",1839754000,2806571000,4646325000
2022,1,WA72,Eisen und Stahl,2965154000,3083230000,6048384000
2022,1,WA73,Waren aus Eisen oder Stahl,2578842000,2273481000,4852323000
2022,1,WA74,Kupfer und Waren daraus,1224436000,1135342000,2359778000
2022,1,WA75,Nickel und Waren daraus,147397000,191765000,339162000
2022,1,WA76,Aluminium und Waren daraus,1503008000,1856851000,3359859000
2022,1,WA78,Blei und Waren daraus,35217000,50992000,86209000
2022,1,WA79,Zink und Waren daraus,74475000,128380000,202855000
2022,1,WA80,Zinn und Waren daraus,15660000,66288000,81948000
2022,1,WA81,"Andere unedle Metalle, Cermets usw.",126669000,185755000,312424000
2022,1,WA82,"Werkzeuge, Schneidwaren, Essbestecke",738467000,515287000,1253754000
2022,1,WA83,Verschiedene Waren aus unedlen Metallen,694132000,489969000,1184101000
2022,1,WA84,"Maschinen, Apparate, mechanische Geräte",17647232000,13285390000,30932622000
2022,1,WA85,Elektrotechnische Erzeugnisse,12628389000,13879044000,26507433000
2022,1,WA86,Schienenfahrzeuge,294352000,218385000,512737000
2022,1,WA87,"Kraftfahrzeuge, Landfahrzeuge",17305309000,9157856000,26463165000
2022,1,WA88,"Luftfahrzeuge, Raumfahrzeuge",1118724000,738212000,1856936000
2022,1,WA89,Wasserfahrzeuge,229700000,172550000,402250000
2022,1,WA90,"Optische, photografische usw. Erzeugnisse",5352593000,3403246000,8755839000
2022,1,WA91,Uhrmacherwaren,129374000,193386000,322760000
2022,1,WA92,Musikinstrumente,75487000,74193000,149680000
2022,1,WA93,Waffen und Munition,42481000,19677000,62158000
2022,1,WA94,"Möbel, Beleuchtungskörper usw.",1369500000,1971955000,3341455000
2022,1,WA95,"Spielzeug, Spiele usw., Sportgeräte",410229000,701201000,1111430000
2022,1,WA96,Verschiedene Waren,326545000,313347000,639892000
2022,1,WA97,"Kunstgegenstände, Sammlungsstücke",130288000,36228000,166516000
2022,1,WA98,Vollständige Fabrikationsanlagen,58762000,0,58762000
2022,1,WA99,Zusammenstellungen verschiedener Waren,972681000,869520000,1842201000
2022,2,WA01,Lebende Tiere,90637000,83450000,174087000
2022,2,WA02,Fleisch,528208000,486623000,1014831000
2022,2,WA03,"Fische, Krebs- und Weichtiere",110836000,316985000,427821000
2022,2,WA04,"Milch, Milcherzeugnisse, Eier, Honig",893898000,766902000,1660800000
2022,2,WA05,Andere Waren tierischen Ursprungs,77087000,90715000,167802000
2022,2,WA06,"Pflanzen, Waren des Blumenhandels",85422000,332263000,417685000
2022,2,WA07,"Gemüse, Pflanzen für Ernährung",99597000,677075000,776672000
2022,2,WA08,Genießbare Früchte und Nüsse,157098000,848188000,1005286000
2022,2,WA09,"Kaffee, Tee, Mate, Gewürze",294521000,453355000,747876000
2022,2,WA10,Getreide,241309000,315747000,557056000
2022,2,WA11,"Müllereierzeugnisse, Malz usw.",171047000,66061000,237108000
2022,2,WA12,"Ölsamen usw., Heilpflanzen usw.",221431000,701499000,922930000
2022,2,WA13,"Schellack, Gummen, Harz, Pflanzensaft",61042000,61829000,122871000
2022,2,WA14,Flechtstoffe usw. pflanzlichen Ursprungs,1297000,4777000,6074000
2022,2,WA15,"Tierische und pflanzliche Fette, Öle, Wachs",346315000,405499000,751814000
2022,2,WA16,"Zubereitungen von Fleisch, Fisch usw.",243813000,262977000,506790000
2022,2,WA17,Zucker und Zuckerwaren,240756000,144638000,385394000
2022,2,WA18,Kakao und Zubereitungen aus Kakao,505464000,366265000,871729000
2022,2,WA19,"Zubereitungen aus Getreide usw., Backwaren",584542000,394276000,978818000
2022,2,WA20,"Zubereitungen von Gemüse, Früchten usw.",236976000,416870000,653846000
2022,2,WA21,Verschiedene Lebensmittelzubereitungen,559840000,350588000,910428000
2022,2,WA22,"Getränke, alkoholhaltige Flüssigkeiten, Essig",486348000,635537000,1121885000
2022,2,WA23,"Rückstände der Lebensmittelindustrie, Futter",511662000,437050000,948712000
2022,2,WA24,Tabak,206303000,196738000,403041000
2022,2,WA25,"Salz, Schwefel, Steine, Erden usw.",189533000,170730000,360263000
2022,2,WA26,"Erze, Schlacken, Aschen",60512000,873303000,933815000
2022,2,WA27,Mineralische Brennstoffe usw.,4022757000,12263352000,16286109000
2022,2,WA28,Anorganische chemische Erzeugnisse,1268193000,709041000,1977234000
2022,2,WA29,Organische chemische Erzeugnisse,2805938000,5455502000,8261440000
2022,2,WA30,Pharmazeutische Erzeugnisse,8879113000,5508219000,14387332000
2022,2,WA31,Düngemittel,385257000,158084000,543341000
2022,2,WA32,"Gerb- und Farbstoffe, Farben, Lacke usw.",1094073000,540873000,1634946000
2022,2,WA33,"Etherische Öle, Riech-, Schönheitsmittel",845220000,545790000,1391010000
2022,2,WA34,"Seifen, Waschmittel usw.",742885000,386480000,1129365000
2022,2,WA35,"Eiweißstoffe, Klebstoffe, Enzyme",388860000,241177000,630037000
2022,2,WA36,"Sprengstoffe, pyrotechnische Artikel usw.",20780000,14727000,35507000
2022,2,WA37,Photochemische Erzeugnisse,91885000,51991000,143876000
2022,2,WA38,Verschiedene Erzeugnisse der Chemischen Industrie,2843961000,1979575000,4823536000
2022,2,WA39,Kunststoffe und Waren daraus,6644099000,4337337000,10981436000
2022,2,WA40,Kautschuk und Waren daraus,1292908000,1273079000,2565987000
2022,2,WA41,"Häute, Felle, Leder",61347000,49170000,110517000
2022,2,WA42,"Lederwaren, Sattlerwaren",211440000,345853000,557293000
2022,2,WA43,"Pelzfelle, künstliches Pelzwerk",3922000,7437000,11359000
2022,2,WA44,"Holz, Holzwaren, Holzkohle",1049619000,937488000,1987107000
2022,2,WA45,"Kork, Korkwaren",3069000,9364000,12433000
2022,2,WA46,"Flechtwaren, Korbmacherwaren",6756000,18772000,25528000
2022,2,WA47,"Halbstoffe aus Holz usw., Papierabfall",129998000,354844000,484842000
2022,2,WA48,"Papier, Pappe und Waren daraus",1884145000,1116117000,3000262000
2022,2,WA49,"Bücher, Zeitungen, Bilddrucke usw.",297606000,241340000,538946000
2022,2,WA50,Seide,1960000,2274000,4234000
2022,2,WA51,"Wolle, feine und grobe Tierhaare",43203000,43820000,87023000
2022,2,WA52,Baumwolle,59945000,65777000,125722000
2022,2,WA53,"Andere pflanzliche Spinnstoffe, Papiergarn",4494000,7678000,12172000
2022,2,WA54,Synthetisches oder künstliches Filament,148149000,131599000,279748000
2022,2,WA55,Synthetische oder künstliche Spinnfaser,130460000,122659000,253119000
2022,2,WA56,"Watte, Filz, Vliesstoff usw., Tauwerk",228007000,156677000,384684000
2022,2,WA57,"Teppiche, Fußbodenbelag aus Spinnstoff",46950000,103284000,150234000
2022,2,WA58,"Spezialgewebe, Spitzen, Tapisserien",46147000,22378000,68525000
2022,2,WA59,"Getränkte, bestrichene usw. Gewebe",209742000,99336000,309078000
2022,2,WA60,Gewirke und Gestricke,62653000,40678000,103331000
2022,2,WA61,"Bekleidung usw. aus Gewirken, Gestricken",988032000,1671338000,2659370000
2022,2,WA62,"Andere Bekleidung, Bekleidungszubehör",916133000,1431703000,2347836000
2022,2,WA63,"Andere Konfektion, Spinnstoffwaren usw.",276004000,447856000,723860000
2022,2,WA64,"Schuhe, Gamaschen, ähnliche Waren",723884000,1032659000,1756543000
2022,2,WA65,Kopfbedeckungen und Teile davon,55042000,71176000,126218000
2022,2,WA66,"Schirme, Gehstöcke usw., Peitschen",9747000,32152000,41899000
2022,2,WA67,"Zugerichtete Federn, Daunen, künstliche Blumen",14838000,21801000,36639000
2022,2,WA68,"Waren aus Steinen, Gips, Zement usw.",436151000,302870000,739021000
2022,2,WA69,Keramische Waren,338439000,270551000,608990000
2022,2,WA70,Glas und Glaswaren,609361000,446048000,1055409000
2022,2,WA71,"Perlen, Edelsteine, Edelmetalle",1720498000,2776256000,4496754000
2022,2,WA72,Eisen und Stahl,2984734000,3107801000,6092535000
2022,2,WA73,Waren aus Eisen oder Stahl,2690018000,2317772000,5007790000
2022,2,WA74,Kupfer und Waren daraus,1348357000,1264337000,2612694000
2022,2,WA75,Nickel und Waren daraus,136234000,188730000,324964000
2022,2,WA76,Aluminium und Waren daraus,1695985000,2032778000,3728763000
2022,2,WA78,Blei und Waren daraus,34659000,50170000,84829000
2022,2,WA79,Zink und Waren daraus,80180000,149867000,230047000
2022,2,WA80,Zinn und Waren daraus,15029000,66034000,81063000
2022,2,WA81,"Andere unedle Metalle, Cermets usw.",139901000,185592000,325493000
2022,2,WA82,"Werkzeuge, Schneidwaren, Essbestecke",792259000,492015000,1284274000
2022,2,WA83,Verschiedene Waren aus unedlen Metallen,713250000,490183000,1203433000
2022,2,WA84,"Maschinen, Apparate, mechanische Geräte",19249130000,12495743000,31744873000
2022,2,WA85,Elektrotechnische Erzeugnisse,12944087000,13742053000,26686140000
2022,2,WA86,Schienenfahrzeuge,272718000,239072000,511790000
2022,2,WA87,"Kraftfahrzeuge, Landfahrzeuge",19998811000,9926873000,29925684000
2022,2,WA88,"Luftfahrzeuge, Raumfahrzeuge",2138541000,664331000,2802872000
2022,2,WA89,Wasserfahrzeuge,227302000,243097000,470399000
2022,2,WA90,"Optische, photografische usw. Erzeugnisse",5834278000,3295533000,9129811000
2022,2,WA91,Uhrmacherwaren,132272000,196710000,328982000
2022,2,WA92,Musikinstrumente,72848000,61971000,134819000
2022,2,WA93,Waffen und Munition,54156000,22723000,76879000
2022,2,WA94,"Möbel, Beleuchtungskörper usw.",1457052000,1977217000,3434269000
2022,2,WA95,"Spielzeug, Spiele usw., Sportgeräte",373946000,657730000,1031676000
2022,2,WA96,Verschiedene Waren,324808000,272053000,596861000
2022,2,WA97,"Kunstgegenstände, Sammlungsstücke",61636000,60936000,122572000
2022,2,WA98,Vollständige Fabrikationsanlagen,22017000,0,22017000
2022,2,WA99,Zusammenstellungen verschiedener Waren,1074989000,859281000,1934270000
2022,3,WA01,Lebende Tiere,118181000,134970000,253151000
2022,3,WA02,Fleisch,620527000,682380000,1302907000
2022,3,WA03,"Fische, Krebs- und Weichtiere",134863000,383111000,517974000
2022,3,WA04,"Milch, Milcherzeugnisse, Eier, Honig",1060794000,955961000,2016755000
2022,3,WA05,Andere Waren tierischen Ursprungs,88871000,111399000,200270000
2022,3,WA06,"Pflanzen, Waren des Blumenhandels",131207000,411007000,542214000
2022,3,WA07,"Gemüse, Pflanzen für Ernährung",125220000,813049000,938269000
2022,3,WA08,Genießbare Früchte und Nüsse,182736000,946634000,1129370000
2022,3,WA09,"Kaffee, Tee, Mate, Gewürze",349428000,553420000,902848000
2022,3,WA10,Getreide,357769000,431122000,788891000
2022,3,WA11,"Müllereierzeugnisse, Malz usw.",187419000,80204000,267623000
2022,3,WA12,"Ölsamen usw., Heilpflanzen usw.",216305000,839481000,1055786000
2022,3,WA13,"Schellack, Gummen, Harz, Pflanzensaft",72030000,66742000,138772000
2022,3,WA14,Flechtstoffe usw. pflanzlichen Ursprungs,1165000,4564000,5729000
2022,3,WA15,"Tierische und pflanzliche Fette, Öle, Wachs",424902000,529726000,954628000
2022,3,WA16,"Zubereitungen von Fleisch, Fisch usw.",301165000,311886000,613051000
2022,3,WA17,Zucker und Zuckerwaren,269513000,170099000,439612000
2022,3,WA18,Kakao und Zubereitungen aus Kakao,507777000,428833000,936610000
2022,3,WA19,"Zubereitungen aus Getreide usw., Backwaren",685659000,491495000,1177154000
2022,3,WA20,"Zubereitungen von Gemüse, Früchten usw.",283726000,517745000,801471000
2022,3,WA21,Verschiedene Lebensmittelzubereitungen,683262000,426503000,1109765000
2022,3,WA22,"Getränke, alkoholhaltige Flüssigkeiten, Essig",593716000,798154000,1391870000
2022,3,WA23,"Rückstände der Lebensmittelindustrie, Futter",601266000,510888000,1112154000
2022,3,WA24,Tabak,233673000,258410000,492083000
2022,3,WA25,"Salz, Schwefel, Steine, Erden usw.",220602000,186035000,406637000
2022,3,WA26,"Erze, Schlacken, Aschen",95436000,1117609000,1213045000
2022,3,WA27,Mineralische Brennstoffe usw.,5540948000,16012422000,21553370000
2022,3,WA28,Anorganische chemische Erzeugnisse,1573815000,881930000,2455745000
2022,3,WA29,Organische chemische Erzeugnisse,3190779000,6490264000,9681043000
2022,3,WA30,Pharmazeutische Erzeugnisse,11069056000,6596543000,17665599000
2022,3,WA31,Düngemittel,429974000,226354000,656328000
2022,3,WA32,"Gerb- und Farbstoffe, Farben, Lacke usw.",1254406000,661120000,1915526000
2022,3,WA33,"Etherische Öle, Riech-, Schönheitsmittel",1033753000,685968000,1719721000
2022,3,WA34,"Seifen, Waschmittel usw.",839650000,477337000,1316987000
2022,3,WA35,"Eiweißstoffe, Klebstoffe, Enzyme",428808000,279295000,708103000
2022,3,WA36,"Sprengstoffe, pyrotechnische Artikel usw.",19728000,14700000,34428000
2022,3,WA37,Photochemische Erzeugnisse,94767000,60538000,155305000
2022,3,WA38,Verschiedene Erzeugnisse der Chemischen Industrie,3153268000,2144554000,5297822000
2022,3,WA39,Kunststoffe und Waren daraus,7481150000,5119874000,12601024000
2022,3,WA40,Kautschuk und Waren daraus,1514690000,1480451000,2995141000
2022,3,WA41,"Häute, Felle, Leder",68695000,55961000,124656000
2022,3,WA42,"Lederwaren, Sattlerwaren",239982000,406666000,646648000
2022,3,WA43,"Pelzfelle, künstliches Pelzwerk",9056000,10825000,19881000
2022,3,WA44,"Holz, Holzwaren, Holzkohle",1295530000,1144071000,2439601000
2022,3,WA45,"Kork, Korkwaren",2996000,10484000,13480000
2022,3,WA46,"Flechtwaren, Korbmacherwaren",7312000,20902000,28214000
2022,3,WA47,"Halbstoffe aus Holz usw., Papierabfall",132311000,432139000,564450000
2022,3,WA48,"Papier, Pappe und Waren daraus",2160315000,1330799000,3491114000
2022,3,WA49,"Bücher, Zeitungen, Bilddrucke usw.",333861000,261150000,595011000
2022,3,WA50,Seide,1780000,3022000,4802000
2022,3,WA51,"Wolle, feine und grobe Tierhaare",51587000,53711000,105298000
2022,3,WA52,Baumwolle,65795000,85350000,151145000
2022,3,WA53,"Andere pflanzliche Spinnstoffe, Papiergarn",4349000,7836000,12185000
2022,3,WA54,Synthetisches oder künstliches Filament,171984000,152194000,324178000
2022,3,WA55,Synthetische oder künstliche Spinnfaser,139382000,144399000,283781000
2022,3,WA56,"Watte, Filz, Vliesstoff usw., Tauwerk",264716000,172938000,437654000
2022,3,WA57,"Teppiche, Fußbodenbelag aus Spinnstoff",50562000,115172000,165734000
2022,3,WA58,"Spezialgewebe, Spitzen, Tapisserien",49653000,28043000,77696000
2022,3,WA59,"Getränkte, bestrichene usw. Gewebe",241480000,116717000,358197000
2022,3,WA60,Gewirke und Gestricke,72688000,53140000,125828000
2022,3,WA61,"Bekleidung usw. aus Gewirken, Gestricken",1049893000,1955052000,3004945000
2022,3,WA62,"Andere Bekleidung, Bekleidungszubehör",1057586000,1794022000,2851608000
2022,3,WA63,"Andere Konfektion, Spinnstoffwaren usw.",304569000,527095000,831664000
2022,3,WA64,"Schuhe, Gamaschen, ähnliche Waren",859302000,1264660000,2123962000
2022,3,WA65,Kopfbedeckungen und Teile davon,68328000,84400000,152728000
2022,3,WA66,"Schirme, Gehstöcke usw., Peitschen",12450000,47916000,60366000
2022,3,WA67,"Zugerichtete Federn, Daunen, künstliche Blumen",16576000,27301000,43877000
2022,3,WA68,"Waren aus Steinen, Gips, Zement usw.",526189000,368242000,894431000
2022,3,WA69,Keramische Waren,383747000,344142000,727889000
2022,3,WA70,Glas und Glaswaren,710871000,511694000,1222565000
2022,3,WA71,"Perlen, Edelsteine, Edelmetalle",2219867000,4645972000,6865839000
2022,3,WA72,Eisen und Stahl,3717148000,3751422000,7468570000
2022,3,WA73,Waren aus Eisen oder Stahl,3147599000,2780005000,5927604000
2022,3,WA74,Kupfer und Waren daraus,1542693000,1693657000,3236350000
2022,3,WA75,Nickel und Waren daraus,169679000,316230000,485909000
2022,3,WA76,Aluminium und Waren daraus,1906974000,2560308000,4467282000
2022,3,WA78,Blei und Waren daraus,30817000,87114000,117931000
2022,3,WA79,Zink und Waren daraus,98624000,189631000,288255000
2022,3,WA80,Zinn und Waren daraus,19012000,83993000,103005000
2022,3,WA81,"Andere unedle Metalle, Cermets usw.",176239000,260375000,436614000
2022,3,WA82,"Werkzeuge, Schneidwaren, Essbestecke",856682000,589591000,1446273000
2022,3,WA83,Verschiedene Waren aus unedlen Metallen,798532000,560251000,1358783000
2022,3,WA84,"Maschinen, Apparate, mechanische Geräte",21923934000,14875310000,36799244000
2022,3,WA85,Elektrotechnische Erzeugnisse,14788180000,15478525000,30266705000
2022,3,WA86,Schienenfahrzeuge,294047000,311547000,605594000
2022,3,WA87,"Kraftfahrzeuge, Landfahrzeuge",19913305000,11237252000,31150557000
2022,3,WA88,"Luftfahrzeuge, Raumfahrzeuge",2138706000,821523000,2960229000
2022,3,WA89,Wasserfahrzeuge,1530294000,167054000,1697348000
2022,3,WA90,"Optische, photografische usw. Erzeugnisse",6881784000,4044016000,10925800000
2022,3,WA91,Uhrmacherwaren,156718000,216038000,372756000
2022,3,WA92,Musikinstrumente,84721000,75184000,159905000
2022,3,WA93,Waffen und Munition,67982000,27535000,95517000
2022,3,WA94,"Möbel, Beleuchtungskörper usw.",1662603000,2228292000,3890895000
2022,3,WA95,"Spielzeug, Spiele usw., Sportgeräte",472250000,774080000,1246330000
2022,3,WA96,Verschiedene Waren,396927000,333044000,729971000
2022,3,WA97,"Kunstgegenstände, Sammlungsstücke",79607000,52245000,131852000
2022,3,WA98,Vollständige Fabrikationsanlagen,36024000,0,36024000
2022,3,WA99,Zusammenstellungen verschiedener Waren,1358758000,930649000,2289407000
2022,4,WA01,Lebende Tiere,91984000,118423000,210407000
2022,4,WA02,Fleisch,586831000,685554000,1272385000
2022,4,WA03,"Fische, Krebs- und Weichtiere",122131000,333242000,455373000
2022,4,WA04,"Milch, Milcherzeugnisse, Eier, Honig",973867000,899515000,1873382000
2022,4,WA05,Andere Waren tierischen Ursprungs,82466000,90500000,172966000
2022,4,WA06,"Pflanzen, Waren des Blumenhandels",137875000,423832000,561707000
2022,4,WA07,"Gemüse, Pflanzen für Ernährung",116023000,770742000,886765000
2022,4,WA08,Genießbare Früchte und Nüsse,168858000,940269000,1109127000
2022,4,WA09,"Kaffee, Tee, Mate, Gewürze",309397000,514090000,823487000
2022,4,WA10,Getreide,281114000,365230000,646344000
2022,4,WA11,"Müllereierzeugnisse, Malz usw.",169255000,76223000,245478000
2022,4,WA12,"Ölsamen usw., Heilpflanzen usw.",114848000,777962000,892810000
2022,4,WA13,"Schellack, Gummen, Harz, Pflanzensaft",57433000,67429000,124862000
2022,4,WA14,Flechtstoffe usw. pflanzlichen Ursprungs,1677000,4389000,6066000
2022,4,WA15,"Tierische und pflanzliche Fette, Öle, Wachs",404359000,489873000,894232000
2022,4,WA16,"Zubereitungen von Fleisch, Fisch usw.",267749000,291046000,558795000
2022,4,WA17,Zucker und Zuckerwaren,242361000,148861000,391222000
2022,4,WA18,Kakao und Zubereitungen aus Kakao,400118000,337692000,737810000
2022,4,WA19,"Zubereitungen aus Getreide usw., Backwaren",592402000,431548000,1023950000
2022,4,WA20,"Zubereitungen von Gemüse, Früchten usw.",261333000,437289000,698622000
2022,4,WA21,Verschiedene Lebensmittelzubereitungen,622207000,390526000,1012733000
2022,4,WA22,"Getränke, alkoholhaltige Flüssigkeiten, Essig",521586000,735283000,1256869000
2022,4,WA23,"Rückstände der Lebensmittelindustrie, Futter",527979000,444295000,972274000
2022,4,WA24,Tabak,206701000,230368000,437069000
2022,4,WA25,"Salz, Schwefel, Steine, Erden usw.",205953000,202770000,408723000
2022,4,WA26,"Erze, Schlacken, Aschen",68307000,1079420000,1147727000
2022,4,WA27,Mineralische Brennstoffe usw.,4382830000,16023108000,20405938000
2022,4,WA28,Anorganische chemische Erzeugnisse,1310389000,898264000,2208653000
2022,4,WA29,Organische chemische Erzeugnisse,2847638000,8259350000,11106988000
2022,4,WA30,Pharmazeutische Erzeugnisse,10268530000,5280039000,15548569000
2022,4,WA31,Düngemittel,414060000,192583000,606643000
2022,4,WA32,"Gerb- und Farbstoffe, Farben, Lacke usw.",1029990000,544677000,1574667000
2022,4,WA33,"Etherische Öle, Riech-, Schönheitsmittel",875421000,592626000,1468047000
2022,4,WA34,"Seifen, Waschmittel usw.",732606000,414165000,1146771000
2022,4,WA35,"Eiweißstoffe, Klebstoffe, Enzyme",386252000,254601000,640853000
2022,4,WA36,"Sprengstoffe, pyrotechnische Artikel usw.",28356000,12685000,41041000
2022,4,WA37,Photochemische Erzeugnisse,89198000,57459000,146657000
2022,4,WA38,Verschiedene Erzeugnisse der Chemischen Industrie,2533384000,1905814000,4439198000
2022,4,WA39,Kunststoffe und Waren daraus,6496528000,4570651000,11067179000
2022,4,WA40,Kautschuk und Waren daraus,1330129000,1339933000,2670062000
2022,4,WA41,"Häute, Felle, Leder",60767000,45872000,106639000
2022,4,WA42,"Lederwaren, Sattlerwaren",213947000,358979000,572926000
2022,4,WA43,"Pelzfelle, künstliches Pelzwerk",2581000,5991000,8572000
2022,4,WA44,"Holz, Holzwaren, Holzkohle",1099435000,1016184000,2115619000
2022,4,WA45,"Kork, Korkwaren",2415000,8522000,10937000
2022,4,WA46,"Flechtwaren, Korbmacherwaren",6846000,21642000,28488000
2022,4,WA47,"Halbstoffe aus Holz usw., Papierabfall",120509000,390051000,510560000
2022,4,WA48,"Papier, Pappe und Waren daraus",1958853000,1206046000,3164899000
2022,4,WA49,"Bücher, Zeitungen, Bilddrucke usw.",287060000,239038000,526098000
2022,4,WA50,Seide,1519000,1559000,3078000
2022,4,WA51,"Wolle, feine und grobe Tierhaare",42023000,46619000,88642000
2022,4,WA52,Baumwolle,57346000,73322000,130668000
2022,4,WA53,"Andere pflanzliche Spinnstoffe, Papiergarn",3445000,8248000,11693000
2022,4,WA54,Synthetisches oder künstliches Filament,144145000,136833000,280978000
2022,4,WA55,Synthetische oder künstliche Spinnfaser,131678000,138392000,270070000
2022,4,WA56,"Watte, Filz, Vliesstoff usw., Tauwerk",227061000,155573000,382634000
2022,4,WA57,"Teppiche, Fußbodenbelag aus Spinnstoff",44849000,97936000,142785000
2022,4,WA58,"Spezialgewebe, Spitzen, Tapisserien",42962000,23501000,66463000
2022,4,WA59,"Getränkte, bestrichene usw. Gewebe",212167000,99676000,311843000
2022,4,WA60,Gewirke und Gestricke,63039000,41309000,104348000
2022,4,WA61,"Bekleidung usw. aus Gewirken, Gestricken",930852000,1716488000,2647340000
2022,4,WA62,"Andere Bekleidung, Bekleidungszubehör",977810000,1583133000,2560943000
2022,4,WA63,"Andere Konfektion, Spinnstoffwaren usw.",263847000,439638000,703485000
2022,4,WA64,"Schuhe, Gamaschen, ähnliche Waren",730106000,1021585000,1751691000
2022,4,WA65,Kopfbedeckungen und Teile davon,56550000,77074000,133624000
2022,4,WA66,"Schirme, Gehstöcke usw., Peitschen",12144000,42971000,55115000
2022,4,WA67,"Zugerichtete Federn, Daunen, künstliche Blumen",13713000,20504000,34217000
2022,4,WA68,"Waren aus Steinen, Gips, Zement usw.",445365000,317782000,763147000
2022,4,WA69,Keramische Waren,331938000,300451000,632389000
2022,4,WA70,Glas und Glaswaren,616588000,442536000,1059124000
2022,4,WA71,"Perlen, Edelsteine, Edelmetalle",1848579000,3233930000,5082509000
2022,4,WA72,Eisen und Stahl,3312902000,3328228000,6641130000
2022,4,WA73,Waren aus Eisen oder Stahl,2613569000,2430259000,5043828000
2022,4,WA74,Kupfer und Waren daraus,1364255000,1325578000,2689833000
2022,4,WA75,Nickel und Waren daraus,149276000,212510000,361786000
2022,4,WA76,Aluminium und Waren daraus,1703243000,2103427000,3806670000
2022,4,WA78,Blei und Waren daraus,27323000,53476000,80799000
2022,4,WA79,Zink und Waren daraus,88158000,166855000,255013000
2022,4,WA80,Zinn und Waren daraus,16752000,76866000,93618000
2022,4,WA81,"Andere unedle Metalle, Cermets usw.",142109000,209591000,351700000
2022,4,WA82,"Werkzeuge, Schneidwaren, Essbestecke",756389000,507246000,1263635000
2022,4,WA83,Verschiedene Waren aus unedlen Metallen,673330000,466008000,1139338000
2022,4,WA84,"Maschinen, Apparate, mechanische Geräte",18571841000,13036449000,31608290000
2022,4,WA85,Elektrotechnische Erzeugnisse,12714889000,13903541000,26618430000
2022,4,WA86,Schienenfahrzeuge,249165000,221689000,470854000
2022,4,WA87,"Kraftfahrzeuge, Landfahrzeuge",17996999000,9863070000,27860069000
2022,4,WA88,"Luftfahrzeuge, Raumfahrzeuge",2082865000,820897000,2903762000
2022,4,WA89,Wasserfahrzeuge,192987000,196944000,389931000
2022,4,WA90,"Optische, photografische usw. Erzeugnisse",5586944000,3423313000,9010257000
2022,4,WA91,Uhrmacherwaren,134729000,214980000,349709000
2022,4,WA92,Musikinstrumente,73204000,60841000,134045000
2022,4,WA93,Waffen und Munition,55145000,25889000,81034000
2022,4,WA94,"Möbel, Beleuchtungskörper usw.",1357704000,1895913000,3253617000
2022,4,WA95,"Spielzeug, Spiele usw., Sportgeräte",391020000,700174000,1091194000
2022,4,WA96,Verschiedene Waren,337792000,284053000,621845000
2022,4,WA97,"Kunstgegenstände, Sammlungsstücke",93721000,41870000,135591000
2022,4,WA98,Vollständige Fabrikationsanlagen,47102000,0,47102000
2022,4,WA99,Zusammenstellungen verschiedener Waren,1281296000,839802000,2121098000
2022,5,WA01,Lebende Tiere,106965000,119411000,226376000
2022,5,WA02,Fleisch,632109000,670855000,1302964000
2022,5,WA03,"Fische, Krebs- und Weichtiere",132343000,356857000,489200000
2022,5,WA04,"Milch, Milcherzeugnisse, Eier, Honig",1051751000,935963000,1987714000
2022,5,WA05,Andere Waren tierischen Ursprungs,88849000,103057000,191906000
2022,5,WA06,"Pflanzen, Waren des Blumenhandels",122343000,387441000,509784000
2022,5,WA07,"Gemüse, Pflanzen für Ernährung",106797000,619925000,726722000
2022,5,WA08,Genießbare Früchte und Nüsse,169739000,1037010000,1206749000
2022,5,WA09,"Kaffee, Tee, Mate, Gewürze",326072000,602452000,928524000
2022,5,WA10,Getreide,272694000,403335000,676029000
2022,5,WA11,"Müllereierzeugnisse, Malz usw.",180406000,85213000,265619000
2022,5,WA12,"Ölsamen usw., Heilpflanzen usw.",112875000,913238000,1026113000
2022,5,WA13,"Schellack, Gummen, Harz, Pflanzensaft",65397000,71428000,136825000
2022,5,WA14,Flechtstoffe usw. pflanzlichen Ursprungs,1129000,4963000,6092000
2022,5,WA15,"Tierische und pflanzliche Fette, Öle, Wachs",430697000,629550000,1060247000
2022,5,WA16,"Zubereitungen von Fleisch, Fisch usw.",294748000,300879000,595627000
2022,5,WA17,Zucker und Zuckerwaren,268614000,167593000,436207000
2022,5,WA18,Kakao und Zubereitungen aus Kakao,442429000,376426000,818855000
2022,5,WA19,"Zubereitungen aus Getreide usw., Backwaren",651108000,474882000,1125990000
2022,5,WA20,"Zubereitungen von Gemüse, Früchten usw.",269258000,493388000,762646000
2022,5,WA21,Verschiedene Lebensmittelzubereitungen,683210000,428722000,1111932000
2022,5,WA22,"Getränke, alkoholhaltige Flüssigkeiten, Essig",622790000,853193000,1475983000
2022,5,WA23,"Rückstände der Lebensmittelindustrie, Futter",538612000,512020000,1050632000
2022,5,WA24,Tabak,240442000,281217000,521659000
2022,5,WA25,"Salz, Schwefel, Steine, Erden usw.",211701000,213849000,425550000
2022,5,WA26,"Erze, Schlacken, Aschen",102224000,899848000,1002072000
2022,5,WA27,Mineralische Brennstoffe usw.,4581403000,15394589000,19975992000
2022,5,WA28,Anorganische chemische Erzeugnisse,1358304000,968011000,2326315000
2022,5,WA29,Organische chemische Erzeugnisse,4017294000,10209291000,14226585000
2022,5,WA30,Pharmazeutische Erzeugnisse,11440382000,5899040000,17339422000
2022,5,WA31,Düngemittel,453942000,184566000,638508000
2022,5,WA32,"Gerb- und Farbstoffe, Farben, Lacke usw.",1139924000,622002000,1761926000
2022,5,WA33,"Etherische Öle, Riech-, Schönheitsmittel",959169000,677516000,1636685000
2022,5,WA34,"Seifen, Waschmittel usw.",815767000,472271000,1288038000
2022,5,WA35,"Eiweißstoffe, Klebstoffe, Enzyme",422548000,258022000,680570000
2022,5,WA36,"Sprengstoffe, pyrotechnische Artikel usw.",24366000,14432000,38798000
2022,5,WA37,Photochemische Erzeugnisse,103016000,66142000,169158000
2022,5,WA38,Verschiedene Erzeugnisse der Chemischen Industrie,2789323000,1951469000,4740792000
2022,5,WA39,Kunststoffe und Waren daraus,7156270000,5109148000,12265418000
2022,5,WA40,Kautschuk und Waren daraus,1465035000,1504819000,2969854000
2022,5,WA41,"Häute, Felle, Leder",62024000,50509000,112533000
2022,5,WA42,"Lederwaren, Sattlerwaren",235362000,408113000,643475000
2022,5,WA43,"Pelzfelle, künstliches Pelzwerk",2745000,5692000,8437000
2022,5,WA44,"Holz, Holzwaren, Holzkohle",1246262000,1133729000,2379991000
2022,5,WA45,"Kork, Korkwaren",2760000,10667000,13427000
2022,5,WA46,"Flechtwaren, Korbmacherwaren",7463000,21471000,28934000
2022,5,WA47,"Halbstoffe aus Holz usw., Papierabfall",132941000,462467000,595408000
2022,5,WA48,"Papier, Pappe und Waren daraus",2150281000,1343585000,3493866000
2022,5,WA49,"Bücher, Zeitungen, Bilddrucke usw.",304892000,254934000,559826000
2022,5,WA50,Seide,1677000,3245000,4922000
2022,5,WA51,"Wolle, feine und grobe Tierhaare",48487000,60728000,109215000
2022,5,WA52,Baumwolle,61034000,87417000,148451000
2022,5,WA53,"Andere pflanzliche Spinnstoffe, Papiergarn",3173000,8740000,11913000
2022,5,WA54,Synthetisches oder künstliches Filament,154326000,145333000,299659000
2022,5,WA55,Synthetische oder künstliche Spinnfaser,142625000,148091000,290716000
2022,5,WA56,"Watte, Filz, Vliesstoff usw., Tauwerk",246562000,172232000,418794000
2022,5,WA57,"Teppiche, Fußbodenbelag aus Spinnstoff",44899000,96387000,141286000
2022,5,WA58,"Spezialgewebe, Spitzen, Tapisserien",47399000,24383000,71782000
2022,5,WA59,"Getränkte, bestrichene usw. Gewebe",226570000,111600000,338170000
2022,5,WA60,Gewirke und Gestricke,67860000,47194000,115054000
2022,5,WA61,"Bekleidung usw. aus Gewirken, Gestricken",1041408000,1859389000,2900797000
2022,5,WA62,"Andere Bekleidung, Bekleidungszubehör",1005168000,1602970000,2608138000
2022,5,WA63,"Andere Konfektion, Spinnstoffwaren usw.",276226000,484841000,761067000
2022,5,WA64,"Schuhe, Gamaschen, ähnliche Waren",779319000,1139244000,1918563000
2022,5,WA65,Kopfbedeckungen und Teile davon,62257000,85623000,147880000
2022,5,WA66,"Schirme, Gehstöcke usw., Peitschen",12369000,43333000,55702000
2022,5,WA67,"Zugerichtete Federn, Daunen, künstliche Blumen",14439000,24744000,39183000
2022,5,WA68,"Waren aus Steinen, Gips, Zement usw.",495870000,364118000,859988000
2022,5,WA69,Keramische Waren,358371000,319855000,678226000
2022,5,WA70,Glas und Glaswaren,691192000,505635000,1196827000
2022,5,WA71,"Perlen, Edelsteine, Edelmetalle",2025029000,3349910000,5374939000
2022,5,WA72,Eisen und Stahl,3502173000,3743189000,7245362000
2022,5,WA73,Waren aus Eisen oder Stahl,2896964000,2775281000,5672245000
2022,5,WA74,Kupfer und Waren daraus,1471721000,1479363000,2951084000
2022,5,WA75,Nickel und Waren daraus,169794000,292732000,462526000
2022,5,WA76,Aluminium und Waren daraus,1901942000,2514114000,4416056000
2022,5,WA78,Blei und Waren daraus,35681000,54273000,89954000
2022,5,WA79,Zink und Waren daraus,96191000,173782000,269973000
2022,5,WA80,Zinn und Waren daraus,17185000,61849000,79034000
2022,5,WA81,"Andere unedle Metalle, Cermets usw.",156999000,226201000,383200000
2022,5,WA82,"Werkzeuge, Schneidwaren, Essbestecke",780149000,561675000,1341824000
2022,5,WA83,Verschiedene Waren aus unedlen Metallen,725803000,531730000,1257533000
2022,5,WA84,"Maschinen, Apparate, mechanische Geräte",20587647000,14217545000,34805192000
2022,5,WA85,Elektrotechnische Erzeugnisse,13975657000,15483120000,29458777000
2022,5,WA86,Schienenfahrzeuge,186214000,249565000,435779000
2022,5,WA87,"Kraftfahrzeuge, Landfahrzeuge",21199220000,11600159000,32799379000
2022,5,WA88,"Luftfahrzeuge, Raumfahrzeuge",2066430000,740317000,2806747000
2022,5,WA89,Wasserfahrzeuge,356720000,142335000,499055000
2022,5,WA90,"Optische, photografische usw. Erzeugnisse",6230304000,3741798000,9972102000
2022,5,WA91,Uhrmacherwaren,158262000,220739000,379001000
2022,5,WA92,Musikinstrumente,74905000,63011000,137916000
2022,5,WA93,Waffen und Munition,60478000,32526000,93004000
2022,5,WA94,"Möbel, Beleuchtungskörper usw.",1532360000,2128778000,3661138000
2022,5,WA95,"Spielzeug, Spiele usw., Sportgeräte",452149000,769027000,1221176000
2022,5,WA96,Verschiedene Waren,361744000,292788000,654532000
2022,5,WA97,"Kunstgegenstände, Sammlungsstücke",144535000,42986000,187521000
2022,5,WA98,Vollständige Fabrikationsanlagen,50790000,0,50790000
2022,5,WA99,Zusammenstellungen verschiedener Waren,1432778000,961029000,2393807000
2022,6,WA01,Lebende Tiere,130052000,110961000,241013000
2022,6,WA02,Fleisch,646601000,628865000,1275466000
2022,6,WA03,"Fische, Krebs- und Weichtiere",141240000,367157000,508397000
2022,6,WA04,"Milch, Milcherzeugnisse, Eier, Honig",1123599000,925535000,2049134000
2022,6,WA05,Andere Waren tierischen Ursprungs,88658000,104038000,192696000
2022,6,WA06,"Pflanzen, Waren des Blumenhandels",69333000,234578000,303911000
2022,6,WA07,"Gemüse, Pflanzen für Ernährung",100744000,546122000,646866000
2022,6,WA08,Genießbare Früchte und Nüsse,176758000,1085424000,1262182000
2022,6,WA09,"Kaffee, Tee, Mate, Gewürze",325295000,531197000,856492000
2022,6,WA10,Getreide,397253000,372560000,769813000
2022,6,WA11,"Müllereierzeugnisse, Malz usw.",179238000,82110000,261348000
2022,6,WA12,"Ölsamen usw., Heilpflanzen usw.",138791000,761763000,900554000
2022,6,WA13,"Schellack, Gummen, Harz, Pflanzensaft",63155000,75065000,138220000
2022,6,WA14,Flechtstoffe usw. pflanzlichen Ursprungs,1021000,4236000,5257000
2022,6,WA15,"Tierische und pflanzliche Fette, Öle, Wachs",443224000,648884000,1092108000
2022,6,WA16,"Zubereitungen von Fleisch, Fisch usw.",308285000,313737000,622022000
2022,6,WA17,Zucker und Zuckerwaren,274851000,159670000,434521000
2022,6,WA18,Kakao und Zubereitungen aus Kakao,433910000,370431000,804341000
2022,6,WA19,"Zubereitungen aus Getreide usw., Backwaren",676393000,470568000,1146961000
2022,6,WA20,"Zubereitungen von Gemüse, Früchten usw.",270956000,461888000,732844000
2022,6,WA21,Verschiedene Lebensmittelzubereitungen,698489000,403876000,1102365000
2022,6,WA22,"Getränke, alkoholhaltige Flüssigkeiten, Essig",637813000,822934000,1460747000
2022,6,WA23,"Rückstände der Lebensmittelindustrie, Futter",541309000,455103000,996412000
2022,6,WA24,Tabak,238937000,302825000,541762000
2022,6,WA25,"Salz, Schwefel, Steine, Erden usw.",228301000,197106000,425407000
2022,6,WA26,"Erze, Schlacken, Aschen",86658000,1079404000,1166062000
2022,6,WA27,Mineralische Brennstoffe usw.,5032973000,16742730000,21775703000
2022,6,WA28,Anorganische chemische Erzeugnisse,1412317000,887492000,2299809000
2022,6,WA29,Organische chemische Erzeugnisse,2909153000,6436571000,9345724000
2022,6,WA30,Pharmazeutische Erzeugnisse,10157492000,6151998000,16309490000
2022,6,WA31,Düngemittel,449629000,199868000,649497000
2022,6,WA32,"Gerb- und Farbstoffe, Farben, Lacke usw.",1133581000,603330000,1736911000
2022,6,WA33,"Etherische Öle, Riech-, Schönheitsmittel",969446000,664155000,1633601000
2022,6,WA34,"Seifen, Waschmittel usw.",809705000,442792000,1252497000
2022,6,WA35,"Eiweißstoffe, Klebstoffe, Enzyme",426247000,263443000,689690000
2022,6,WA36,"Sprengstoffe, pyrotechnische Artikel usw.",30607000,12590000,43197000
2022,6,WA37,Photochemische Erzeugnisse,99495000,59286000,158781000
2022,6,WA38,Verschiedene Erzeugnisse der Chemischen Industrie,2763519000,1908001000,4671520000
2022,6,WA39,Kunststoffe und Waren daraus,7039047000,4852592000,11891639000
2022,6,WA40,Kautschuk und Waren daraus,1461358000,1442002000,2903360000
2022,6,WA41,"Häute, Felle, Leder",59417000,44925000,104342000
2022,6,WA42,"Lederwaren, Sattlerwaren",255428000,399127000,654555000
2022,6,WA43,"Pelzfelle, künstliches Pelzwerk",4240000,9144000,13384000
2022,6,WA44,"Holz, Holzwaren, Holzkohle",1165479000,1051420000,2216899000
2022,6,WA45,"Kork, Korkwaren",2182000,9828000,12010000
2022,6,WA46,"Flechtwaren, Korbmacherwaren",6227000,18291000,24518000
2022,6,WA47,"Halbstoffe aus Holz usw., Papierabfall",136220000,448478000,584698000
2022,6,WA48,"Papier, Pappe und Waren daraus",2175997000,1336694000,3512691000
2022,6,WA49,"Bücher, Zeitungen, Bilddrucke usw.",316945000,238711000,555656000
2022,6,WA50,Seide,2102000,2820000,4922000
2022,6,WA51,"Wolle, feine und grobe Tierhaare",48187000,45461000,93648000
2022,6,WA52,Baumwolle,60964000,74838000,135802000
2022,6,WA53,"Andere pflanzliche Spinnstoffe, Papiergarn",3071000,6667000,9738000
2022,6,WA54,Synthetisches oder künstliches Filament,154623000,126748000,281371000
2022,6,WA55,Synthetische oder künstliche Spinnfaser,138719000,140764000,279483000
2022,6,WA56,"Watte, Filz, Vliesstoff usw., Tauwerk",249421000,164516000,413937000
2022,6,WA57,"Teppiche, Fußbodenbelag aus Spinnstoff",46045000,89050000,135095000
2022,6,WA58,"Spezialgewebe, Spitzen, Tapisserien",45994000,22711000,68705000
2022,6,WA59,"Getränkte, bestrichene usw. Gewebe",234644000,103896000,338540000
2022,6,WA60,Gewirke und Gestricke,68316000,42485000,110801000
2022,6,WA61,"Bekleidung usw. aus Gewirken, Gestricken",1040674000,1868802000,2909476000
2022,6,WA62,"Andere Bekleidung, Bekleidungszubehör",935649000,1534330000,2469979000
2022,6,WA63,"Andere Konfektion, Spinnstoffwaren usw.",274673000,456274000,730947000
2022,6,WA64,"Schuhe, Gamaschen, ähnliche Waren",801534000,1141668000,1943202000
2022,6,WA65,Kopfbedeckungen und Teile davon,65533000,80855000,146388000
2022,6,WA66,"Schirme, Gehstöcke usw., Peitschen",13991000,38091000,52082000
2022,6,WA67,"Zugerichtete Federn, Daunen, künstliche Blumen",12294000,25668000,37962000
2022,6,WA68,"Waren aus Steinen, Gips, Zement usw.",496046000,344185000,840231000
2022,6,WA69,Keramische Waren,371827000,308690000,680517000
2022,6,WA70,Glas und Glaswaren,689437000,486908000,1176345000
2022,6,WA71,"Perlen, Edelsteine, Edelmetalle",1824421000,2454152000,4278573000
2022,6,WA72,Eisen und Stahl,3282858000,3557309000,6840167000
2022,6,WA73,Waren aus Eisen oder Stahl,2969663000,2629629000,5599292000
2022,6,WA74,Kupfer und Waren daraus,1389580000,1494503000,2884083000
2022,6,WA75,Nickel und Waren daraus,177477000,233588000,411065000
2022,6,WA76,Aluminium und Waren daraus,1860268000,2362642000,4222910000
2022,6,WA78,Blei und Waren daraus,34599000,49382000,83981000
2022,6,WA79,Zink und Waren daraus,80704000,179688000,260392000
2022,6,WA80,Zinn und Waren daraus,15194000,68326000,83520000
2022,6,WA81,"Andere unedle Metalle, Cermets usw.",152920000,214925000,367845000
2022,6,WA82,"Werkzeuge, Schneidwaren, Essbestecke",798993000,538038000,1337031000
2022,6,WA83,Verschiedene Waren aus unedlen Metallen,734959000,503902000,1238861000
2022,6,WA84,"Maschinen, Apparate, mechanische Geräte",20820278000,13926014000,34746292000
2022,6,WA85,Elektrotechnische Erzeugnisse,14295487000,15802824000,30098311000
2022,6,WA86,Schienenfahrzeuge,268927000,294437000,563364000
2022,6,WA87,"Kraftfahrzeuge, Landfahrzeuge",21755585000,11288775000,33044360000
2022,6,WA88,"Luftfahrzeuge, Raumfahrzeuge",2619713000,1179289000,3799002000
2022,6,WA89,Wasserfahrzeuge,969056000,299605000,1268661000
2022,6,WA90,"Optische, photografische usw. Erzeugnisse",6482042000,3743038000,10225080000
2022,6,WA91,Uhrmacherwaren,153923000,228002000,381925000
2022,6,WA92,Musikinstrumente,76074000,58103000,134177000
2022,6,WA93,Waffen und Munition,60130000,33323000,93453000
2022,6,WA94,"Möbel, Beleuchtungskörper usw.",1493964000,1931191000,3425155000
2022,6,WA95,"Spielzeug, Spiele usw., Sportgeräte",435861000,734405000,1170266000
2022,6,WA96,Verschiedene Waren,364837000,297470000,662307000
2022,6,WA97,"Kunstgegenstände, Sammlungsstücke",92945000,175526000,268471000
2022,6,WA98,Vollständige Fabrikationsanlagen,48411000,0,48411000
2022,6,WA99,Zusammenstellungen verschiedener Waren,1548764000,987723000,2536487000
2022,7,WA01,Lebende Tiere,109168000,101793000,210961000
2022,7,WA02,Fleisch,641713000,602662000,1244375000
2022,7,WA03,"Fische, Krebs- und Weichtiere",147826000,361696000,509522000
2022,7,WA04,"Milch, Milcherzeugnisse, Eier, Honig",1086950000,904287000,1991237000
2022,7,WA05,Andere Waren tierischen Ursprungs,80920000,100121000,181041000
2022,7,WA06,"Pflanzen, Waren des Blumenhandels",58067000,196411000,254478000
2022,7,WA07,"Gemüse, Pflanzen für Ernährung",105746000,482456000,588202000
2022,7,WA08,Genießbare Früchte und Nüsse,171499000,1038710000,1210209000
2022,7,WA09,"Kaffee, Tee, Mate, Gewürze",309983000,535928000,845911000
2022,7,WA10,Getreide,298468000,305711000,604179000
2022,7,WA11,"Müllereierzeugnisse, Malz usw.",173197000,78286000,251483000
2022,7,WA12,"Ölsamen usw., Heilpflanzen usw.",152647000,688112000,840759000
2022,7,WA13,"Schellack, Gummen, Harz, Pflanzensaft",57355000,65031000,122386000
2022,7,WA14,Flechtstoffe usw. pflanzlichen Ursprungs,954000,3737000,4691000
2022,7,WA15,"Tierische und pflanzliche Fette, Öle, Wachs",362924000,599155000,962079000
2022,7,WA16,"Zubereitungen von Fleisch, Fisch usw.",299378000,309256000,608634000
2022,7,WA17,Zucker und Zuckerwaren,273985000,160779000,434764000
2022,7,WA18,Kakao und Zubereitungen aus Kakao,459160000,376890000,836050000
2022,7,WA19,"Zubereitungen aus Getreide usw., Backwaren",664031000,456537000,1120568000
2022,7,WA20,"Zubereitungen von Gemüse, Früchten usw.",266579000,482508000,749087000
2022,7,WA21,Verschiedene Lebensmittelzubereitungen,685647000,423116000,1108763000
2022,7,WA22,"Getränke, alkoholhaltige Flüssigkeiten, Essig",650751000,849641000,1500392000
2022,7,WA23,"Rückstände der Lebensmittelindustrie, Futter",532921000,481070000,1013991000
2022,7,WA24,Tabak,241308000,267381000,508689000
2022,7,WA25,"Salz, Schwefel, Steine, Erden usw.",199633000,187037000,386670000
2022,7,WA26,"Erze, Schlacken, Aschen",76546000,946066000,1022612000
2022,7,WA27,Mineralische Brennstoffe usw.,5926909000,19429055000,25355964000
2022,7,WA28,Anorganische chemische Erzeugnisse,1365446000,725671000,2091117000
2022,7,WA29,Organische chemische Erzeugnisse,3231074000,4050964000,7282038000
2022,7,WA30,Pharmazeutische Erzeugnisse,8963240000,6702563000,15665803000
2022,7,WA31,Düngemittel,438154000,189018000,627172000
2022,7,WA32,"Gerb- und Farbstoffe, Farben, Lacke usw.",1048689000,549235000,1597924000
2022,7,WA33,"Etherische Öle, Riech-, Schönheitsmittel",993260000,678185000,1671445000
2022,7,WA34,"Seifen, Waschmittel usw.",775508000,436024000,1211532000
2022,7,WA35,"Eiweißstoffe, Klebstoffe, Enzyme",407470000,252265000,659735000
2022,7,WA36,"Sprengstoffe, pyrotechnische Artikel usw.",24149000,15985000,40134000
2022,7,WA37,Photochemische Erzeugnisse,88742000,54977000,143719000
2022,7,WA38,Verschiedene Erzeugnisse der Chemischen Industrie,2613199000,1900898000,4514097000
2022,7,WA39,Kunststoffe und Waren daraus,6502499000,4681348000,11183847000
2022,7,WA40,Kautschuk und Waren daraus,1376156000,1391369000,2767525000
2022,7,WA41,"Häute, Felle, Leder",60325000,48855000,109180000
2022,7,WA42,"Lederwaren, Sattlerwaren",240934000,403950000,644884000
2022,7,WA43,"Pelzfelle, künstliches Pelzwerk",3565000,7389000,10954000
2022,7,WA44,"Holz, Holzwaren, Holzkohle",1015867000,933441000,1949308000
2022,7,WA45,"Kork, Korkwaren",2192000,8831000,11023000
2022,7,WA46,"Flechtwaren, Korbmacherwaren",6329000,19258000,25587000
2022,7,WA47,"Halbstoffe aus Holz usw., Papierabfall",127832000,506776000,634608000
2022,7,WA48,"Papier, Pappe und Waren daraus",2048730000,1322606000,3371336000
2022,7,WA49,"Bücher, Zeitungen, Bilddrucke usw.",297041000,231642000,528683000
2022,7,WA50,Seide,1284000,1964000,3248000
2022,7,WA51,"Wolle, feine und grobe Tierhaare",40632000,51236000,91868000
2022,7,WA52,Baumwolle,51075000,71171000,122246000
2022,7,WA53,"Andere pflanzliche Spinnstoffe, Papiergarn",2415000,5736000,8151000
2022,7,WA54,Synthetisches oder künstliches Filament,135404000,121394000,256798000
2022,7,WA55,Synthetische oder künstliche Spinnfaser,131039000,128923000,259962000
2022,7,WA56,"Watte, Filz, Vliesstoff usw., Tauwerk",228681000,155447000,384128000
2022,7,WA57,"Teppiche, Fußbodenbelag aus Spinnstoff",37999000,91790000,129789000
2022,7,WA58,"Spezialgewebe, Spitzen, Tapisserien",42573000,20764000,63337000
2022,7,WA59,"Getränkte, bestrichene usw. Gewebe",217908000,100308000,318216000
2022,7,WA60,Gewirke und Gestricke,57598000,36743000,94341000
2022,7,WA61,"Bekleidung usw. aus Gewirken, Gestricken",1051252000,1960739000,3011991000
2022,7,WA62,"Andere Bekleidung, Bekleidungszubehör",896313000,1605052000,2501365000
2022,7,WA63,"Andere Konfektion, Spinnstoffwaren usw.",272200000,451075000,723275000
2022,7,WA64,"Schuhe, Gamaschen, ähnliche Waren",786577000,1232708000,2019285000
2022,7,WA65,Kopfbedeckungen und Teile davon,57435000,85567000,143002000
2022,7,WA66,"Schirme, Gehstöcke usw., Peitschen",11833000,21212000,33045000
2022,7,WA67,"Zugerichtete Federn, Daunen, künstliche Blumen",12691000,26944000,39635000
2022,7,WA68,"Waren aus Steinen, Gips, Zement usw.",454707000,321476000,776183000
2022,7,WA69,Keramische Waren,333438000,308902000,642340000
2022,7,WA70,Glas und Glaswaren,655321000,465675000,1120996000
2022,7,WA71,"Perlen, Edelsteine, Edelmetalle",1726151000,2733845000,4459996000
2022,7,WA72,Eisen und Stahl,2800516000,3343718000,6144234000
2022,7,WA73,Waren aus Eisen oder Stahl,2640352000,2574933000,5215285000
2022,7,WA74,Kupfer und Waren daraus,1149923000,1171464000,2321387000
2022,7,WA75,Nickel und Waren daraus,148996000,205094000,354090000
2022,7,WA76,Aluminium und Waren daraus,1709892000,2176303000,3886195000
2022,7,WA78,Blei und Waren daraus,24321000,42902000,67223000
2022,7,WA79,Zink und Waren daraus,72404000,161874000,234278000
2022,7,WA80,Zinn und Waren daraus,15119000,46262000,61381000
2022,7,WA81,"Andere unedle Metalle, Cermets usw.",160067000,207752000,367819000
2022,7,WA82,"Werkzeuge, Schneidwaren, Essbestecke",754455000,514565000,1269020000
2022,7,WA83,Verschiedene Waren aus unedlen Metallen,686165000,480823000,1166988000
2022,7,WA84,"Maschinen, Apparate, mechanische Geräte",20195375000,13400703000,33596078000
2022,7,WA85,Elektrotechnische Erzeugnisse,13866362000,15362340000,29228702000
2022,7,WA86,Schienenfahrzeuge,218756000,427175000,645931000
2022,7,WA87,"Kraftfahrzeuge, Landfahrzeuge",19447220000,9738139000,29185359000
2022,7,WA88,"Luftfahrzeuge, Raumfahrzeuge",2055177000,686863000,2742040000
2022,7,WA89,Wasserfahrzeuge,319622000,498801000,818423000
2022,7,WA90,"Optische, photografische usw. Erzeugnisse",6147866000,3560034000,9707900000
2022,7,WA91,Uhrmacherwaren,153868000,230953000,384821000
2022,7,WA92,Musikinstrumente,70447000,58742000,129189000
2022,7,WA93,Waffen und Munition,51491000,29161000,80652000
2022,7,WA94,"Möbel, Beleuchtungskörper usw.",1354845000,1708083000,3062928000
2022,7,WA95,"Spielzeug, Spiele usw., Sportgeräte",450873000,740455000,1191328000
2022,7,WA96,Verschiedene Waren,355878000,296742000,652620000
2022,7,WA97,"Kunstgegenstände, Sammlungsstücke",59045000,71398000,130443000
2022,7,WA98,Vollständige Fabrikationsanlagen,27782000,0,27782000
2022,7,WA99,Zusammenstellungen verschiedener Waren,1426490000,886938000,2313428000
2022,8,WA01,Lebende Tiere,121853000,107935000,229788000
2022,8,WA02,Fleisch,700241000,631660000,1331901000
2022,8,WA03,"Fische, Krebs- und Weichtiere",143113000,401042000,544155000
2022,8,WA04,"Milch, Milcherzeugnisse, Eier, Honig",1157899000,953430000,2111329000
2022,8,WA05,Andere Waren tierischen Ursprungs,86515000,112738000,199253000
2022,8,WA06,"Pflanzen, Waren des Blumenhandels",76935000,188803000,265738000
2022,8,WA07,"Gemüse, Pflanzen für Ernährung",103936000,450525000,554461000
2022,8,WA08,Genießbare Früchte und Nüsse,164052000,1070144000,1234196000
2022,8,WA09,"Kaffee, Tee, Mate, Gewürze",339236000,554203000,893439000
2022,8,WA10,Getreide,380101000,338365000,718466000
2022,8,WA11,"Müllereierzeugnisse, Malz usw.",179582000,75766000,255348000
2022,8,WA12,"Ölsamen usw., Heilpflanzen usw.",126659000,574009000,700668000
2022,8,WA13,"Schellack, Gummen, Harz, Pflanzensaft",62411000,69819000,132230000
2022,8,WA14,Flechtstoffe usw. pflanzlichen Ursprungs,987000,4813000,5800000
2022,8,WA15,"Tierische und pflanzliche Fette, Öle, Wachs",372723000,635340000,1008063000
2022,8,WA16,"Zubereitungen von Fleisch, Fisch usw.",312968000,310245000,623213000
2022,8,WA17,Zucker und Zuckerwaren,291238000,163504000,454742000
2022,8,WA18,Kakao und Zubereitungen aus Kakao,580396000,404295000,984691000
2022,8,WA19,"Zubereitungen aus Getreide usw., Backwaren",740540000,453267000,1193807000
2022,8,WA20,"Zubereitungen von Gemüse, Früchten usw.",271556000,487723000,759279000
2022,8,WA21,Verschiedene Lebensmittelzubereitungen,682677000,390002000,1072679000
2022,8,WA22,"Getränke, alkoholhaltige Flüssigkeiten, Essig",652812000,794143000,1446955000
2022,8,WA23,"Rückstände der Lebensmittelindustrie, Futter",572863000,475154000,1048017000
2022,8,WA24,Tabak,261736000,290502000,552238000
2022,8,WA25,"Salz, Schwefel, Steine, Erden usw.",179628000,195564000,375192000
2022,8,WA26,"Erze, Schlacken, Aschen",91258000,857170000,948428000
2022,8,WA27,Mineralische Brennstoffe usw.,5910146000,22738660000,28648806000
2022,8,WA28,Anorganische chemische Erzeugnisse,1409389000,852652000,2262041000
2022,8,WA29,Organische chemische Erzeugnisse,2807409000,4955605000,7763014000
2022,8,WA30,Pharmazeutische Erzeugnisse,9848374000,6516825000,16365199000
2022,8,WA31,Düngemittel,387007000,209190000,596197000
2022,8,WA32,"Gerb- und Farbstoffe, Farben, Lacke usw.",1046323000,553753000,1600076000
2022,8,WA33,"Etherische Öle, Riech-, Schönheitsmittel",1024088000,687620000,1711708000
2022,8,WA34,"Seifen, Waschmittel usw.",793199000,466462000,1259661000
2022,8,WA35,"Eiweißstoffe, Klebstoffe, Enzyme",407888000,253581000,661469000
2022,8,WA36,"Sprengstoffe, pyrotechnische Artikel usw.",20910000,19863000,40773000
2022,8,WA37,Photochemische Erzeugnisse,92940000,57618000,150558000
2022,8,WA38,Verschiedene Erzeugnisse der Chemischen Industrie,2851301000,2061916000,4913217000
2022,8,WA39,Kunststoffe und Waren daraus,6266637000,4478357000,10744994000
2022,8,WA40,Kautschuk und Waren daraus,1389819000,1396693000,2786512000
2022,8,WA41,"Häute, Felle, Leder",45824000,35503000,81327000
2022,8,WA42,"Lederwaren, Sattlerwaren",270757000,434033000,704790000
2022,8,WA43,"Pelzfelle, künstliches Pelzwerk",6502000,9595000,16097000
2022,8,WA44,"Holz, Holzwaren, Holzkohle",926401000,855718000,1782119000
2022,8,WA45,"Kork, Korkwaren",1954000,8718000,10672000
2022,8,WA46,"Flechtwaren, Korbmacherwaren",5930000,16550000,22480000
2022,8,WA47,"Halbstoffe aus Holz usw., Papierabfall",130502000,494133000,624635000
2022,8,WA48,"Papier, Pappe und Waren daraus",2094301000,1383313000,3477614000
2022,8,WA49,"Bücher, Zeitungen, Bilddrucke usw.",326301000,268911000,595212000
2022,8,WA50,Seide,1535000,2351000,3886000
2022,8,WA51,"Wolle, feine und grobe Tierhaare",39621000,44869000,84490000
2022,8,WA52,Baumwolle,56002000,75247000,131249000
2022,8,WA53,"Andere pflanzliche Spinnstoffe, Papiergarn",3513000,6325000,9838000
2022,8,WA54,Synthetisches oder künstliches Filament,133582000,119128000,252710000
2022,8,WA55,Synthetische oder künstliche Spinnfaser,117391000,117707000,235098000
2022,8,WA56,"Watte, Filz, Vliesstoff usw., Tauwerk",223659000,152152000,375811000
2022,8,WA57,"Teppiche, Fußbodenbelag aus Spinnstoff",43377000,94849000,138226000
2022,8,WA58,"Spezialgewebe, Spitzen, Tapisserien",41338000,21299000,62637000
2022,8,WA59,"Getränkte, bestrichene usw. Gewebe",221451000,100171000,321622000
2022,8,WA60,Gewirke und Gestricke,47027000,28871000,75898000
2022,8,WA61,"Bekleidung usw. aus Gewirken, Gestricken",1159010000,2402222000,3561232000
2022,8,WA62,"Andere Bekleidung, Bekleidungszubehör",1017167000,1982948000,3000115000
2022,8,WA63,"Andere Konfektion, Spinnstoffwaren usw.",280787000,523118000,803905000
2022,8,WA64,"Schuhe, Gamaschen, ähnliche Waren",982818000,1407801000,2390619000
2022,8,WA65,Kopfbedeckungen und Teile davon,62026000,104931000,166957000
2022,8,WA66,"Schirme, Gehstöcke usw., Peitschen",10913000,18120000,29033000
2022,8,WA67,"Zugerichtete Federn, Daunen, künstliche Blumen",14684000,39557000,54241000
2022,8,WA68,"Waren aus Steinen, Gips, Zement usw.",453127000,328706000,781833000
2022,8,WA69,Keramische Waren,328137000,295859000,623996000
2022,8,WA70,Glas und Glaswaren,653942000,478922000,1132864000
2022,8,WA71,"Perlen, Edelsteine, Edelmetalle",1825248000,2519376000,4344624000
2022,8,WA72,Eisen und Stahl,2554808000,2857514000,5412322000
2022,8,WA73,Waren aus Eisen oder Stahl,2647214000,2435925000,5083139000
2022,8,WA74,Kupfer und Waren daraus,1038536000,1104489000,2143025000
2022,8,WA75,Nickel und Waren daraus,166179000,194493000,360672000
2022,8,WA76,Aluminium und Waren daraus,1663485000,2048010000,3711495000
2022,8,WA78,Blei und Waren daraus,23839000,37386000,61225000
2022,8,WA79,Zink und Waren daraus,61293000,140946000,202239000
2022,8,WA80,Zinn und Waren daraus,13904000,46752000,60656000
2022,8,WA81,"Andere unedle Metalle, Cermets usw.",152797000,206649000,359446000
2022,8,WA82,"Werkzeuge, Schneidwaren, Essbestecke",754620000,531310000,1285930000
2022,8,WA83,Verschiedene Waren aus unedlen Metallen,679636000,471831000,1151467000
2022,8,WA84,"Maschinen, Apparate, mechanische Geräte",20204462000,13097996000,33302458000
2022,8,WA85,Elektrotechnische Erzeugnisse,14638234000,16269052000,30907286000
2022,8,WA86,Schienenfahrzeuge,186213000,263925000,450138000
2022,8,WA87,"Kraftfahrzeuge, Landfahrzeuge",18047975000,9120073000,27168048000
2022,8,WA88,"Luftfahrzeuge, Raumfahrzeuge",1605379000,1015718000,2621097000
2022,8,WA89,Wasserfahrzeuge,252509000,105780000,358289000
2022,8,WA90,"Optische, photografische usw. Erzeugnisse",6362499000,3703163000,10065662000
2022,8,WA91,Uhrmacherwaren,155702000,226243000,381945000
2022,8,WA92,Musikinstrumente,71555000,67660000,139215000
2022,8,WA93,Waffen und Munition,57582000,35505000,93087000
2022,8,WA94,"Möbel, Beleuchtungskörper usw.",1380760000,1788743000,3169503000
2022,8,WA95,"Spielzeug, Spiele usw., Sportgeräte",501916000,812009000,1313925000
2022,8,WA96,Verschiedene Waren,375517000,313490000,689007000
2022,8,WA97,"Kunstgegenstände, Sammlungsstücke",83190000,42820000,126010000
2022,8,WA98,Vollständige Fabrikationsanlagen,61329000,95000,61424000
2022,8,WA99,Zusammenstellungen verschiedener Waren,1516174000,860134000,2376308000
2022,9,WA01,Lebende Tiere,134702000,117587000,252289000
2022,9,WA02,Fleisch,710742000,698458000,1409200000
2022,9,WA03,"Fische, Krebs- und Weichtiere",164447000,427580000,592027000
2022,9,WA04,"Milch, Milcherzeugnisse, Eier, Honig",1156529000,986611000,2143140000
2022,9,WA05,Andere Waren tierischen Ursprungs,85087000,109549000,194636000
2022,9,WA06,"Pflanzen, Waren des Blumenhandels",92969000,215315000,308284000
2022,9,WA07,"Gemüse, Pflanzen für Ernährung",124000000,490577000,614577000
2022,9,WA08,Genießbare Früchte und Nüsse,164737000,930424000,1095161000
2022,9,WA09,"Kaffee, Tee, Mate, Gewürze",343236000,539578000,882814000
2022,9,WA10,Getreide,386995000,370846000,757841000
2022,9,WA11,"Müllereierzeugnisse, Malz usw.",199644000,84046000,283690000
2022,9,WA12,"Ölsamen usw., Heilpflanzen usw.",117850000,626517000,744367000
2022,9,WA13,"Schellack, Gummen, Harz, Pflanzensaft",64156000,67154000,131310000
2022,9,WA14,Flechtstoffe usw. pflanzlichen Ursprungs,1062000,4672000,5734000
2022,9,WA15,"Tierische und pflanzliche Fette, Öle, Wachs",421321000,572589000,993910000
2022,9,WA16,"Zubereitungen von Fleisch, Fisch usw.",327101000,327328000,654429000
2022,9,WA17,Zucker und Zuckerwaren,316468000,170811000,487279000
2022,9,WA18,Kakao und Zubereitungen aus Kakao,693905000,434124000,1128029000
2022,9,WA19,"Zubereitungen aus Getreide usw., Backwaren",776575000,506203000,1282778000
2022,9,WA20,"Zubereitungen von Gemüse, Früchten usw.",277026000,521000000,798026000
2022,9,WA21,Verschiedene Lebensmittelzubereitungen,673420000,410922000,1084342000
2022,9,WA22,"Getränke, alkoholhaltige Flüssigkeiten, Essig",637956000,827728000,1465684000
2022,9,WA23,"Rückstände der Lebensmittelindustrie, Futter",582942000,492897000,1075839000
2022,9,WA24,Tabak,254269000,303665000,557934000
2022,9,WA25,"Salz, Schwefel, Steine, Erden usw.",212120000,192140000,404260000
2022,9,WA26,"Erze, Schlacken, Aschen",93181000,1092270000,1185451000
2022,9,WA27,Mineralische Brennstoffe usw.,5538673000,19138572000,24677245000
2022,9,WA28,Anorganische chemische Erzeugnisse,1438997000,961498000,2400495000
2022,9,WA29,Organische chemische Erzeugnisse,3924522000,4786182000,8710704000
2022,9,WA30,Pharmazeutische Erzeugnisse,10883015000,8187674000,19070689000
2022,9,WA31,Düngemittel,418408000,281543000,699951000
2022,9,WA32,"Gerb- und Farbstoffe, Farben, Lacke usw.",1098631000,558727000,1657358000
2022,9,WA33,"Etherische Öle, Riech-, Schönheitsmittel",1104078000,776208000,1880286000
2022,9,WA34,"Seifen, Waschmittel usw.",847720000,520561000,1368281000
2022,9,WA35,"Eiweißstoffe, Klebstoffe, Enzyme",442568000,277804000,720372000
2022,9,WA36,"Sprengstoffe, pyrotechnische Artikel usw.",35874000,25846000,61720000
2022,9,WA37,Photochemische Erzeugnisse,97010000,57342000,154352000
2022,9,WA38,Verschiedene Erzeugnisse der Chemischen Industrie,2964667000,2009508000,4974175000
2022,9,WA39,Kunststoffe und Waren daraus,6710528000,4614711000,11325239000
2022,9,WA40,Kautschuk und Waren daraus,1547020000,1620605000,3167625000
2022,9,WA41,"Häute, Felle, Leder",58980000,45170000,104150000
2022,9,WA42,"Lederwaren, Sattlerwaren",281935000,453489000,735424000
2022,9,WA43,"Pelzfelle, künstliches Pelzwerk",5987000,10863000,16850000
2022,9,WA44,"Holz, Holzwaren, Holzkohle",1092870000,938085000,2030955000
2022,9,WA45,"Kork, Korkwaren",2240000,8164000,10404000
2022,9,WA46,"Flechtwaren, Korbmacherwaren",5731000,18884000,24615000
2022,9,WA47,"Halbstoffe aus Holz usw., Papierabfall",145993000,408245000,554238000
2022,9,WA48,"Papier, Pappe und Waren daraus",2231806000,1389199000,3621005000
2022,9,WA49,"Bücher, Zeitungen, Bilddrucke usw.",352877000,286982000,639859000
2022,9,WA50,Seide,2284000,4671000,6955000
2022,9,WA51,"Wolle, feine und grobe Tierhaare",47682000,48576000,96258000
2022,9,WA52,Baumwolle,67515000,74229000,141744000
2022,9,WA53,"Andere pflanzliche Spinnstoffe, Papiergarn",3780000,7558000,11338000
2022,9,WA54,Synthetisches oder künstliches Filament,162941000,144884000,307825000
2022,9,WA55,Synthetische oder künstliche Spinnfaser,143239000,144758000,287997000
2022,9,WA56,"Watte, Filz, Vliesstoff usw., Tauwerk",245996000,159712000,405708000
2022,9,WA57,"Teppiche, Fußbodenbelag aus Spinnstoff",53166000,98718000,151884000
2022,9,WA58,"Spezialgewebe, Spitzen, Tapisserien",51541000,25105000,76646000
2022,9,WA59,"Getränkte, bestrichene usw. Gewebe",241472000,119879000,361351000
2022,9,WA60,Gewirke und Gestricke,67593000,45095000,112688000
2022,9,WA61,"Bekleidung usw. aus Gewirken, Gestricken",1266624000,2546236000,3812860000
2022,9,WA62,"Andere Bekleidung, Bekleidungszubehör",1160022000,2150717000,3310739000
2022,9,WA63,"Andere Konfektion, Spinnstoffwaren usw.",300241000,514172000,814413000
2022,9,WA64,"Schuhe, Gamaschen, ähnliche Waren",942068000,1431530000,2373598000
2022,9,WA65,Kopfbedeckungen und Teile davon,69640000,109501000,179141000
2022,9,WA66,"Schirme, Gehstöcke usw., Peitschen",9203000,16171000,25374000
2022,9,WA67,"Zugerichtete Federn, Daunen, künstliche Blumen",19594000,34857000,54451000
2022,9,WA68,"Waren aus Steinen, Gips, Zement usw.",495829000,350114000,845943000
2022,9,WA69,Keramische Waren,378865000,321861000,700726000
2022,9,WA70,Glas und Glaswaren,769533000,540556000,1310089000
2022,9,WA71,"Perlen, Edelsteine, Edelmetalle",2021684000,2835080000,4856764000
2022,9,WA72,Eisen und Stahl,2977008000,2885475000,5862483000
2022,9,WA73,Waren aus Eisen oder Stahl,2973519000,2717759000,5691278000
2022,9,WA74,Kupfer und Waren daraus,1285083000,1146361000,2431444000
2022,9,WA75,Nickel und Waren daraus,185169000,199202000,384371000
2022,9,WA76,Aluminium und Waren daraus,1761988000,2255733000,4017721000
2022,9,WA78,Blei und Waren daraus,30820000,40928000,71748000
2022,9,WA79,Zink und Waren daraus,76170000,160312000,236482000
2022,9,WA80,Zinn und Waren daraus,11725000,55308000,67033000
2022,9,WA81,"Andere unedle Metalle, Cermets usw.",156654000,219353000,376007000
2022,9,WA82,"Werkzeuge, Schneidwaren, Essbestecke",818510000,567268000,1385778000
2022,9,WA83,Verschiedene Waren aus unedlen Metallen,736033000,536341000,1272374000
2022,9,WA84,"Maschinen, Apparate, mechanische Geräte",21959140000,15289958000,37249098000
2022,9,WA85,Elektrotechnische Erzeugnisse,15869183000,18548980000,34418163000
2022,9,WA86,Schienenfahrzeuge,235803000,281892000,517695000
2022,9,WA87,"Kraftfahrzeuge, Landfahrzeuge",24521946000,13130890000,37652836000
2022,9,WA88,"Luftfahrzeuge, Raumfahrzeuge",2718876000,1129634000,3848510000
2022,9,WA89,Wasserfahrzeuge,93952000,125791000,219743000
2022,9,WA90,"Optische, photografische usw. Erzeugnisse",6958345000,4015815000,10974160000
2022,9,WA91,Uhrmacherwaren,165274000,248732000,414006000
2022,9,WA92,Musikinstrumente,92478000,77507000,169985000
2022,9,WA93,Waffen und Munition,63909000,34619000,98528000
2022,9,WA94,"Möbel, Beleuchtungskörper usw.",1619047000,2057571000,3676618000
2022,9,WA95,"Spielzeug, Spiele usw., Sportgeräte",684127000,952707000,1636834000
2022,9,WA96,Verschiedene Waren,378735000,319069000,697804000
2022,9,WA97,"Kunstgegenstände, Sammlungsstücke",89780000,46402000,136182000
2022,9,WA98,Vollständige Fabrikationsanlagen,59377000,0,59377000
2022,9,WA99,Zusammenstellungen verschiedener Waren,1390700000,930913000,2321613000
2022,10,WA01,Lebende Tiere,121466000,111527000,232993000
2022,10,WA02,Fleisch,638611000,710837000,1349448000
2022,10,WA03,"Fische, Krebs- und Weichtiere",158709000,463125000,621834000
2022,10,WA04,"Milch, Milcherzeugnisse, Eier, Honig",1066545000,970506000,2037051000
2022,10,WA05,Andere Waren tierischen Ursprungs,85201000,115265000,200466000
2022,10,WA06,"Pflanzen, Waren des Blumenhandels",85370000,214005000,299375000
2022,10,WA07,"Gemüse, Pflanzen für Ernährung",116700000,556237000,672937000
2022,10,WA08,Genießbare Früchte und Nüsse,169168000,875801000,1044969000
2022,10,WA09,"Kaffee, Tee, Mate, Gewürze",335602000,569683000,905285000
2022,10,WA10,Getreide,294429000,370895000,665324000
2022,10,WA11,"Müllereierzeugnisse, Malz usw.",195608000,82883000,278491000
2022,10,WA12,"Ölsamen usw., Heilpflanzen usw.",108864000,800018000,908882000
2022,10,WA13,"Schellack, Gummen, Harz, Pflanzensaft",61328000,62197000,123525000
2022,10,WA14,Flechtstoffe usw. pflanzlichen Ursprungs,1034000,4781000,5815000
2022,10,WA15,"Tierische und pflanzliche Fette, Öle, Wachs",426291000,537243000,963534000
2022,10,WA16,"Zubereitungen von Fleisch, Fisch usw.",300161000,338612000,638773000
2022,10,WA17,Zucker und Zuckerwaren,327474000,173071000,500545000
2022,10,WA18,Kakao und Zubereitungen aus Kakao,658411000,444653000,1103064000
2022,10,WA19,"Zubereitungen aus Getreide usw., Backwaren",744605000,503568000,1248173000
2022,10,WA20,"Zubereitungen von Gemüse, Früchten usw.",271840000,518688000,790528000
2022,10,WA21,Verschiedene Lebensmittelzubereitungen,635283000,400193000,1035476000
2022,10,WA22,"Getränke, alkoholhaltige Flüssigkeiten, Essig",577976000,835224000,1413200000
2022,10,WA23,"Rückstände der Lebensmittelindustrie, Futter",594476000,471780000,1066256000
2022,10,WA24,Tabak,241130000,264908000,506038000
2022,10,WA25,"Salz, Schwefel, Steine, Erden usw.",201145000,179501000,380646000
2022,10,WA26,"Erze, Schlacken, Aschen",81217000,1024762000,1105979000
2022,10,WA27,Mineralische Brennstoffe usw.,4394236000,15347363000,19741599000
2022,10,WA28,Anorganische chemische Erzeugnisse,1539312000,1010886000,2550198000
2022,10,WA29,Organische chemische Erzeugnisse,2370531000,3132666000,5503197000
2022,10,WA30,Pharmazeutische Erzeugnisse,10240226000,6984630000,17224856000
2022,10,WA31,Düngemittel,424635000,279601000,704236000
2022,10,WA32,"Gerb- und Farbstoffe, Farben, Lacke usw.",979503000,505212000,1484715000
2022,10,WA33,"Etherische Öle, Riech-, Schönheitsmittel",1010725000,712256000,1722981000
2022,10,WA34,"Seifen, Waschmittel usw.",784985000,530824000,1315809000
2022,10,WA35,"Eiweißstoffe, Klebstoffe, Enzyme",403603000,262953000,666556000
2022,10,WA36,"Sprengstoffe, pyrotechnische Artikel usw.",28325000,22051000,50376000
2022,10,WA37,Photochemische Erzeugnisse,91075000,56056000,147131000
2022,10,WA38,Verschiedene Erzeugnisse der Chemischen Industrie,2761095000,1933961000,4695056000
2022,10,WA39,Kunststoffe und Waren daraus,6100365000,4401988000,10502353000
2022,10,WA40,Kautschuk und Waren daraus,1474718000,1546401000,3021119000
2022,10,WA41,"Häute, Felle, Leder",54190000,41916000,96106000
2022,10,WA42,"Lederwaren, Sattlerwaren",256023000,461077000,717100000
2022,10,WA43,"Pelzfelle, künstliches Pelzwerk",9445000,13406000,22851000
2022,10,WA44,"Holz, Holzwaren, Holzkohle",990810000,877781000,1868591000
2022,10,WA45,"Kork, Korkwaren",2007000,7714000,9721000
2022,10,WA46,"Flechtwaren, Korbmacherwaren",5326000,14400000,19726000
2022,10,WA47,"Halbstoffe aus Holz usw., Papierabfall",130244000,442801000,573045000
2022,10,WA48,"Papier, Pappe und Waren daraus",2050905000,1390568000,3441473000
2022,10,WA49,"Bücher, Zeitungen, Bilddrucke usw.",351022000,282007000,633029000
2022,10,WA50,Seide,1665000,2754000,4419000
2022,10,WA51,"Wolle, feine und grobe Tierhaare",42566000,49068000,91634000
2022,10,WA52,Baumwolle,63217000,75665000,138882000
2022,10,WA53,"Andere pflanzliche Spinnstoffe, Papiergarn",4129000,9517000,13646000
2022,10,WA54,Synthetisches oder künstliches Filament,146243000,140015000,286258000
2022,10,WA55,Synthetische oder künstliche Spinnfaser,134091000,140354000,274445000
2022,10,WA56,"Watte, Filz, Vliesstoff usw., Tauwerk",223329000,155589000,378918000
2022,10,WA57,"Teppiche, Fußbodenbelag aus Spinnstoff",50303000,98983000,149286000
2022,10,WA58,"Spezialgewebe, Spitzen, Tapisserien",46459000,24496000,70955000
2022,10,WA59,"Getränkte, bestrichene usw. Gewebe",218649000,117424000,336073000
2022,10,WA60,Gewirke und Gestricke,61542000,41507000,103049000
2022,10,WA61,"Bekleidung usw. aus Gewirken, Gestricken",1203253000,2332401000,3535654000
2022,10,WA62,"Andere Bekleidung, Bekleidungszubehör",1098779000,1928971000,3027750000
2022,10,WA63,"Andere Konfektion, Spinnstoffwaren usw.",287719000,486990000,774709000
2022,10,WA64,"Schuhe, Gamaschen, ähnliche Waren",879932000,1365425000,2245357000
2022,10,WA65,Kopfbedeckungen und Teile davon,68011000,102259000,170270000
2022,10,WA66,"Schirme, Gehstöcke usw., Peitschen",11988000,20232000,32220000
2022,10,WA67,"Zugerichtete Federn, Daunen, künstliche Blumen",17698000,32312000,50010000
2022,10,WA68,"Waren aus Steinen, Gips, Zement usw.",472995000,324417000,797412000
2022,10,WA69,Keramische Waren,366272000,305250000,671522000
2022,10,WA70,Glas und Glaswaren,697230000,510399000,1207629000
2022,10,WA71,"Perlen, Edelsteine, Edelmetalle",1986152000,3068442000,5054594000
2022,10,WA72,Eisen und Stahl,2707299000,2996909000,5704208000
2022,10,WA73,Waren aus Eisen oder Stahl,2684138000,2643778000,5327916000
2022,10,WA74,Kupfer und Waren daraus,1174190000,1038814000,2213004000
2022,10,WA75,Nickel und Waren daraus,159856000,184807000,344663000
2022,10,WA76,Aluminium und Waren daraus,1629217000,2080504000,3709721000
2022,10,WA78,Blei und Waren daraus,29909000,45732000,75641000
2022,10,WA79,Zink und Waren daraus,74263000,156465000,230728000
2022,10,WA80,Zinn und Waren daraus,11121000,45535000,56656000
2022,10,WA81,"Andere unedle Metalle, Cermets usw.",151574000,192915000,344489000
2022,10,WA82,"Werkzeuge, Schneidwaren, Essbestecke",759745000,551725000,1311470000
2022,10,WA83,Verschiedene Waren aus unedlen Metallen,674243000,501524000,1175767000
2022,10,WA84,"Maschinen, Apparate, mechanische Geräte",20090754000,14701711000,34792465000
2022,10,WA85,Elektrotechnische Erzeugnisse,14762853000,18732199000,33495052000
2022,10,WA86,Schienenfahrzeuge,205120000,259560000,464680000
2022,10,WA87,"Kraftfahrzeuge, Landfahrzeuge",22612020000,11931258000,34543278000
2022,10,WA88,"Luftfahrzeuge, Raumfahrzeuge",2833185000,1034771000,3867956000
2022,10,WA89,Wasserfahrzeuge,576525000,111848000,688373000
2022,10,WA90,"Optische, photografische usw. Erzeugnisse",6194951000,3950861000,10145812000
2022,10,WA91,Uhrmacherwaren,175676000,285119000,460795000
2022,10,WA92,Musikinstrumente,88606000,75426000,164032000
2022,10,WA93,Waffen und Munition,54351000,42885000,97236000
2022,10,WA94,"Möbel, Beleuchtungskörper usw.",1521339000,1918160000,3439499000
2022,10,WA95,"Spielzeug, Spiele usw., Sportgeräte",752158000,1163278000,1915436000
2022,10,WA96,Verschiedene Waren,375926000,321803000,697729000
2022,10,WA97,"Kunstgegenstände, Sammlungsstücke",251696000,51042000,302738000
2022,10,WA98,Vollständige Fabrikationsanlagen,48592000,0,48592000
2022,10,WA99,Zusammenstellungen verschiedener Waren,2036196000,970129000,3006325000
2022,11,WA01,Lebende Tiere,135324000,114556000,249880000
2022,11,WA02,Fleisch,708029000,725722000,1433751000
2022,11,WA03,"Fische, Krebs- und Weichtiere",177608000,496562000,674170000
2022,11,WA04,"Milch, Milcherzeugnisse, Eier, Honig",1126839000,1090562000,2217401000
2022,11,WA05,Andere Waren tierischen Ursprungs,93040000,124376000,217416000
2022,11,WA06,"Pflanzen, Waren des Blumenhandels",81412000,251885000,333297000
2022,11,WA07,"Gemüse, Pflanzen für Ernährung",106840000,612379000,719219000
2022,11,WA08,Genießbare Früchte und Nüsse,170353000,973254000,1143607000
2022,11,WA09,"Kaffee, Tee, Mate, Gewürze",375303000,594630000,969933000
2022,11,WA10,Getreide,221291000,407538000,628829000
2022,11,WA11,"Müllereierzeugnisse, Malz usw.",227071000,93628000,320699000
2022,11,WA12,"Ölsamen usw., Heilpflanzen usw.",166650000,684927000,851577000
2022,11,WA13,"Schellack, Gummen, Harz, Pflanzensaft",64343000,70508000,134851000
2022,11,WA14,Flechtstoffe usw. pflanzlichen Ursprungs,1336000,5139000,6475000
2022,11,WA15,"Tierische und pflanzliche Fette, Öle, Wachs",441633000,565513000,1007146000
2022,11,WA16,"Zubereitungen von Fleisch, Fisch usw.",326014000,356992000,683006000
2022,11,WA17,Zucker und Zuckerwaren,356265000,186140000,542405000
2022,11,WA18,Kakao und Zubereitungen aus Kakao,680425000,507295000,1187720000
2022,11,WA19,"Zubereitungen aus Getreide usw., Backwaren",785056000,552780000,1337836000
2022,11,WA20,"Zubereitungen von Gemüse, Früchten usw.",285852000,574292000,860144000
2022,11,WA21,Verschiedene Lebensmittelzubereitungen,682320000,427937000,1110257000
2022,11,WA22,"Getränke, alkoholhaltige Flüssigkeiten, Essig",632638000,888176000,1520814000
2022,11,WA23,"Rückstände der Lebensmittelindustrie, Futter",685120000,576168000,1261288000
2022,11,WA24,Tabak,250339000,332933000,583272000
2022,11,WA25,"Salz, Schwefel, Steine, Erden usw.",211833000,207018000,418851000
2022,11,WA26,"Erze, Schlacken, Aschen",71754000,854285000,926039000
2022,11,WA27,Mineralische Brennstoffe usw.,4517018000,14501561000,19018579000
2022,11,WA28,Anorganische chemische Erzeugnisse,1346034000,952575000,2298609000
2022,11,WA29,Organische chemische Erzeugnisse,2630869000,3066154000,5697023000
2022,11,WA30,Pharmazeutische Erzeugnisse,10033603000,6374094000,16407697000
2022,11,WA31,Düngemittel,447346000,257483000,704829000
2022,11,WA32,"Gerb- und Farbstoffe, Farben, Lacke usw.",1040265000,519810000,1560075000
2022,11,WA33,"Etherische Öle, Riech-, Schönheitsmittel",1119281000,751368000,1870649000
2022,11,WA34,"Seifen, Waschmittel usw.",801161000,526657000,1327818000
2022,11,WA35,"Eiweißstoffe, Klebstoffe, Enzyme",427542000,267309000,694851000
2022,11,WA36,"Sprengstoffe, pyrotechnische Artikel usw.",37973000,27123000,65096000
2022,11,WA37,Photochemische Erzeugnisse,101987000,56681000,158668000
2022,11,WA38,Verschiedene Erzeugnisse der Chemischen Industrie,3205918000,2004704000,5210622000
2022,11,WA39,Kunststoffe und Waren daraus,6233829000,4444268000,10678097000
2022,11,WA40,Kautschuk und Waren daraus,1527816000,1470575000,2998391000
2022,11,WA41,"Häute, Felle, Leder",65858000,45619000,111477000
2022,11,WA42,"Lederwaren, Sattlerwaren",290770000,476540000,767310000
2022,11,WA43,"Pelzfelle, künstliches Pelzwerk",6188000,10958000,17146000
2022,11,WA44,"Holz, Holzwaren, Holzkohle",1056695000,864602000,1921297000
2022,11,WA45,"Kork, Korkwaren",2341000,8671000,11012000
2022,11,WA46,"Flechtwaren, Korbmacherwaren",5237000,14890000,20127000
2022,11,WA47,"Halbstoffe aus Holz usw., Papierabfall",129990000,419566000,549556000
2022,11,WA48,"Papier, Pappe und Waren daraus",2130983000,1423471000,3554454000
2022,11,WA49,"Bücher, Zeitungen, Bilddrucke usw.",359777000,303356000,663133000
2022,11,WA50,Seide,2400000,2888000,5288000
2022,11,WA51,"Wolle, feine und grobe Tierhaare",47848000,54151000,101999000
2022,11,WA52,Baumwolle,71828000,83133000,154961000
2022,11,WA53,"Andere pflanzliche Spinnstoffe, Papiergarn",6087000,9243000,15330000
2022,11,WA54,Synthetisches oder künstliches Filament,155014000,136259000,291273000
2022,11,WA55,Synthetische oder künstliche Spinnfaser,143109000,146517000,289626000
2022,11,WA56,"Watte, Filz, Vliesstoff usw., Tauwerk",228672000,157421000,386093000
2022,11,WA57,"Teppiche, Fußbodenbelag aus Spinnstoff",59666000,100638000,160304000
2022,11,WA58,"Spezialgewebe, Spitzen, Tapisserien",47700000,23880000,71580000
2022,11,WA59,"Getränkte, bestrichene usw. Gewebe",242250000,127290000,369540000
2022,11,WA60,Gewirke und Gestricke,66051000,43674000,109725000
2022,11,WA61,"Bekleidung usw. aus Gewirken, Gestricken",1258115000,2190477000,3448592000
2022,11,WA62,"Andere Bekleidung, Bekleidungszubehör",1106318000,1765810000,2872128000
2022,11,WA63,"Andere Konfektion, Spinnstoffwaren usw.",299458000,506433000,805891000
2022,11,WA64,"Schuhe, Gamaschen, ähnliche Waren",858820000,1349573000,2208393000
2022,11,WA65,Kopfbedeckungen und Teile davon,71231000,98320000,169551000
2022,11,WA66,"Schirme, Gehstöcke usw., Peitschen",8255000,19489000,27744000
2022,11,WA67,"Zugerichtete Federn, Daunen, künstliche Blumen",17619000,28033000,45652000
2022,11,WA68,"Waren aus Steinen, Gips, Zement usw.",501464000,338075000,839539000
2022,11,WA69,Keramische Waren,373858000,320456000,694314000
2022,11,WA70,Glas und Glaswaren,723636000,517253000,1240889000
2022,11,WA71,"Perlen, Edelsteine, Edelmetalle",2174632000,3378684000,5553316000
2022,11,WA72,Eisen und Stahl,2750240000,2901165000,5651405000
2022,11,WA73,Waren aus Eisen oder Stahl,2949204000,2735385000,5684589000
2022,11,WA74,Kupfer und Waren daraus,1316102000,1103738000,2419840000
2022,11,WA75,Nickel und Waren daraus,200411000,186570000,386981000
2022,11,WA76,Aluminium und Waren daraus,1749788000,2043444000,3793232000
2022,11,WA78,Blei und Waren daraus,35280000,57957000,93237000
2022,11,WA79,Zink und Waren daraus,75429000,174463000,249892000
2022,11,WA80,Zinn und Waren daraus,11736000,32653000,44389000
2022,11,WA81,"Andere unedle Metalle, Cermets usw.",149550000,216516000,366066000
2022,11,WA82,"Werkzeuge, Schneidwaren, Essbestecke",841992000,574166000,1416158000
2022,11,WA83,Verschiedene Waren aus unedlen Metallen,713171000,503882000,1217053000
2022,11,WA84,"Maschinen, Apparate, mechanische Geräte",23013509000,15497922000,38511431000
2022,11,WA85,Elektrotechnische Erzeugnisse,16090155000,20090039000,36180194000
2022,11,WA86,Schienenfahrzeuge,272800000,288667000,561467000
2022,11,WA87,"Kraftfahrzeuge, Landfahrzeuge",24713581000,13414836000,38128417000
2022,11,WA88,"Luftfahrzeuge, Raumfahrzeuge",2549562000,1095851000,3645413000
2022,11,WA89,Wasserfahrzeuge,1116381000,722960000,1839341000
2022,11,WA90,"Optische, photografische usw. Erzeugnisse",7131099000,4255423000,11386522000
2022,11,WA91,Uhrmacherwaren,183442000,287222000,470664000
2022,11,WA92,Musikinstrumente,101771000,91999000,193770000
2022,11,WA93,Waffen und Munition,63903000,40996000,104899000
2022,11,WA94,"Möbel, Beleuchtungskörper usw.",1690587000,2076268000,3766855000
2022,11,WA95,"Spielzeug, Spiele usw., Sportgeräte",732387000,1059719000,1792106000
2022,11,WA96,Verschiedene Waren,391423000,354192000,745615000
2022,11,WA97,"Kunstgegenstände, Sammlungsstücke",102598000,50250000,152848000
2022,11,WA98,Vollständige Fabrikationsanlagen,39979000,0,39979000
2022,11,WA99,Zusammenstellungen verschiedener Waren,1541404000,1107477000,2648881000
2022,12,WA01,Lebende Tiere,128042000,122975000,251017000
2022,12,WA02,Fleisch,655635000,690715000,1346350000
2022,12,WA03,"Fische, Krebs- und Weichtiere",157103000,445505000,602608000
2022,12,WA04,"Milch, Milcherzeugnisse, Eier, Honig",1086759000,1028732000,2115491000
2022,12,WA05,Andere Waren tierischen Ursprungs,79736000,110408000,190144000
2022,12,WA06,"Pflanzen, Waren des Blumenhandels",54631000,210834000,265465000
2022,12,WA07,"Gemüse, Pflanzen für Ernährung",107651000,648401000,756052000
2022,12,WA08,Genießbare Früchte und Nüsse,165500000,859709000,1025209000
2022,12,WA09,"Kaffee, Tee, Mate, Gewürze",322402000,467260000,789662000
2022,12,WA10,Getreide,230466000,341832000,572298000
2022,12,WA11,"Müllereierzeugnisse, Malz usw.",190891000,84532000,275423000
2022,12,WA12,"Ölsamen usw., Heilpflanzen usw.",136144000,700313000,836457000
2022,12,WA13,"Schellack, Gummen, Harz, Pflanzensaft",60015000,53370000,113385000
2022,12,WA14,Flechtstoffe usw. pflanzlichen Ursprungs,681000,4390000,5071000
2022,12,WA15,"Tierische und pflanzliche Fette, Öle, Wachs",377436000,494268000,871704000
2022,12,WA16,"Zubereitungen von Fleisch, Fisch usw.",306723000,333689000,640412000
2022,12,WA17,Zucker und Zuckerwaren,288331000,171750000,460081000
2022,12,WA18,Kakao und Zubereitungen aus Kakao,545381000,411734000,957115000
2022,12,WA19,"Zubereitungen aus Getreide usw., Backwaren",690978000,510025000,1201003000
2022,12,WA20,"Zubereitungen von Gemüse, Früchten usw.",275255000,529410000,804665000
2022,12,WA21,Verschiedene Lebensmittelzubereitungen,603340000,390751000,994091000
2022,12,WA22,"Getränke, alkoholhaltige Flüssigkeiten, Essig",514209000,749515000,1263724000
2022,12,WA23,"Rückstände der Lebensmittelindustrie, Futter",603007000,545754000,1148761000
2022,12,WA24,Tabak,215160000,360731000,575891000
2022,12,WA25,"Salz, Schwefel, Steine, Erden usw.",172380000,168047000,340427000
2022,12,WA26,"Erze, Schlacken, Aschen",88185000,801746000,889931000
2022,12,WA27,Mineralische Brennstoffe usw.,4862220000,14890407000,19752627000
2022,12,WA28,Anorganische chemische Erzeugnisse,1205787000,884375000,2090162000
2022,12,WA29,Organische chemische Erzeugnisse,2238960000,3577871000,5816831000
2022,12,WA30,Pharmazeutische Erzeugnisse,8938203000,6015822000,14954025000
2022,12,WA31,Düngemittel,410920000,183323000,594243000
2022,12,WA32,"Gerb- und Farbstoffe, Farben, Lacke usw.",778825000,415440000,1194265000
2022,12,WA33,"Etherische Öle, Riech-, Schönheitsmittel",920062000,690203000,1610265000
2022,12,WA34,"Seifen, Waschmittel usw.",668591000,427572000,1096163000
2022,12,WA35,"Eiweißstoffe, Klebstoffe, Enzyme",342138000,245229000,587367000
2022,12,WA36,"Sprengstoffe, pyrotechnische Artikel usw.",53780000,15531000,69311000
2022,12,WA37,Photochemische Erzeugnisse,91690000,54421000,146111000
2022,12,WA38,Verschiedene Erzeugnisse der Chemischen Industrie,2711082000,1753261000,4464343000
2022,12,WA39,Kunststoffe und Waren daraus,4752307000,3452859000,8205166000
2022,12,WA40,Kautschuk und Waren daraus,1173796000,1004173000,2177969000
2022,12,WA41,"Häute, Felle, Leder",51544000,37639000,89183000
2022,12,WA42,"Lederwaren, Sattlerwaren",227180000,405342000,632522000
2022,12,WA43,"Pelzfelle, künstliches Pelzwerk",7260000,7503000,14763000
2022,12,WA44,"Holz, Holzwaren, Holzkohle",812174000,648619000,1460793000
2022,12,WA45,"Kork, Korkwaren",2042000,7328000,9370000
2022,12,WA46,"Flechtwaren, Korbmacherwaren",4793000,12514000,17307000
2022,12,WA47,"Halbstoffe aus Holz usw., Papierabfall",109482000,329721000,439203000
2022,12,WA48,"Papier, Pappe und Waren daraus",1697057000,1132615000,2829672000
2022,12,WA49,"Bücher, Zeitungen, Bilddrucke usw.",319105000,287872000,606977000
2022,12,WA50,Seide,2055000,2459000,4514000
2022,12,WA51,"Wolle, feine und grobe Tierhaare",33910000,40198000,74108000
2022,12,WA52,Baumwolle,53793000,53530000,107323000
2022,12,WA53,"Andere pflanzliche Spinnstoffe, Papiergarn",5374000,6586000,11960000
2022,12,WA54,Synthetisches oder künstliches Filament,115215000,88760000,203975000
2022,12,WA55,Synthetische oder künstliche Spinnfaser,116423000,100952000,217375000
2022,12,WA56,"Watte, Filz, Vliesstoff usw., Tauwerk",188515000,126470000,314985000
2022,12,WA57,"Teppiche, Fußbodenbelag aus Spinnstoff",50943000,97870000,148813000
2022,12,WA58,"Spezialgewebe, Spitzen, Tapisserien",36561000,19072000,55633000
2022,12,WA59,"Getränkte, bestrichene usw. Gewebe",179982000,88512000,268494000
2022,12,WA60,Gewirke und Gestricke,47035000,31834000,78869000
2022,12,WA61,"Bekleidung usw. aus Gewirken, Gestricken",1074731000,1877023000,2951754000
2022,12,WA62,"Andere Bekleidung, Bekleidungszubehör",935045000,1568285000,2503330000
2022,12,WA63,"Andere Konfektion, Spinnstoffwaren usw.",258651000,396802000,655453000
2022,12,WA64,"Schuhe, Gamaschen, ähnliche Waren",792245000,1163771000,1956016000
2022,12,WA65,Kopfbedeckungen und Teile davon,61070000,86898000,147968000
2022,12,WA66,"Schirme, Gehstöcke usw., Peitschen",7818000,15549000,23367000
2022,12,WA67,"Zugerichtete Federn, Daunen, künstliche Blumen",12383000,25052000,37435000
2022,12,WA68,"Waren aus Steinen, Gips, Zement usw.",373602000,256125000,629727000
2022,12,WA69,Keramische Waren,320605000,268884000,589489000
2022,12,WA70,Glas und Glaswaren,574666000,404718000,979384000
2022,12,WA71,"Perlen, Edelsteine, Edelmetalle",1588280000,2229084000,3817364000
2022,12,WA72,Eisen und Stahl,2103445000,1969397000,4072842000
2022,12,WA73,Waren aus Eisen oder Stahl,2194955000,2044857000,4239812000
2022,12,WA74,Kupfer und Waren daraus,917512000,992661000,1910173000
2022,12,WA75,Nickel und Waren daraus,136778000,177183000,313961000
2022,12,WA76,Aluminium und Waren daraus,1253844000,1375702000,2629546000
2022,12,WA78,Blei und Waren daraus,27048000,53803000,80851000
2022,12,WA79,Zink und Waren daraus,55213000,115829000,171042000
2022,12,WA80,Zinn und Waren daraus,8759000,35094000,43853000
2022,12,WA81,"Andere unedle Metalle, Cermets usw.",138768000,172344000,311112000
2022,12,WA82,"Werkzeuge, Schneidwaren, Essbestecke",669195000,469270000,1138465000
2022,12,WA83,Verschiedene Waren aus unedlen Metallen,538082000,390983000,929065000
2022,12,WA84,"Maschinen, Apparate, mechanische Geräte",21026663000,13240261000,34266924000
2022,12,WA85,Elektrotechnische Erzeugnisse,14070618000,16485210000,30555828000
2022,12,WA86,Schienenfahrzeuge,311772000,270066000,581838000
2022,12,WA87,"Kraftfahrzeuge, Landfahrzeuge",19964986000,11108656000,31073642000
2022,12,WA88,"Luftfahrzeuge, Raumfahrzeuge",4121665000,1044678000,5166343000
2022,12,WA89,Wasserfahrzeuge,96906000,280775000,377681000
2022,12,WA90,"Optische, photografische usw. Erzeugnisse",6525719000,3798902000,10324621000
2022,12,WA91,Uhrmacherwaren,148609000,221177000,369786000
2022,12,WA92,Musikinstrumente,104184000,74336000,178520000
2022,12,WA93,Waffen und Munition,60291000,28489000,88780000
2022,12,WA94,"Möbel, Beleuchtungskörper usw.",1344701000,1697032000,3041733000
2022,12,WA95,"Spielzeug, Spiele usw., Sportgeräte",433411000,770097000,1203508000
2022,12,WA96,Verschiedene Waren,342674000,303589000,646263000
2022,12,WA97,"Kunstgegenstände, Sammlungsstücke",77692000,66309000,144001000
2022,12,WA98,Vollständige Fabrikationsanlagen,33647000,0,33647000
2022,12,WA99,Zusammenstellungen verschiedener Waren,1421460000,1021155000,2442615000
2023,1,WA01,Lebende Tiere,130301000,131947000,262248000
2023,1,WA02,Fleisch,604204000,577406000,1181610000
2023,1,WA03,"Fische, Krebs- und Weichtiere",125470000,370506000,495976000
2023,1,WA04,"Milch, Milcherzeugnisse, Eier, Honig",1100615000,945081000,2045696000
2023,1,WA05,Andere Waren tierischen Ursprungs,83605000,107257000,190862000
2023,1,WA06,"Pflanzen, Waren des Blumenhandels",51830000,235114000,286944000
2023,1,WA07,"Gemüse, Pflanzen für Ernährung",107488000,702161000,809649000
2023,1,WA08,Genießbare Früchte und Nüsse,168430000,891537000,1059967000
2023,1,WA09,"Kaffee, Tee, Mate, Gewürze",315529000,466722000,782251000
2023,1,WA10,Getreide,256735000,386203000,642938000
2023,1,WA11,"Müllereierzeugnisse, Malz usw.",218008000,89960000,307968000
2023,1,WA12,"Ölsamen usw., Heilpflanzen usw.",192446000,679952000,872398000
2023,1,WA13,"Schellack, Gummen, Harz, Pflanzensaft",60435000,55729000,116164000
2023,1,WA14,Flechtstoffe usw. pflanzlichen Ursprungs,1585000,3808000,5393000
2023,1,WA15,"Tierische und pflanzliche Fette, Öle, Wachs",397270000,445281000,842551000
2023,1,WA16,"Zubereitungen von Fleisch, Fisch usw.",302591000,288866000,591457000
2023,1,WA17,Zucker und Zuckerwaren,306104000,204169000,510273000
2023,1,WA18,Kakao und Zubereitungen aus Kakao,583880000,428255000,1012135000
2023,1,WA19,"Zubereitungen aus Getreide usw., Backwaren",732884000,506582000,1239466000
2023,1,WA20,"Zubereitungen von Gemüse, Früchten usw.",268504000,512238000,780742000
2023,1,WA21,Verschiedene Lebensmittelzubereitungen,677904000,414999000,1092903000
2023,1,WA22,"Getränke, alkoholhaltige Flüssigkeiten, Essig",538572000,659428000,1198000000
2023,1,WA23,"Rückstände der Lebensmittelindustrie, Futter",644638000,505345000,1149983000
2023,1,WA24,Tabak,260721000,379984000,640705000
2023,1,WA25,"Salz, Schwefel, Steine, Erden usw.",190453000,180350000,370803000
2023,1,WA26,"Erze, Schlacken, Aschen",84972000,938321000,1023293000
2023,1,WA27,Mineralische Brennstoffe usw.,3614858000,13490572000,17105430000
2023,1,WA28,Anorganische chemische Erzeugnisse,1321687000,748445000,2070132000
2023,1,WA29,Organische chemische Erzeugnisse,2516411000,4489565000,7005976000
2023,1,WA30,Pharmazeutische Erzeugnisse,10091381000,5414648000,15506029000
2023,1,WA31,Düngemittel,381440000,191983000,573423000
2023,1,WA32,"Gerb- und Farbstoffe, Farben, Lacke usw.",998022000,517358000,1515380000
2023,1,WA33,"Etherische Öle, Riech-, Schönheitsmittel",998330000,712168000,1710498000
2023,1,WA34,"Seifen, Waschmittel usw.",773625000,445758000,1219383000
2023,1,WA35,"Eiweißstoffe, Klebstoffe, Enzyme",400293000,251258000,651551000
2023,1,WA36,"Sprengstoffe, pyrotechnische Artikel usw.",27983000,15315000,43298000
2023,1,WA37,Photochemische Erzeugnisse,87343000,49506000,136849000
2023,1,WA38,Verschiedene Erzeugnisse der Chemischen Industrie,3147759000,1793936000,4941695000
2023,1,WA39,Kunststoffe und Waren daraus,6109030000,3989463000,10098493000
2023,1,WA40,Kautschuk und Waren daraus,1395797000,1250565000,2646362000
2023,1,WA41,"Häute, Felle, Leder",49551000,38087000,87638000
2023,1,WA42,"Lederwaren, Sattlerwaren",242373000,406276000,648649000
2023,1,WA43,"Pelzfelle, künstliches Pelzwerk",4880000,5874000,10754000
2023,1,WA44,"Holz, Holzwaren, Holzkohle",907875000,742489000,1650364000
2023,1,WA45,"Kork, Korkwaren",1920000,5219000,7139000
2023,1,WA46,"Flechtwaren, Korbmacherwaren",6543000,13566000,20109000
2023,1,WA47,"Halbstoffe aus Holz usw., Papierabfall",120539000,322598000,443137000
2023,1,WA48,"Papier, Pappe und Waren daraus",1867606000,1220863000,3088469000
2023,1,WA49,"Bücher, Zeitungen, Bilddrucke usw.",281474000,238350000,519824000
2023,1,WA50,Seide,2202000,2336000,4538000
2023,1,WA51,"Wolle, feine und grobe Tierhaare",49032000,52106000,101138000
2023,1,WA52,Baumwolle,65626000,64306000,129932000
2023,1,WA53,"Andere pflanzliche Spinnstoffe, Papiergarn",6757000,7680000,14437000
2023,1,WA54,Synthetisches oder künstliches Filament,144367000,124152000,268519000
2023,1,WA55,Synthetische oder künstliche Spinnfaser,141203000,126387000,267590000
2023,1,WA56,"Watte, Filz, Vliesstoff usw., Tauwerk",228857000,154308000,383165000
2023,1,WA57,"Teppiche, Fußbodenbelag aus Spinnstoff",50956000,101278000,152234000
2023,1,WA58,"Spezialgewebe, Spitzen, Tapisserien",46783000,22862000,69645000
2023,1,WA59,"Getränkte, bestrichene usw. Gewebe",227532000,117632000,345164000
2023,1,WA60,Gewirke und Gestricke,60827000,39268000,100095000
2023,1,WA61,"Bekleidung usw. aus Gewirken, Gestricken",1157605000,1934633000,3092238000
2023,1,WA62,"Andere Bekleidung, Bekleidungszubehör",1106608000,1761333000,2867941000
2023,1,WA63,"Andere Konfektion, Spinnstoffwaren usw.",262661000,414962000,677623000
2023,1,WA64,"Schuhe, Gamaschen, ähnliche Waren",928521000,1271129000,2199650000
2023,1,WA65,Kopfbedeckungen und Teile davon,62884000,83976000,146860000
2023,1,WA66,"Schirme, Gehstöcke usw., Peitschen",7070000,26584000,33654000
2023,1,WA67,"Zugerichtete Federn, Daunen, künstliche Blumen",15794000,23639000,39433000
2023,1,WA68,"Waren aus Steinen, Gips, Zement usw.",446250000,300200000,746450000
2023,1,WA69,Keramische Waren,333079000,259235000,592314000
2023,1,WA70,Glas und Glaswaren,699214000,486691000,1185905000
2023,1,WA71,"Perlen, Edelsteine, Edelmetalle",1733612000,2197415000,3931027000
2023,1,WA72,Eisen und Stahl,2797147000,2703913000,5501060000
2023,1,WA73,Waren aus Eisen oder Stahl,2836470000,2342882000,5179352000
2023,1,WA74,Kupfer und Waren daraus,1215935000,969875000,2185810000
2023,1,WA75,Nickel und Waren daraus,136181000,233124000,369305000
2023,1,WA76,Aluminium und Waren daraus,1574755000,1774399000,3349154000
2023,1,WA78,Blei und Waren daraus,27577000,51381000,78958000
2023,1,WA79,Zink und Waren daraus,69029000,147636000,216665000
2023,1,WA80,Zinn und Waren daraus,18607000,35177000,53784000
2023,1,WA81,"Andere unedle Metalle, Cermets usw.",155925000,186161000,342086000
2023,1,WA82,"Werkzeuge, Schneidwaren, Essbestecke",796950000,506278000,1303228000
2023,1,WA83,Verschiedene Waren aus unedlen Metallen,742747000,469748000,1212495000
2023,1,WA84,"Maschinen, Apparate, mechanische Geräte",20035380000,13649380000,33684760000
2023,1,WA85,Elektrotechnische Erzeugnisse,14996077000,17310183000,32306260000
2023,1,WA86,Schienenfahrzeuge,232293000,275721000,508014000
2023,1,WA87,"Kraftfahrzeuge, Landfahrzeuge",20443009000,10982084000,31425093000
2023,1,WA88,"Luftfahrzeuge, Raumfahrzeuge",1523994000,1430574000,2954568000
2023,1,WA89,Wasserfahrzeuge,240298000,290437000,530735000
2023,1,WA90,"Optische, photografische usw. Erzeugnisse",5831263000,3723888000,9555151000
2023,1,WA91,Uhrmacherwaren,142435000,195249000,337684000
2023,1,WA92,Musikinstrumente,80342000,61973000,142315000
2023,1,WA93,Waffen und Munition,50251000,27715000,77966000
2023,1,WA94,"Möbel, Beleuchtungskörper usw.",1417867000,1837082000,3254949000
2023,1,WA95,"Spielzeug, Spiele usw., Sportgeräte",358469000,615635000,974104000
2023,1,WA96,Verschiedene Waren,354367000,292041000,646408000
2023,1,WA97,"Kunstgegenstände, Sammlungsstücke",74604000,62767000,137371000
2023,1,WA98,Vollständige Fabrikationsanlagen,72270000,0,72270000
2023,1,WA99,Zusammenstellungen verschiedener Waren,1193622000,1035551000,2229173000
2023,2,WA01,Lebende Tiere,102991000,143282000,246273000
2023,2,WA02,Fleisch,556165000,594407000,1150572000
2023,2,WA03,"Fische, Krebs- und Weichtiere",123895000,366012000,489907000
2023,2,WA04,"Milch, Milcherzeugnisse, Eier, Honig",1042972000,914955000,1957927000
2023,2,WA05,Andere Waren tierischen Ursprungs,76109000,105470000,181579000
2023,2,WA06,"Pflanzen, Waren des Blumenhandels",83256000,294805000,378061000
2023,2,WA07,"Gemüse, Pflanzen für Ernährung",121714000,801519000,923233000
2023,2,WA08,Genießbare Früchte und Nüsse,168403000,880339000,1048742000
2023,2,WA09,"Kaffee, Tee, Mate, Gewürze",291824000,431148000,722972000
2023,2,WA10,Getreide,326223000,386731000,712954000
2023,2,WA11,"Müllereierzeugnisse, Malz usw.",209222000,86237000,295459000
2023,2,WA12,"Ölsamen usw., Heilpflanzen usw.",224036000,790638000,1014674000
2023,2,WA13,"Schellack, Gummen, Harz, Pflanzensaft",60354000,60420000,120774000
2023,2,WA14,Flechtstoffe usw. pflanzlichen Ursprungs,1081000,4589000,5670000
2023,2,WA15,"Tierische und pflanzliche Fette, Öle, Wachs",383711000,463235000,846946000
2023,2,WA16,"Zubereitungen von Fleisch, Fisch usw.",285041000,295385000,580426000
2023,2,WA17,Zucker und Zuckerwaren,287935000,204830000,492765000
2023,2,WA18,Kakao und Zubereitungen aus Kakao,577244000,450481000,1027725000
2023,2,WA19,"Zubereitungen aus Getreide usw., Backwaren",712727000,537968000,1250695000
2023,2,WA20,"Zubereitungen von Gemüse, Früchten usw.",259880000,490048000,749928000
2023,2,WA21,Verschiedene Lebensmittelzubereitungen,677323000,413220000,1090543000
2023,2,WA22,"Getränke, alkoholhaltige Flüssigkeiten, Essig",544042000,650581000,1194623000
2023,2,WA23,"Rückstände der Lebensmittelindustrie, Futter",562193000,455419000,1017612000
2023,2,WA24,Tabak,238943000,355595000,594538000
2023,2,WA25,"Salz, Schwefel, Steine, Erden usw.",200083000,188251000,388334000
2023,2,WA26,"Erze, Schlacken, Aschen",109256000,897209000,1006465000
2023,2,WA27,Mineralische Brennstoffe usw.,3141310000,10310654000,13451964000
2023,2,WA28,Anorganische chemische Erzeugnisse,1217693000,806169000,2023862000
2023,2,WA29,Organische chemische Erzeugnisse,2590827000,4521436000,7112263000
2023,2,WA30,Pharmazeutische Erzeugnisse,10071441000,5499377000,15570818000
2023,2,WA31,Düngemittel,341365000,189494000,530859000
2023,2,WA32,"Gerb- und Farbstoffe, Farben, Lacke usw.",1001354000,481106000,1482460000
2023,2,WA33,"Etherische Öle, Riech-, Schönheitsmittel",1004304000,674865000,1679169000
2023,2,WA34,"Seifen, Waschmittel usw.",731284000,423878000,1155162000
2023,2,WA35,"Eiweißstoffe, Klebstoffe, Enzyme",393594000,248917000,642511000
2023,2,WA36,"Sprengstoffe, pyrotechnische Artikel usw.",29257000,16666000,45923000
2023,2,WA37,Photochemische Erzeugnisse,79232000,49935000,129167000
2023,2,WA38,Verschiedene Erzeugnisse der Chemischen Industrie,3009485000,1769122000,4778607000
2023,2,WA39,Kunststoffe und Waren daraus,5893951000,4004329000,9898280000
2023,2,WA40,Kautschuk und Waren daraus,1416496000,1319540000,2736036000
2023,2,WA41,"Häute, Felle, Leder",45397000,40788000,86185000
2023,2,WA42,"Lederwaren, Sattlerwaren",237425000,370299000,607724000
2023,2,WA43,"Pelzfelle, künstliches Pelzwerk",3549000,3852000,7401000
2023,2,WA44,"Holz, Holzwaren, Holzkohle",917696000,771648000,1689344000
2023,2,WA45,"Kork, Korkwaren",2327000,8571000,10898000
2023,2,WA46,"Flechtwaren, Korbmacherwaren",5820000,12197000,18017000
2023,2,WA47,"Halbstoffe aus Holz usw., Papierabfall",127157000,339806000,466963000
2023,2,WA48,"Papier, Pappe und Waren daraus",1753594000,1113603000,2867197000
2023,2,WA49,"Bücher, Zeitungen, Bilddrucke usw.",291102000,217988000,509090000
2023,2,WA50,Seide,2244000,1992000,4236000
2023,2,WA51,"Wolle, feine und grobe Tierhaare",46105000,48458000,94563000
2023,2,WA52,Baumwolle,60865000,56316000,117181000
2023,2,WA53,"Andere pflanzliche Spinnstoffe, Papiergarn",5008000,6227000,11235000
2023,2,WA54,Synthetisches oder künstliches Filament,129812000,117052000,246864000
2023,2,WA55,Synthetische oder künstliche Spinnfaser,144043000,114266000,258309000
2023,2,WA56,"Watte, Filz, Vliesstoff usw., Tauwerk",224340000,147850000,372190000
2023,2,WA57,"Teppiche, Fußbodenbelag aus Spinnstoff",49777000,87564000,137341000
2023,2,WA58,"Spezialgewebe, Spitzen, Tapisserien",46755000,22531000,69286000
2023,2,WA59,"Getränkte, bestrichene usw. Gewebe",227101000,112107000,339208000
2023,2,WA60,Gewirke und Gestricke,58872000,39323000,98195000
2023,2,WA61,"Bekleidung usw. aus Gewirken, Gestricken",1022383000,1672636000,2695019000
2023,2,WA62,"Andere Bekleidung, Bekleidungszubehör",1058597000,1625533000,2684130000
2023,2,WA63,"Andere Konfektion, Spinnstoffwaren usw.",256177000,356658000,612835000
2023,2,WA64,"Schuhe, Gamaschen, ähnliche Waren",861481000,1165481000,2026962000
2023,2,WA65,Kopfbedeckungen und Teile davon,62163000,72874000,135037000
2023,2,WA66,"Schirme, Gehstöcke usw., Peitschen",7641000,25901000,33542000
2023,2,WA67,"Zugerichtete Federn, Daunen, künstliche Blumen",15835000,19074000,34909000
2023,2,WA68,"Waren aus Steinen, Gips, Zement usw.",462095000,305216000,767311000
2023,2,WA69,Keramische Waren,336483000,256942000,593425000
2023,2,WA70,Glas und Glaswaren,671110000,513644000,1184754000
2023,2,WA71,"Perlen, Edelsteine, Edelmetalle",1671119000,1969998000,3641117000
2023,2,WA72,Eisen und Stahl,2774557000,2599713000,5374270000
2023,2,WA73,Waren aus Eisen oder Stahl,2796709000,2395666000,5192375000
2023,2,WA74,Kupfer und Waren daraus,1195428000,1051311000,2246739000
2023,2,WA75,Nickel und Waren daraus,209167000,195073000,404240000
2023,2,WA76,Aluminium und Waren daraus,1585488000,1775813000,3361301000
2023,2,WA78,Blei und Waren daraus,38775000,57398000,96173000
2023,2,WA79,Zink und Waren daraus,55453000,166241000,221694000
2023,2,WA80,Zinn und Waren daraus,11913000,41144000,53057000
2023,2,WA81,"Andere unedle Metalle, Cermets usw.",140730000,169410000,310140000
2023,2,WA82,"Werkzeuge, Schneidwaren, Essbestecke",779879000,484217000,1264096000
2023,2,WA83,Verschiedene Waren aus unedlen Metallen,685611000,467380000,1152991000
2023,2,WA84,"Maschinen, Apparate, mechanische Geräte",20812259000,13406136000,34218395000
2023,2,WA85,Elektrotechnische Erzeugnisse,14342956000,16587896000,30930852000
2023,2,WA86,Schienenfahrzeuge,231805000,264892000,496697000
2023,2,WA87,"Kraftfahrzeuge, Landfahrzeuge",23890745000,11598524000,35489269000
2023,2,WA88,"Luftfahrzeuge, Raumfahrzeuge",2417500000,927256000,3344756000
2023,2,WA89,Wasserfahrzeuge,268107000,500614000,768721000
2023,2,WA90,"Optische, photografische usw. Erzeugnisse",6140561000,3594705000,9735266000
2023,2,WA91,Uhrmacherwaren,143321000,194848000,338169000
2023,2,WA92,Musikinstrumente,77781000,62451000,140232000
2023,2,WA93,Waffen und Munition,54763000,30223000,84986000
2023,2,WA94,"Möbel, Beleuchtungskörper usw.",1451795000,1863066000,3314861000
2023,2,WA95,"Spielzeug, Spiele usw., Sportgeräte",387928000,628045000,1015973000
2023,2,WA96,Verschiedene Waren,342146000,285993000,628139000
2023,2,WA97,"Kunstgegenstände, Sammlungsstücke",76498000,64342000,140840000
2023,2,WA98,Vollständige Fabrikationsanlagen,49879000,754000,50633000
2023,2,WA99,Zusammenstellungen verschiedener Waren,1144004000,892697000,2036701000
2023,3,WA01,Lebende Tiere,126502000,165518000,292020000
2023,3,WA02,Fleisch,684088000,722030000,1406118000
2023,3,WA03,"Fische, Krebs- und Weichtiere",136838000,412761000,549599000
2023,3,WA04,"Milch, Milcherzeugnisse, Eier, Honig",1201594000,1098055000,2299649000
2023,3,WA05,Andere Waren tierischen Ursprungs,93714000,114509000,208223000
2023,3,WA06,"Pflanzen, Waren des Blumenhandels",119678000,376474000,496152000
2023,3,WA07,"Gemüse, Pflanzen für Ernährung",158267000,943820000,1102087000
2023,3,WA08,Genießbare Früchte und Nüsse,190986000,982977000,1173963000
2023,3,WA09,"Kaffee, Tee, Mate, Gewürze",342415000,474102000,816517000
2023,3,WA10,Getreide,331014000,417394000,748408000
2023,3,WA11,"Müllereierzeugnisse, Malz usw.",245312000,104160000,349472000
2023,3,WA12,"Ölsamen usw., Heilpflanzen usw.",247712000,730801000,978513000
2023,3,WA13,"Schellack, Gummen, Harz, Pflanzensaft",71172000,69273000,140445000
2023,3,WA14,Flechtstoffe usw. pflanzlichen Ursprungs,1199000,4702000,5901000
2023,3,WA15,"Tierische und pflanzliche Fette, Öle, Wachs",415447000,498520000,913967000
2023,3,WA16,"Zubereitungen von Fleisch, Fisch usw.",335763000,338712000,674475000
2023,3,WA17,Zucker und Zuckerwaren,329631000,239285000,568916000
2023,3,WA18,Kakao und Zubereitungen aus Kakao,582102000,485702000,1067804000
2023,3,WA19,"Zubereitungen aus Getreide usw., Backwaren",853016000,596331000,1449347000
2023,3,WA20,"Zubereitungen von Gemüse, Früchten usw.",309059000,589954000,899013000
2023,3,WA21,Verschiedene Lebensmittelzubereitungen,781416000,573472000,1354888000
2023,3,WA22,"Getränke, alkoholhaltige Flüssigkeiten, Essig",671799000,812610000,1484409000
2023,3,WA23,"Rückstände der Lebensmittelindustrie, Futter",653904000,496300000,1150204000
2023,3,WA24,Tabak,281378000,465474000,746852000
2023,3,WA25,"Salz, Schwefel, Steine, Erden usw.",232875000,198406000,431281000
2023,3,WA26,"Erze, Schlacken, Aschen",67428000,1149296000,1216724000
2023,3,WA27,Mineralische Brennstoffe usw.,3198682000,10961781000,14160463000
2023,3,WA28,Anorganische chemische Erzeugnisse,1417129000,859288000,2276417000
2023,3,WA29,Organische chemische Erzeugnisse,2742441000,3325049000,6067490000
2023,3,WA30,Pharmazeutische Erzeugnisse,10244274000,6515061000,16759335000
2023,3,WA31,Düngemittel,356310000,181124000,537434000
2023,3,WA32,"Gerb- und Farbstoffe, Farben, Lacke usw.",1126057000,558659000,1684716000
2023,3,WA33,"Etherische Öle, Riech-, Schönheitsmittel",1175831000,771625000,1947456000
2023,3,WA34,"Seifen, Waschmittel usw.",855508000,500914000,1356422000
2023,3,WA35,"Eiweißstoffe, Klebstoffe, Enzyme",446362000,281735000,728097000
2023,3,WA36,"Sprengstoffe, pyrotechnische Artikel usw.",38420000,16290000,54710000
2023,3,WA37,Photochemische Erzeugnisse,91220000,46705000,137925000
2023,3,WA38,Verschiedene Erzeugnisse der Chemischen Industrie,3330755000,2063057000,5393812000
2023,3,WA39,Kunststoffe und Waren daraus,6720034000,4483977000,11204011000
2023,3,WA40,Kautschuk und Waren daraus,1657134000,1547428000,3204562000
2023,3,WA41,"Häute, Felle, Leder",55289000,47795000,103084000
2023,3,WA42,"Lederwaren, Sattlerwaren",264500000,380630000,645130000
2023,3,WA43,"Pelzfelle, künstliches Pelzwerk",3900000,4229000,8129000
2023,3,WA44,"Holz, Holzwaren, Holzkohle",1049999000,876922000,1926921000
2023,3,WA45,"Kork, Korkwaren",2600000,8201000,10801000
2023,3,WA46,"Flechtwaren, Korbmacherwaren",7279000,13437000,20716000
2023,3,WA47,"Halbstoffe aus Holz usw., Papierabfall",127474000,368169000,495643000
2023,3,WA48,"Papier, Pappe und Waren daraus",1938163000,1274681000,3212844000
2023,3,WA49,"Bücher, Zeitungen, Bilddrucke usw.",324727000,252736000,577463000
2023,3,WA50,Seide,2677000,3092000,5769000
2023,3,WA51,"Wolle, feine und grobe Tierhaare",45376000,50239000,95615000
2023,3,WA52,Baumwolle,66026000,65923000,131949000
2023,3,WA53,"Andere pflanzliche Spinnstoffe, Papiergarn",3682000,5834000,9516000
2023,3,WA54,Synthetisches oder künstliches Filament,152860000,137431000,290291000
2023,3,WA55,Synthetische oder künstliche Spinnfaser,148291000,132400000,280691000
2023,3,WA56,"Watte, Filz, Vliesstoff usw., Tauwerk",249546000,170601000,420147000
2023,3,WA57,"Teppiche, Fußbodenbelag aus Spinnstoff",54678000,101526000,156204000
2023,3,WA58,"Spezialgewebe, Spitzen, Tapisserien",51702000,25542000,77244000
2023,3,WA59,"Getränkte, bestrichene usw. Gewebe",263516000,132596000,396112000
2023,3,WA60,Gewirke und Gestricke,67936000,48095000,116031000
2023,3,WA61,"Bekleidung usw. aus Gewirken, Gestricken",1135191000,1763955000,2899146000
2023,3,WA62,"Andere Bekleidung, Bekleidungszubehör",1211218000,1765502000,2976720000
2023,3,WA63,"Andere Konfektion, Spinnstoffwaren usw.",295759000,379851000,675610000
2023,3,WA64,"Schuhe, Gamaschen, ähnliche Waren",988370000,1140184000,2128554000
2023,3,WA65,Kopfbedeckungen und Teile davon,70671000,81413000,152084000
2023,3,WA66,"Schirme, Gehstöcke usw., Peitschen",8762000,25289000,34051000
2023,3,WA67,"Zugerichtete Federn, Daunen, künstliche Blumen",15518000,17770000,33288000
2023,3,WA68,"Waren aus Steinen, Gips, Zement usw.",526028000,344340000,870368000
2023,3,WA69,Keramische Waren,392547000,294622000,687169000
2023,3,WA70,Glas und Glaswaren,779920000,571002000,1350922000
2023,3,WA71,"Perlen, Edelsteine, Edelmetalle",2074027000,2105143000,4179170000
2023,3,WA72,Eisen und Stahl,2998646000,2974600000,5973246000
2023,3,WA73,Waren aus Eisen oder Stahl,3422626000,2717528000,6140154000
2023,3,WA74,Kupfer und Waren daraus,1443783000,1113346000,2557129000
2023,3,WA75,Nickel und Waren daraus,220568000,260614000,481182000
2023,3,WA76,Aluminium und Waren daraus,1789988000,2077406000,3867394000
2023,3,WA78,Blei und Waren daraus,33843000,72669000,106512000
2023,3,WA79,Zink und Waren daraus,74054000,173263000,247317000
2023,3,WA80,Zinn und Waren daraus,13456000,42768000,56224000
2023,3,WA81,"Andere unedle Metalle, Cermets usw.",184798000,201741000,386539000
2023,3,WA82,"Werkzeuge, Schneidwaren, Essbestecke",922573000,525699000,1448272000
2023,3,WA83,Verschiedene Waren aus unedlen Metallen,794922000,505431000,1300353000
2023,3,WA84,"Maschinen, Apparate, mechanische Geräte",25095986000,15552858000,40648844000
2023,3,WA85,Elektrotechnische Erzeugnisse,16801373000,18495538000,35296911000
2023,3,WA86,Schienenfahrzeuge,275540000,319760000,595300000
2023,3,WA87,"Kraftfahrzeuge, Landfahrzeuge",25903403000,14394133000,40297536000
2023,3,WA88,"Luftfahrzeuge, Raumfahrzeuge",3037653000,1241507000,4279160000
2023,3,WA89,Wasserfahrzeuge,842876000,804778000,1647654000
2023,3,WA90,"Optische, photografische usw. Erzeugnisse",7688732000,4307701000,11996433000
2023,3,WA91,Uhrmacherwaren,157208000,230495000,387703000
2023,3,WA92,Musikinstrumente,91862000,63219000,155081000
2023,3,WA93,Waffen und Munition,64435000,35358000,99793000
2023,3,WA94,"Möbel, Beleuchtungskörper usw.",1667510000,1997827000,3665337000
2023,3,WA95,"Spielzeug, Spiele usw., Sportgeräte",472234000,725578000,1197812000
2023,3,WA96,Verschiedene Waren,400394000,303595000,703989000
2023,3,WA97,"Kunstgegenstände, Sammlungsstücke",69228000,69246000,138474000
2023,3,WA98,Vollständige Fabrikationsanlagen,89319000,0,89319000
2023,3,WA99,Zusammenstellungen verschiedener Waren,2071756000,1055523000,3127279000
2023,4,WA01,Lebende Tiere,117088000,141390000,258478000
2023,4,WA02,Fleisch,576201000,602600000,1178801000
2023,4,WA03,"Fische, Krebs- und Weichtiere",112723000,339155000,451878000
2023,4,WA04,"Milch, Milcherzeugnisse, Eier, Honig",1003147000,847201000,1850348000
2023,4,WA05,Andere Waren tierischen Ursprungs,78201000,93484000,171685000
2023,4,WA06,"Pflanzen, Waren des Blumenhandels",112601000,351936000,464537000
2023,4,WA07,"Gemüse, Pflanzen für Ernährung",124643000,801190000,925833000
2023,4,WA08,Genießbare Früchte und Nüsse,171964000,893220000,1065184000
2023,4,WA09,"Kaffee, Tee, Mate, Gewürze",283245000,408412000,691657000
2023,4,WA10,Getreide,312255000,300839000,613094000
2023,4,WA11,"Müllereierzeugnisse, Malz usw.",190823000,82364000,273187000
2023,4,WA12,"Ölsamen usw., Heilpflanzen usw.",133437000,634853000,768290000
2023,4,WA13,"Schellack, Gummen, Harz, Pflanzensaft",55466000,53335000,108801000
2023,4,WA14,Flechtstoffe usw. pflanzlichen Ursprungs,1074000,4014000,5088000
2023,4,WA15,"Tierische und pflanzliche Fette, Öle, Wachs",329232000,411561000,740793000
2023,4,WA16,"Zubereitungen von Fleisch, Fisch usw.",287267000,285267000,572534000
2023,4,WA17,Zucker und Zuckerwaren,269121000,205464000,474585000
2023,4,WA18,Kakao und Zubereitungen aus Kakao,431658000,404085000,835743000
2023,4,WA19,"Zubereitungen aus Getreide usw., Backwaren",691309000,500428000,1191737000
2023,4,WA20,"Zubereitungen von Gemüse, Früchten usw.",267348000,482304000,749652000
2023,4,WA21,Verschiedene Lebensmittelzubereitungen,684651000,404057000,1088708000
2023,4,WA22,"Getränke, alkoholhaltige Flüssigkeiten, Essig",538801000,681880000,1220681000
2023,4,WA23,"Rückstände der Lebensmittelindustrie, Futter",565576000,456963000,1022539000
2023,4,WA24,Tabak,222304000,386762000,609066000
2023,4,WA25,"Salz, Schwefel, Steine, Erden usw.",191456000,161263000,352719000
2023,4,WA26,"Erze, Schlacken, Aschen",49994000,850764000,900758000
2023,4,WA27,Mineralische Brennstoffe usw.,2624673000,9625565000,12250238000
2023,4,WA28,Anorganische chemische Erzeugnisse,1082829000,630778000,1713607000
2023,4,WA29,Organische chemische Erzeugnisse,2306649000,3339392000,5646041000
2023,4,WA30,Pharmazeutische Erzeugnisse,7995929000,4568900000,12564829000
2023,4,WA31,Düngemittel,282029000,133471000,415500000
2023,4,WA32,"Gerb- und Farbstoffe, Farben, Lacke usw.",899644000,448503000,1348147000
2023,4,WA33,"Etherische Öle, Riech-, Schönheitsmittel",934550000,614777000,1549327000
2023,4,WA34,"Seifen, Waschmittel usw.",676486000,395776000,1072262000
2023,4,WA35,"Eiweißstoffe, Klebstoffe, Enzyme",360293000,216716000,577009000
2023,4,WA36,"Sprengstoffe, pyrotechnische Artikel usw.",29099000,21033000,50132000
2023,4,WA37,Photochemische Erzeugnisse,74377000,42291000,116668000
2023,4,WA38,Verschiedene Erzeugnisse der Chemischen Industrie,2567630000,1599605000,4167235000
2023,4,WA39,Kunststoffe und Waren daraus,5396431000,3760321000,9156752000
2023,4,WA40,Kautschuk und Waren daraus,1308552000,1251186000,2559738000
2023,4,WA41,"Häute, Felle, Leder",46869000,38547000,85416000
2023,4,WA42,"Lederwaren, Sattlerwaren",213640000,322630000,536270000
2023,4,WA43,"Pelzfelle, künstliches Pelzwerk",4578000,5611000,10189000
2023,4,WA44,"Holz, Holzwaren, Holzkohle",816494000,708213000,1524707000
2023,4,WA45,"Kork, Korkwaren",1839000,6122000,7961000
2023,4,WA46,"Flechtwaren, Korbmacherwaren",5785000,11850000,17635000
2023,4,WA47,"Halbstoffe aus Holz usw., Papierabfall",99065000,304175000,403240000
2023,4,WA48,"Papier, Pappe und Waren daraus",1575746000,1054632000,2630378000
2023,4,WA49,"Bücher, Zeitungen, Bilddrucke usw.",249039000,242283000,491322000
2023,4,WA50,Seide,1425000,2746000,4171000
2023,4,WA51,"Wolle, feine und grobe Tierhaare",37028000,43148000,80176000
2023,4,WA52,Baumwolle,53172000,59905000,113077000
2023,4,WA53,"Andere pflanzliche Spinnstoffe, Papiergarn",2544000,5045000,7589000
2023,4,WA54,Synthetisches oder künstliches Filament,132002000,118552000,250554000
2023,4,WA55,Synthetische oder künstliche Spinnfaser,120053000,117400000,237453000
2023,4,WA56,"Watte, Filz, Vliesstoff usw., Tauwerk",202772000,135865000,338637000
2023,4,WA57,"Teppiche, Fußbodenbelag aus Spinnstoff",46236000,80908000,127144000
2023,4,WA58,"Spezialgewebe, Spitzen, Tapisserien",42744000,21628000,64372000
2023,4,WA59,"Getränkte, bestrichene usw. Gewebe",212479000,110351000,322830000
2023,4,WA60,Gewirke und Gestricke,58248000,38290000,96538000
2023,4,WA61,"Bekleidung usw. aus Gewirken, Gestricken",884790000,1299703000,2184493000
2023,4,WA62,"Andere Bekleidung, Bekleidungszubehör",956917000,1280739000,2237656000
2023,4,WA63,"Andere Konfektion, Spinnstoffwaren usw.",245136000,332685000,577821000
2023,4,WA64,"Schuhe, Gamaschen, ähnliche Waren",753752000,895052000,1648804000
2023,4,WA65,Kopfbedeckungen und Teile davon,55940000,65799000,121739000
2023,4,WA66,"Schirme, Gehstöcke usw., Peitschen",9064000,23854000,32918000
2023,4,WA67,"Zugerichtete Federn, Daunen, künstliche Blumen",11868000,16222000,28090000
2023,4,WA68,"Waren aus Steinen, Gips, Zement usw.",430682000,301048000,731730000
2023,4,WA69,Keramische Waren,313596000,234942000,548538000
2023,4,WA70,Glas und Glaswaren,631540000,462847000,1094387000
2023,4,WA71,"Perlen, Edelsteine, Edelmetalle",1538659000,1838130000,3376789000
2023,4,WA72,Eisen und Stahl,2440194000,2573419000,5013613000
2023,4,WA73,Waren aus Eisen oder Stahl,2672027000,2214739000,4886766000
2023,4,WA74,Kupfer und Waren daraus,1135457000,953550000,2089007000
2023,4,WA75,Nickel und Waren daraus,169357000,248860000,418217000
2023,4,WA76,Aluminium und Waren daraus,1496321000,1724786000,3221107000
2023,4,WA78,Blei und Waren daraus,32894000,61502000,94396000
2023,4,WA79,Zink und Waren daraus,51585000,137250000,188835000
2023,4,WA80,Zinn und Waren daraus,12653000,35211000,47864000
2023,4,WA81,"Andere unedle Metalle, Cermets usw.",144042000,185882000,329924000
2023,4,WA82,"Werkzeuge, Schneidwaren, Essbestecke",725992000,459653000,1185645000
2023,4,WA83,Verschiedene Waren aus unedlen Metallen,637684000,414497000,1052181000
2023,4,WA84,"Maschinen, Apparate, mechanische Geräte",19479766000,13059386000,32539152000
2023,4,WA85,Elektrotechnische Erzeugnisse,13414785000,15897176000,29311961000
2023,4,WA86,Schienenfahrzeuge,183951000,219124000,403075000
2023,4,WA87,"Kraftfahrzeuge, Landfahrzeuge",21439290000,11122746000,32562036000
2023,4,WA88,"Luftfahrzeuge, Raumfahrzeuge",2450223000,1231216000,3681439000
2023,4,WA89,Wasserfahrzeuge,438648000,613764000,1052412000
2023,4,WA90,"Optische, photografische usw. Erzeugnisse",5808729000,3641729000,9450458000
2023,4,WA91,Uhrmacherwaren,134142000,194093000,328235000
2023,4,WA92,Musikinstrumente,73958000,57087000,131045000
2023,4,WA93,Waffen und Munition,55145000,79484000,134629000
2023,4,WA94,"Möbel, Beleuchtungskörper usw.",1328810000,1660439000,2989249000
2023,4,WA95,"Spielzeug, Spiele usw., Sportgeräte",425153000,683309000,1108462000
2023,4,WA96,Verschiedene Waren,333756000,262050000,595806000
2023,4,WA97,"Kunstgegenstände, Sammlungsstücke",70411000,56321000,126732000
2023,4,WA98,Vollständige Fabrikationsanlagen,60087000,0,60087000
2023,4,WA99,Zusammenstellungen verschiedener Waren,1007865000,915463000,1923328000
2023,5,WA01,Lebende Tiere,130303000,161152000,291455000
2023,5,WA02,Fleisch,640524000,681319000,1321843000
2023,5,WA03,"Fische, Krebs- und Weichtiere",126739000,372647000,499386000
2023,5,WA04,"Milch, Milcherzeugnisse, Eier, Honig",1066339000,948962000,2015301000
2023,5,WA05,Andere Waren tierischen Ursprungs,85022000,111591000,196613000
2023,5,WA06,"Pflanzen, Waren des Blumenhandels",119289000,393872000,513161000
2023,5,WA07,"Gemüse, Pflanzen für Ernährung",136698000,778681000,915379000
2023,5,WA08,Genießbare Früchte und Nüsse,170458000,1057579000,1228037000
2023,5,WA09,"Kaffee, Tee, Mate, Gewürze",313188000,454356000,767544000
2023,5,WA10,Getreide,282854000,343030000,625884000
2023,5,WA11,"Müllereierzeugnisse, Malz usw.",216191000,96052000,312243000
2023,5,WA12,"Ölsamen usw., Heilpflanzen usw.",115205000,695199000,810404000
2023,5,WA13,"Schellack, Gummen, Harz, Pflanzensaft",52637000,51177000,103814000
2023,5,WA14,Flechtstoffe usw. pflanzlichen Ursprungs,986000,4232000,5218000
2023,5,WA15,"Tierische und pflanzliche Fette, Öle, Wachs",366681000,429302000,795983000
2023,5,WA16,"Zubereitungen von Fleisch, Fisch usw.",333702000,328842000,662544000
2023,5,WA17,Zucker und Zuckerwaren,307795000,220055000,527850000
2023,5,WA18,Kakao und Zubereitungen aus Kakao,502354000,420593000,922947000
2023,5,WA19,"Zubereitungen aus Getreide usw., Backwaren",784769000,572238000,1357007000
2023,5,WA20,"Zubereitungen von Gemüse, Früchten usw.",290536000,544424000,834960000
2023,5,WA21,Verschiedene Lebensmittelzubereitungen,778411000,463927000,1242338000
2023,5,WA22,"Getränke, alkoholhaltige Flüssigkeiten, Essig",663590000,801474000,1465064000
2023,5,WA23,"Rückstände der Lebensmittelindustrie, Futter",617868000,514816000,1132684000
2023,5,WA24,Tabak,255341000,474600000,729941000
2023,5,WA25,"Salz, Schwefel, Steine, Erden usw.",231578000,194708000,426286000
2023,5,WA26,"Erze, Schlacken, Aschen",73199000,1053241000,1126440000
2023,5,WA27,Mineralische Brennstoffe usw.,2340824000,9683424000,12024248000
2023,5,WA28,Anorganische chemische Erzeugnisse,1102692000,737392000,1840084000
2023,5,WA29,Organische chemische Erzeugnisse,2640636000,4469323000,7109959000
2023,5,WA30,Pharmazeutische Erzeugnisse,8053162000,5770760000,13823922000
2023,5,WA31,Düngemittel,219897000,144139000,364036000
2023,5,WA32,"Gerb- und Farbstoffe, Farben, Lacke usw.",1001444000,466882000,1468326000
2023,5,WA33,"Etherische Öle, Riech-, Schönheitsmittel",1007685000,705702000,1713387000
2023,5,WA34,"Seifen, Waschmittel usw.",729883000,431756000,1161639000
2023,5,WA35,"Eiweißstoffe, Klebstoffe, Enzyme",380225000,244305000,624530000
2023,5,WA36,"Sprengstoffe, pyrotechnische Artikel usw.",35638000,18231000,53869000
2023,5,WA37,Photochemische Erzeugnisse,85094000,47808000,132902000
2023,5,WA38,Verschiedene Erzeugnisse der Chemischen Industrie,2727810000,1731919000,4459729000
2023,5,WA39,Kunststoffe und Waren daraus,5856042000,4099061000,9955103000
2023,5,WA40,Kautschuk und Waren daraus,1418593000,1366877000,2785470000
2023,5,WA41,"Häute, Felle, Leder",55183000,44898000,100081000
2023,5,WA42,"Lederwaren, Sattlerwaren",244320000,395118000,639438000
2023,5,WA43,"Pelzfelle, künstliches Pelzwerk",3575000,5680000,9255000
2023,5,WA44,"Holz, Holzwaren, Holzkohle",899665000,782428000,1682093000
2023,5,WA45,"Kork, Korkwaren",2043000,8239000,10282000
2023,5,WA46,"Flechtwaren, Korbmacherwaren",6848000,12546000,19394000
2023,5,WA47,"Halbstoffe aus Holz usw., Papierabfall",96824000,314787000,411611000
2023,5,WA48,"Papier, Pappe und Waren daraus",1751755000,1137403000,2889158000
2023,5,WA49,"Bücher, Zeitungen, Bilddrucke usw.",268679000,233506000,502185000
2023,5,WA50,Seide,2048000,4253000,6301000
2023,5,WA51,"Wolle, feine und grobe Tierhaare",41858000,50649000,92507000
2023,5,WA52,Baumwolle,60418000,66139000,126557000
2023,5,WA53,"Andere pflanzliche Spinnstoffe, Papiergarn",2746000,5379000,8125000
2023,5,WA54,Synthetisches oder künstliches Filament,146474000,123522000,269996000
2023,5,WA55,Synthetische oder künstliche Spinnfaser,135941000,119422000,255363000
2023,5,WA56,"Watte, Filz, Vliesstoff usw., Tauwerk",225602000,156313000,381915000
2023,5,WA57,"Teppiche, Fußbodenbelag aus Spinnstoff",46917000,88065000,134982000
2023,5,WA58,"Spezialgewebe, Spitzen, Tapisserien",46474000,24227000,70701000
2023,5,WA59,"Getränkte, bestrichene usw. Gewebe",232391000,117426000,349817000
2023,5,WA60,Gewirke und Gestricke,62712000,42302000,105014000
2023,5,WA61,"Bekleidung usw. aus Gewirken, Gestricken",973939000,1402878000,2376817000
2023,5,WA62,"Andere Bekleidung, Bekleidungszubehör",973088000,1319967000,2293055000
2023,5,WA63,"Andere Konfektion, Spinnstoffwaren usw.",272222000,396106000,668328000
2023,5,WA64,"Schuhe, Gamaschen, ähnliche Waren",788043000,1095257000,1883300000
2023,5,WA65,Kopfbedeckungen und Teile davon,60416000,68944000,129360000
2023,5,WA66,"Schirme, Gehstöcke usw., Peitschen",13700000,23366000,37066000
2023,5,WA67,"Zugerichtete Federn, Daunen, künstliche Blumen",13779000,21583000,35362000
2023,5,WA68,"Waren aus Steinen, Gips, Zement usw.",475800000,331023000,806823000
2023,5,WA69,Keramische Waren,330486000,274105000,604591000
2023,5,WA70,Glas und Glaswaren,694282000,527463000,1221745000
2023,5,WA71,"Perlen, Edelsteine, Edelmetalle",1885272000,2626121000,4511393000
2023,5,WA72,Eisen und Stahl,2754840000,2724237000,5479077000
2023,5,WA73,Waren aus Eisen oder Stahl,2880157000,2436039000,5316196000
2023,5,WA74,Kupfer und Waren daraus,1218549000,1061152000,2279701000
2023,5,WA75,Nickel und Waren daraus,185300000,241632000,426932000
2023,5,WA76,Aluminium und Waren daraus,1611908000,2034022000,3645930000
2023,5,WA78,Blei und Waren daraus,38957000,62035000,100992000
2023,5,WA79,Zink und Waren daraus,53110000,161481000,214591000
2023,5,WA80,Zinn und Waren daraus,13233000,39385000,52618000
2023,5,WA81,"Andere unedle Metalle, Cermets usw.",151773000,204468000,356241000
2023,5,WA82,"Werkzeuge, Schneidwaren, Essbestecke",787102000,508379000,1295481000
2023,5,WA83,Verschiedene Waren aus unedlen Metallen,700861000,486893000,1187754000
2023,5,WA84,"Maschinen, Apparate, mechanische Geräte",21811945000,13881881000,35693826000
2023,5,WA85,Elektrotechnische Erzeugnisse,14832827000,17672247000,32505074000
2023,5,WA86,Schienenfahrzeuge,214241000,272846000,487087000
2023,5,WA87,"Kraftfahrzeuge, Landfahrzeuge",23969440000,13149104000,37118544000
2023,5,WA88,"Luftfahrzeuge, Raumfahrzeuge",3292080000,1152147000,4444227000
2023,5,WA89,Wasserfahrzeuge,247436000,724729000,972165000
2023,5,WA90,"Optische, photografische usw. Erzeugnisse",6533631000,3976569000,10510200000
2023,5,WA91,Uhrmacherwaren,156240000,213396000,369636000
2023,5,WA92,Musikinstrumente,80918000,60516000,141434000
2023,5,WA93,Waffen und Munition,57837000,34854000,92691000
2023,5,WA94,"Möbel, Beleuchtungskörper usw.",1481482000,1832826000,3314308000
2023,5,WA95,"Spielzeug, Spiele usw., Sportgeräte",400337000,681079000,1081416000
2023,5,WA96,Verschiedene Waren,364344000,319233000,683577000
2023,5,WA97,"Kunstgegenstände, Sammlungsstücke",71936000,61007000,132943000
2023,5,WA98,Vollständige Fabrikationsanlagen,94755000,248000,95003000
2023,5,WA99,Zusammenstellungen verschiedener Waren,1625424000,1017901000,2643325000
2023,6,WA01,Lebende Tiere,128792000,170844000,299636000
2023,6,WA02,Fleisch,650907000,669600000,1320507000
2023,6,WA03,"Fische, Krebs- und Weichtiere",126743000,345658000,472401000
2023,6,WA04,"Milch, Milcherzeugnisse, Eier, Honig",1092116000,900082000,1992198000
2023,6,WA05,Andere Waren tierischen Ursprungs,86852000,104230000,191082000
2023,6,WA06,"Pflanzen, Waren des Blumenhandels",65962000,224661000,290623000
2023,6,WA07,"Gemüse, Pflanzen für Ernährung",132361000,659304000,791665000
2023,6,WA08,Genießbare Früchte und Nüsse,193498000,1120965000,1314463000
2023,6,WA09,"Kaffee, Tee, Mate, Gewürze",336571000,470234000,806805000
2023,6,WA10,Getreide,246472000,332574000,579046000
2023,6,WA11,"Müllereierzeugnisse, Malz usw.",224762000,97214000,321976000
2023,6,WA12,"Ölsamen usw., Heilpflanzen usw.",113636000,525446000,639082000
2023,6,WA13,"Schellack, Gummen, Harz, Pflanzensaft",62666000,54542000,117208000
2023,6,WA14,Flechtstoffe usw. pflanzlichen Ursprungs,1441000,4259000,5700000
2023,6,WA15,"Tierische und pflanzliche Fette, Öle, Wachs",355610000,434823000,790433000
2023,6,WA16,"Zubereitungen von Fleisch, Fisch usw.",339701000,336921000,676622000
2023,6,WA17,Zucker und Zuckerwaren,304955000,227452000,532407000
2023,6,WA18,Kakao und Zubereitungen aus Kakao,537626000,441704000,979330000
2023,6,WA19,"Zubereitungen aus Getreide usw., Backwaren",828523000,575016000,1403539000
2023,6,WA20,"Zubereitungen von Gemüse, Früchten usw.",305527000,549559000,855086000
2023,6,WA21,Verschiedene Lebensmittelzubereitungen,792224000,504552000,1296776000
2023,6,WA22,"Getränke, alkoholhaltige Flüssigkeiten, Essig",686050000,818472000,1504522000
2023,6,WA23,"Rückstände der Lebensmittelindustrie, Futter",601827000,471062000,1072889000
2023,6,WA24,Tabak,280691000,492333000,773024000
2023,6,WA25,"Salz, Schwefel, Steine, Erden usw.",227339000,185240000,412579000
2023,6,WA26,"Erze, Schlacken, Aschen",61732000,906529000,968261000
2023,6,WA27,Mineralische Brennstoffe usw.,2504049000,9461756000,11965805000
2023,6,WA28,Anorganische chemische Erzeugnisse,1295573000,672280000,1967853000
2023,6,WA29,Organische chemische Erzeugnisse,2467975000,2953156000,5421131000
2023,6,WA30,Pharmazeutische Erzeugnisse,9360361000,6217686000,15578047000
2023,6,WA31,Düngemittel,212625000,127744000,340369000
2023,6,WA32,"Gerb- und Farbstoffe, Farben, Lacke usw.",1038030000,495468000,1533498000
2023,6,WA33,"Etherische Öle, Riech-, Schönheitsmittel",1086465000,747324000,1833789000
2023,6,WA34,"Seifen, Waschmittel usw.",768915000,450796000,1219711000
2023,6,WA35,"Eiweißstoffe, Klebstoffe, Enzyme",408197000,246262000,654459000
2023,6,WA36,"Sprengstoffe, pyrotechnische Artikel usw.",41303000,29047000,70350000
2023,6,WA37,Photochemische Erzeugnisse,91105000,49805000,140910000
2023,6,WA38,Verschiedene Erzeugnisse der Chemischen Industrie,2890433000,1708940000,4599373000
2023,6,WA39,Kunststoffe und Waren daraus,6099884000,4033302000,10133186000
2023,6,WA40,Kautschuk und Waren daraus,1487843000,1383458000,2871301000
2023,6,WA41,"Häute, Felle, Leder",52361000,47399000,99760000
2023,6,WA42,"Lederwaren, Sattlerwaren",257496000,409292000,666788000
2023,6,WA43,"Pelzfelle, künstliches Pelzwerk",3217000,6552000,9769000
2023,6,WA44,"Holz, Holzwaren, Holzkohle",889316000,749635000,1638951000
2023,6,WA45,"Kork, Korkwaren",2166000,7664000,9830000
2023,6,WA46,"Flechtwaren, Korbmacherwaren",5847000,11866000,17713000
2023,6,WA47,"Halbstoffe aus Holz usw., Papierabfall",115000000,326065000,441065000
2023,6,WA48,"Papier, Pappe und Waren daraus",1750231000,1130077000,2880308000
2023,6,WA49,"Bücher, Zeitungen, Bilddrucke usw.",295709000,205185000,500894000
2023,6,WA50,Seide,4503000,3524000,8027000
2023,6,WA51,"Wolle, feine und grobe Tierhaare",41289000,44850000,86139000
2023,6,WA52,Baumwolle,60413000,65901000,126314000
2023,6,WA53,"Andere pflanzliche Spinnstoffe, Papiergarn",2665000,4554000,7219000
2023,6,WA54,Synthetisches oder künstliches Filament,148085000,118372000,266457000
2023,6,WA55,Synthetische oder künstliche Spinnfaser,133608000,127740000,261348000
2023,6,WA56,"Watte, Filz, Vliesstoff usw., Tauwerk",233406000,158634000,392040000
2023,6,WA57,"Teppiche, Fußbodenbelag aus Spinnstoff",49650000,94846000,144496000
2023,6,WA58,"Spezialgewebe, Spitzen, Tapisserien",48193000,23007000,71200000
2023,6,WA59,"Getränkte, bestrichene usw. Gewebe",246578000,120362000,366940000
2023,6,WA60,Gewirke und Gestricke,64220000,38921000,103141000
2023,6,WA61,"Bekleidung usw. aus Gewirken, Gestricken",1051967000,1608507000,2660474000
2023,6,WA62,"Andere Bekleidung, Bekleidungszubehör",970252000,1458776000,2429028000
2023,6,WA63,"Andere Konfektion, Spinnstoffwaren usw.",289525000,390432000,679957000
2023,6,WA64,"Schuhe, Gamaschen, ähnliche Waren",910832000,1077637000,1988469000
2023,6,WA65,Kopfbedeckungen und Teile davon,68838000,77811000,146649000
2023,6,WA66,"Schirme, Gehstöcke usw., Peitschen",13403000,21529000,34932000
2023,6,WA67,"Zugerichtete Federn, Daunen, künstliche Blumen",12367000,21003000,33370000
2023,6,WA68,"Waren aus Steinen, Gips, Zement usw.",490874000,334185000,825059000
2023,6,WA69,Keramische Waren,348305000,271698000,620003000
2023,6,WA70,Glas und Glaswaren,717250000,509232000,1226482000
2023,6,WA71,"Perlen, Edelsteine, Edelmetalle",1724539000,1971631000,3696170000
2023,6,WA72,Eisen und Stahl,2764966000,2605694000,5370660000
2023,6,WA73,Waren aus Eisen oder Stahl,3127969000,2475564000,5603533000
2023,6,WA74,Kupfer und Waren daraus,1234921000,936813000,2171734000
2023,6,WA75,Nickel und Waren daraus,210801000,224249000,435050000
2023,6,WA76,Aluminium und Waren daraus,1663745000,1877237000,3540982000
2023,6,WA78,Blei und Waren daraus,45396000,47345000,92741000
2023,6,WA79,Zink und Waren daraus,59486000,154160000,213646000
2023,6,WA80,Zinn und Waren daraus,16669000,40372000,57041000
2023,6,WA81,"Andere unedle Metalle, Cermets usw.",152387000,196526000,348913000
2023,6,WA82,"Werkzeuge, Schneidwaren, Essbestecke",826304000,498436000,1324740000
2023,6,WA83,Verschiedene Waren aus unedlen Metallen,738683000,494730000,1233413000
2023,6,WA84,"Maschinen, Apparate, mechanische Geräte",23136242000,14575130000,37711372000
2023,6,WA85,Elektrotechnische Erzeugnisse,15606383000,17926758000,33533141000
2023,6,WA86,Schienenfahrzeuge,226579000,298291000,524870000
2023,6,WA87,"Kraftfahrzeuge, Landfahrzeuge",25248036000,14180607000,39428643000
2023,6,WA88,"Luftfahrzeuge, Raumfahrzeuge",3154498000,1051284000,4205782000
2023,6,WA89,Wasserfahrzeuge,760696000,560119000,1320815000
2023,6,WA90,"Optische, photografische usw. Erzeugnisse",6964214000,4050600000,11014814000
2023,6,WA91,Uhrmacherwaren,160834000,225684000,386518000
2023,6,WA92,Musikinstrumente,82762000,62329000,145091000
2023,6,WA93,Waffen und Munition,68480000,41518000,109998000
2023,6,WA94,"Möbel, Beleuchtungskörper usw.",1539091000,1805092000,3344183000
2023,6,WA95,"Spielzeug, Spiele usw., Sportgeräte",470467000,642976000,1113443000
2023,6,WA96,Verschiedene Waren,385515000,312292000,697807000
2023,6,WA97,"Kunstgegenstände, Sammlungsstücke",92079000,80138000,172217000
2023,6,WA98,Vollständige Fabrikationsanlagen,103835000,1428000,105263000
2023,6,WA99,Zusammenstellungen verschiedener Waren,2040149000,1178710000,3218859000
2023,7,WA01,Lebende Tiere,124376000,156981000,281357000
2023,7,WA02,Fleisch,637138000,623286000,1260424000
2023,7,WA03,"Fische, Krebs- und Weichtiere",118383000,318545000,436928000
2023,7,WA04,"Milch, Milcherzeugnisse, Eier, Honig",987458000,828339000,1815797000
2023,7,WA05,Andere Waren tierischen Ursprungs,72836000,100946000,173782000
2023,7,WA06,"Pflanzen, Waren des Blumenhandels",56751000,182661000,239412000
2023,7,WA07,"Gemüse, Pflanzen für Ernährung",131610000,531994000,663604000
2023,7,WA08,Genießbare Früchte und Nüsse,167696000,1046115000,1213811000
2023,7,WA09,"Kaffee, Tee, Mate, Gewürze",304937000,413976000,718913000
2023,7,WA10,Getreide,275364000,307983000,583347000
2023,7,WA11,"Müllereierzeugnisse, Malz usw.",195685000,86089000,281774000
2023,7,WA12,"Ölsamen usw., Heilpflanzen usw.",145566000,435508000,581074000
2023,7,WA13,"Schellack, Gummen, Harz, Pflanzensaft",52539000,53939000,106478000
2023,7,WA14,Flechtstoffe usw. pflanzlichen Ursprungs,1130000,4244000,5374000
2023,7,WA15,"Tierische und pflanzliche Fette, Öle, Wachs",322308000,388587000,710895000
2023,7,WA16,"Zubereitungen von Fleisch, Fisch usw.",308889000,305909000,614798000
2023,7,WA17,Zucker und Zuckerwaren,284924000,219620000,504544000
2023,7,WA18,Kakao und Zubereitungen aus Kakao,535074000,424879000,959953000
2023,7,WA19,"Zubereitungen aus Getreide usw., Backwaren",762833000,530036000,1292869000
2023,7,WA20,"Zubereitungen von Gemüse, Früchten usw.",285193000,517727000,802920000
2023,7,WA21,Verschiedene Lebensmittelzubereitungen,741501000,487478000,1228979000
2023,7,WA22,"Getränke, alkoholhaltige Flüssigkeiten, Essig",629591000,847019000,1476610000
2023,7,WA23,"Rückstände der Lebensmittelindustrie, Futter",584527000,516753000,1101280000
2023,7,WA24,Tabak,271158000,496364000,767522000
2023,7,WA25,"Salz, Schwefel, Steine, Erden usw.",192382000,167332000,359714000
2023,7,WA26,"Erze, Schlacken, Aschen",61681000,853771000,915452000
2023,7,WA27,Mineralische Brennstoffe usw.,2467563000,9649474000,12117037000
2023,7,WA28,Anorganische chemische Erzeugnisse,1046970000,709906000,1756876000
2023,7,WA29,Organische chemische Erzeugnisse,2408434000,3764766000,6173200000
2023,7,WA30,Pharmazeutische Erzeugnisse,9758489000,5703730000,15462219000
2023,7,WA31,Düngemittel,219113000,86338000,305451000
2023,7,WA32,"Gerb- und Farbstoffe, Farben, Lacke usw.",964556000,464388000,1428944000
2023,7,WA33,"Etherische Öle, Riech-, Schönheitsmittel",1043256000,766832000,1810088000
2023,7,WA34,"Seifen, Waschmittel usw.",714585000,433836000,1148421000
2023,7,WA35,"Eiweißstoffe, Klebstoffe, Enzyme",364677000,226343000,591020000
2023,7,WA36,"Sprengstoffe, pyrotechnische Artikel usw.",25043000,30681000,55724000
2023,7,WA37,Photochemische Erzeugnisse,82595000,51140000,133735000
2023,7,WA38,Verschiedene Erzeugnisse der Chemischen Industrie,2486692000,1671956000,4158648000
2023,7,WA39,Kunststoffe und Waren daraus,5457930000,3725516000,9183446000
2023,7,WA40,Kautschuk und Waren daraus,1355588000,1256688000,2612276000
2023,7,WA41,"Häute, Felle, Leder",51852000,45310000,97162000
2023,7,WA42,"Lederwaren, Sattlerwaren",260511000,403193000,663704000
2023,7,WA43,"Pelzfelle, künstliches Pelzwerk",4522000,7869000,12391000
2023,7,WA44,"Holz, Holzwaren, Holzkohle",791189000,667847000,1459036000
2023,7,WA45,"Kork, Korkwaren",1924000,6539000,8463000
2023,7,WA46,"Flechtwaren, Korbmacherwaren",5655000,11604000,17259000
2023,7,WA47,"Halbstoffe aus Holz usw., Papierabfall",121151000,273592000,394743000
2023,7,WA48,"Papier, Pappe und Waren daraus",1650574000,1114663000,2765237000
2023,7,WA49,"Bücher, Zeitungen, Bilddrucke usw.",264146000,204221000,468367000
2023,7,WA50,Seide,1558000,3345000,4903000
2023,7,WA51,"Wolle, feine und grobe Tierhaare",32174000,40621000,72795000
2023,7,WA52,Baumwolle,46079000,51595000,97674000
2023,7,WA53,"Andere pflanzliche Spinnstoffe, Papiergarn",2334000,3963000,6297000
2023,7,WA54,Synthetisches oder künstliches Filament,129435000,105140000,234575000
2023,7,WA55,Synthetische oder künstliche Spinnfaser,121073000,109608000,230681000
2023,7,WA56,"Watte, Filz, Vliesstoff usw., Tauwerk",217908000,142016000,359924000
2023,7,WA57,"Teppiche, Fußbodenbelag aus Spinnstoff",45359000,85223000,130582000
2023,7,WA58,"Spezialgewebe, Spitzen, Tapisserien",43469000,20903000,64372000
2023,7,WA59,"Getränkte, bestrichene usw. Gewebe",216674000,108745000,325419000
2023,7,WA60,Gewirke und Gestricke,55805000,33435000,89240000
2023,7,WA61,"Bekleidung usw. aus Gewirken, Gestricken",1081334000,1790789000,2872123000
2023,7,WA62,"Andere Bekleidung, Bekleidungszubehör",986027000,1562174000,2548201000
2023,7,WA63,"Andere Konfektion, Spinnstoffwaren usw.",272452000,373176000,645628000
2023,7,WA64,"Schuhe, Gamaschen, ähnliche Waren",901248000,1118282000,2019530000
2023,7,WA65,Kopfbedeckungen und Teile davon,63257000,79555000,142812000
2023,7,WA66,"Schirme, Gehstöcke usw., Peitschen",9707000,17755000,27462000
2023,7,WA67,"Zugerichtete Federn, Daunen, künstliche Blumen",12225000,24955000,37180000
2023,7,WA68,"Waren aus Steinen, Gips, Zement usw.",440300000,309115000,749415000
2023,7,WA69,Keramische Waren,311167000,241651000,552818000
2023,7,WA70,Glas und Glaswaren,626643000,475799000,1102442000
2023,7,WA71,"Perlen, Edelsteine, Edelmetalle",1756261000,1625318000,3381579000
2023,7,WA72,Eisen und Stahl,2287801000,2400897000,4688698000
2023,7,WA73,Waren aus Eisen oder Stahl,2705316000,2260440000,4965756000
2023,7,WA74,Kupfer und Waren daraus,1103602000,924705000,2028307000
2023,7,WA75,Nickel und Waren daraus,162354000,187365000,349719000
2023,7,WA76,Aluminium und Waren daraus,1474661000,1778791000,3253452000
2023,7,WA78,Blei und Waren daraus,37518000,47021000,84539000
2023,7,WA79,Zink und Waren daraus,54343000,136522000,190865000
2023,7,WA80,Zinn und Waren daraus,10940000,36008000,46948000
2023,7,WA81,"Andere unedle Metalle, Cermets usw.",128362000,186545000,314907000
2023,7,WA82,"Werkzeuge, Schneidwaren, Essbestecke",750475000,475500000,1225975000
2023,7,WA83,Verschiedene Waren aus unedlen Metallen,669638000,447890000,1117528000
2023,7,WA84,"Maschinen, Apparate, mechanische Geräte",21030413000,13428559000,34458972000
2023,7,WA85,Elektrotechnische Erzeugnisse,14230805000,16173185000,30403990000
2023,7,WA86,Schienenfahrzeuge,197705000,357760000,555465000
2023,7,WA87,"Kraftfahrzeuge, Landfahrzeuge",21977806000,12389488000,34367294000
2023,7,WA88,"Luftfahrzeuge, Raumfahrzeuge",2725737000,605419000,3331156000
2023,7,WA89,Wasserfahrzeuge,278004000,238076000,516080000
2023,7,WA90,"Optische, photografische usw. Erzeugnisse",6317126000,3716694000,10033820000
2023,7,WA91,Uhrmacherwaren,154945000,222754000,377699000
2023,7,WA92,Musikinstrumente,69161000,58254000,127415000
2023,7,WA93,Waffen und Munition,55379000,30071000,85450000
2023,7,WA94,"Möbel, Beleuchtungskörper usw.",1336151000,1565086000,2901237000
2023,7,WA95,"Spielzeug, Spiele usw., Sportgeräte",407801000,675309000,1083110000
2023,7,WA96,Verschiedene Waren,356589000,290174000,646763000
2023,7,WA97,"Kunstgegenstände, Sammlungsstücke",80061000,62080000,142141000
2023,7,WA98,Vollständige Fabrikationsanlagen,107512000,1835000,109347000
2023,7,WA99,Zusammenstellungen verschiedener Waren,1321835000,1068390000,2390225000
2023,8,WA01,Lebende Tiere,140702000,165908000,306610000
2023,8,WA02,Fleisch,654782000,631785000,1286567000
2023,8,WA03,"Fische, Krebs- und Weichtiere",130874000,320261000,451135000
2023,8,WA04,"Milch, Milcherzeugnisse, Eier, Honig",1013221000,857104000,1870325000
2023,8,WA05,Andere Waren tierischen Ursprungs,73561000,93774000,167335000
2023,8,WA06,"Pflanzen, Waren des Blumenhandels",61146000,183650000,244796000
2023,8,WA07,"Gemüse, Pflanzen für Ernährung",136286000,513877000,650163000
2023,8,WA08,Genießbare Früchte und Nüsse,165204000,973272000,1138476000
2023,8,WA09,"Kaffee, Tee, Mate, Gewürze",305724000,400044000,705768000
2023,8,WA10,Getreide,206414000,295540000,501954000
2023,8,WA11,"Müllereierzeugnisse, Malz usw.",195701000,85181000,280882000
2023,8,WA12,"Ölsamen usw., Heilpflanzen usw.",138489000,685517000,824006000
2023,8,WA13,"Schellack, Gummen, Harz, Pflanzensaft",47848000,49437000,97285000
2023,8,WA14,Flechtstoffe usw. pflanzlichen Ursprungs,846000,3613000,4459000
2023,8,WA15,"Tierische und pflanzliche Fette, Öle, Wachs",313806000,450458000,764264000
2023,8,WA16,"Zubereitungen von Fleisch, Fisch usw.",328300000,320107000,648407000
2023,8,WA17,Zucker und Zuckerwaren,295969000,230473000,526442000
2023,8,WA18,Kakao und Zubereitungen aus Kakao,619689000,480201000,1099890000
2023,8,WA19,"Zubereitungen aus Getreide usw., Backwaren",852639000,546085000,1398724000
2023,8,WA20,"Zubereitungen von Gemüse, Früchten usw.",292380000,532733000,825113000
2023,8,WA21,Verschiedene Lebensmittelzubereitungen,729157000,577539000,1306696000
2023,8,WA22,"Getränke, alkoholhaltige Flüssigkeiten, Essig",650649000,729850000,1380499000
2023,8,WA23,"Rückstände der Lebensmittelindustrie, Futter",606260000,432694000,1038954000
2023,8,WA24,Tabak,278514000,467415000,745929000
2023,8,WA25,"Salz, Schwefel, Steine, Erden usw.",185177000,158537000,343714000
2023,8,WA26,"Erze, Schlacken, Aschen",58343000,733550000,791893000
2023,8,WA27,Mineralische Brennstoffe usw.,2705969000,9472581000,12178550000
2023,8,WA28,Anorganische chemische Erzeugnisse,1046224000,626908000,1673132000
2023,8,WA29,Organische chemische Erzeugnisse,2198451000,2956472000,5154923000
2023,8,WA30,Pharmazeutische Erzeugnisse,9255565000,5411233000,14666798000
2023,8,WA31,Düngemittel,229814000,112200000,342014000
2023,8,WA32,"Gerb- und Farbstoffe, Farben, Lacke usw.",950035000,432270000,1382305000
2023,8,WA33,"Etherische Öle, Riech-, Schönheitsmittel",1076597000,761788000,1838385000
2023,8,WA34,"Seifen, Waschmittel usw.",727892000,469247000,1197139000
2023,8,WA35,"Eiweißstoffe, Klebstoffe, Enzyme",358507000,219780000,578287000
2023,8,WA36,"Sprengstoffe, pyrotechnische Artikel usw.",30352000,30537000,60889000
2023,8,WA37,Photochemische Erzeugnisse,74869000,45168000,120037000
2023,8,WA38,Verschiedene Erzeugnisse der Chemischen Industrie,2552544000,1637890000,4190434000
2023,8,WA39,Kunststoffe und Waren daraus,5393924000,3507659000,8901583000
2023,8,WA40,Kautschuk und Waren daraus,1381990000,1240746000,2622736000
2023,8,WA41,"Häute, Felle, Leder",36162000,26014000,62176000
2023,8,WA42,"Lederwaren, Sattlerwaren",261847000,391688000,653535000
2023,8,WA43,"Pelzfelle, künstliches Pelzwerk",5040000,9599000,14639000
2023,8,WA44,"Holz, Holzwaren, Holzkohle",745940000,633032000,1378972000
2023,8,WA45,"Kork, Korkwaren",1852000,5284000,7136000
2023,8,WA46,"Flechtwaren, Korbmacherwaren",4877000,9249000,14126000
2023,8,WA47,"Halbstoffe aus Holz usw., Papierabfall",101467000,267899000,369366000
2023,8,WA48,"Papier, Pappe und Waren daraus",1617685000,1073819000,2691504000
2023,8,WA49,"Bücher, Zeitungen, Bilddrucke usw.",288950000,228156000,517106000
2023,8,WA50,Seide,1302000,2468000,3770000
2023,8,WA51,"Wolle, feine und grobe Tierhaare",28489000,33681000,62170000
2023,8,WA52,Baumwolle,50101000,47243000,97344000
2023,8,WA53,"Andere pflanzliche Spinnstoffe, Papiergarn",2436000,4379000,6815000
2023,8,WA54,Synthetisches oder künstliches Filament,125458000,102464000,227922000
2023,8,WA55,Synthetische oder künstliche Spinnfaser,110361000,98775000,209136000
2023,8,WA56,"Watte, Filz, Vliesstoff usw., Tauwerk",204517000,131290000,335807000
2023,8,WA57,"Teppiche, Fußbodenbelag aus Spinnstoff",46405000,78357000,124762000
2023,8,WA58,"Spezialgewebe, Spitzen, Tapisserien",41855000,20613000,62468000
2023,8,WA59,"Getränkte, bestrichene usw. Gewebe",212306000,99275000,311581000
2023,8,WA60,Gewirke und Gestricke,49693000,29474000,79167000
2023,8,WA61,"Bekleidung usw. aus Gewirken, Gestricken",1185450000,1906260000,3091710000
2023,8,WA62,"Andere Bekleidung, Bekleidungszubehör",1114593000,1638091000,2752684000
2023,8,WA63,"Andere Konfektion, Spinnstoffwaren usw.",267667000,375716000,643383000
2023,8,WA64,"Schuhe, Gamaschen, ähnliche Waren",936434000,1075354000,2011788000
2023,8,WA65,Kopfbedeckungen und Teile davon,64415000,81551000,145966000
2023,8,WA66,"Schirme, Gehstöcke usw., Peitschen",8018000,15963000,23981000
2023,8,WA67,"Zugerichtete Federn, Daunen, künstliche Blumen",13748000,25999000,39747000
2023,8,WA68,"Waren aus Steinen, Gips, Zement usw.",429171000,295913000,725084000
2023,8,WA69,Keramische Waren,307242000,227153000,534395000
2023,8,WA70,Glas und Glaswaren,607492000,464164000,1071656000
2023,8,WA71,"Perlen, Edelsteine, Edelmetalle",1405869000,1610785000,3016654000
2023,8,WA72,Eisen und Stahl,2312803000,2051995000,4364798000
2023,8,WA73,Waren aus Eisen oder Stahl,2780092000,2091836000,4871928000
2023,8,WA74,Kupfer und Waren daraus,1092950000,882185000,1975135000
2023,8,WA75,Nickel und Waren daraus,172723000,176049000,348772000
2023,8,WA76,Aluminium und Waren daraus,1425398000,1638591000,3063989000
2023,8,WA78,Blei und Waren daraus,39798000,40095000,79893000
2023,8,WA79,Zink und Waren daraus,46198000,131859000,178057000
2023,8,WA80,Zinn und Waren daraus,11108000,42250000,53358000
2023,8,WA81,"Andere unedle Metalle, Cermets usw.",125058000,160763000,285821000
2023,8,WA82,"Werkzeuge, Schneidwaren, Essbestecke",750780000,465534000,1216314000
2023,8,WA83,Verschiedene Waren aus unedlen Metallen,662019000,426190000,1088209000
2023,8,WA84,"Maschinen, Apparate, mechanische Geräte",20464356000,12727442000,33191798000
2023,8,WA85,Elektrotechnische Erzeugnisse,14527089000,16033671000,30560760000
2023,8,WA86,Schienenfahrzeuge,220872000,256258000,477130000
2023,8,WA87,"Kraftfahrzeuge, Landfahrzeuge",19637389000,10667465000,30304854000
2023,8,WA88,"Luftfahrzeuge, Raumfahrzeuge",2241203000,839865000,3081068000
2023,8,WA89,Wasserfahrzeuge,526746000,150721000,677467000
2023,8,WA90,"Optische, photografische usw. Erzeugnisse",6447368000,3629699000,10077067000
2023,8,WA91,Uhrmacherwaren,144052000,191468000,335520000
2023,8,WA92,Musikinstrumente,74641000,57892000,132533000
2023,8,WA93,Waffen und Munition,51891000,56469000,108360000
2023,8,WA94,"Möbel, Beleuchtungskörper usw.",1380891000,1580572000,2961463000
2023,8,WA95,"Spielzeug, Spiele usw., Sportgeräte",441540000,687669000,1129209000
2023,8,WA96,Verschiedene Waren,347379000,289985000,637364000
2023,8,WA97,"Kunstgegenstände, Sammlungsstücke",67355000,45180000,112535000
2023,8,WA98,Vollständige Fabrikationsanlagen,271287000,7000,271294000
2023,8,WA99,Zusammenstellungen verschiedener Waren,1266098000,926272000,2192370000
2023,9,WA01,Lebende Tiere,130328000,146232000,276560000
2023,9,WA02,Fleisch,635582000,632422000,1268004000
2023,9,WA03,"Fische, Krebs- und Weichtiere",129698000,362824000,492522000
2023,9,WA04,"Milch, Milcherzeugnisse, Eier, Honig",952346000,876829000,1829175000
2023,9,WA05,Andere Waren tierischen Ursprungs,68436000,89128000,157564000
2023,9,WA06,"Pflanzen, Waren des Blumenhandels",83885000,190282000,274167000
2023,9,WA07,"Gemüse, Pflanzen für Ernährung",151474000,519119000,670593000
2023,9,WA08,Genießbare Früchte und Nüsse,171350000,914669000,1086019000
2023,9,WA09,"Kaffee, Tee, Mate, Gewürze",317085000,415629000,732714000
2023,9,WA10,Getreide,245790000,302317000,548107000
2023,9,WA11,"Müllereierzeugnisse, Malz usw.",198445000,84915000,283360000
2023,9,WA12,"Ölsamen usw., Heilpflanzen usw.",104887000,541394000,646281000
2023,9,WA13,"Schellack, Gummen, Harz, Pflanzensaft",53328000,51769000,105097000
2023,9,WA14,Flechtstoffe usw. pflanzlichen Ursprungs,1038000,4264000,5302000
2023,9,WA15,"Tierische und pflanzliche Fette, Öle, Wachs",309714000,481118000,790832000
2023,9,WA16,"Zubereitungen von Fleisch, Fisch usw.",306530000,318431000,624961000
2023,9,WA17,Zucker und Zuckerwaren,304484000,221939000,526423000
2023,9,WA18,Kakao und Zubereitungen aus Kakao,749617000,503302000,1252919000
2023,9,WA19,"Zubereitungen aus Getreide usw., Backwaren",835610000,548809000,1384419000
2023,9,WA20,"Zubereitungen von Gemüse, Früchten usw.",283889000,513279000,797168000
2023,9,WA21,Verschiedene Lebensmittelzubereitungen,681721000,421616000,1103337000
2023,9,WA22,"Getränke, alkoholhaltige Flüssigkeiten, Essig",614310000,772090000,1386400000
2023,9,WA23,"Rückstände der Lebensmittelindustrie, Futter",553779000,459424000,1013203000
2023,9,WA24,Tabak,261983000,511280000,773263000
2023,9,WA25,"Salz, Schwefel, Steine, Erden usw.",210653000,161594000,372247000
2023,9,WA26,"Erze, Schlacken, Aschen",54614000,659867000,714481000
2023,9,WA27,Mineralische Brennstoffe usw.,2862165000,9453653000,12315818000
2023,9,WA28,Anorganische chemische Erzeugnisse,1000953000,636251000,1637204000
2023,9,WA29,Organische chemische Erzeugnisse,2056413000,3016579000,5072992000
2023,9,WA30,Pharmazeutische Erzeugnisse,9033679000,6007291000,15040970000
2023,9,WA31,Düngemittel,266775000,127346000,394121000
2023,9,WA32,"Gerb- und Farbstoffe, Farben, Lacke usw.",981557000,469467000,1451024000
2023,9,WA33,"Etherische Öle, Riech-, Schönheitsmittel",1076091000,742996000,1819087000
2023,9,WA34,"Seifen, Waschmittel usw.",733608000,480209000,1213817000
2023,9,WA35,"Eiweißstoffe, Klebstoffe, Enzyme",366071000,223017000,589088000
2023,9,WA36,"Sprengstoffe, pyrotechnische Artikel usw.",37252000,40582000,77834000
2023,9,WA37,Photochemische Erzeugnisse,80214000,49160000,129374000
2023,9,WA38,Verschiedene Erzeugnisse der Chemischen Industrie,2781453000,1604592000,4386045000
2023,9,WA39,Kunststoffe und Waren daraus,5581114000,3655959000,9237073000
2023,9,WA40,Kautschuk und Waren daraus,1429714000,1383771000,2813485000
2023,9,WA41,"Häute, Felle, Leder",50313000,39526000,89839000
2023,9,WA42,"Lederwaren, Sattlerwaren",249622000,373339000,622961000
2023,9,WA43,"Pelzfelle, künstliches Pelzwerk",6485000,7763000,14248000
2023,9,WA44,"Holz, Holzwaren, Holzkohle",827437000,664249000,1491686000
2023,9,WA45,"Kork, Korkwaren",1668000,6356000,8024000
2023,9,WA46,"Flechtwaren, Korbmacherwaren",4752000,9938000,14690000
2023,9,WA47,"Halbstoffe aus Holz usw., Papierabfall",123083000,284839000,407922000
2023,9,WA48,"Papier, Pappe und Waren daraus",1657313000,1082695000,2740008000
2023,9,WA49,"Bücher, Zeitungen, Bilddrucke usw.",311743000,239917000,551660000
2023,9,WA50,Seide,1474000,2558000,4032000
2023,9,WA51,"Wolle, feine und grobe Tierhaare",36982000,35144000,72126000
2023,9,WA52,Baumwolle,56396000,53010000,109406000
2023,9,WA53,"Andere pflanzliche Spinnstoffe, Papiergarn",3253000,5882000,9135000
2023,9,WA54,Synthetisches oder künstliches Filament,133578000,108167000,241745000
2023,9,WA55,Synthetische oder künstliche Spinnfaser,123861000,109497000,233358000
2023,9,WA56,"Watte, Filz, Vliesstoff usw., Tauwerk",217564000,138140000,355704000
2023,9,WA57,"Teppiche, Fußbodenbelag aus Spinnstoff",48556000,92985000,141541000
2023,9,WA58,"Spezialgewebe, Spitzen, Tapisserien",47318000,21427000,68745000
2023,9,WA59,"Getränkte, bestrichene usw. Gewebe",225447000,105124000,330571000
2023,9,WA60,Gewirke und Gestricke,56871000,33370000,90241000
2023,9,WA61,"Bekleidung usw. aus Gewirken, Gestricken",1115123000,1700207000,2815330000
2023,9,WA62,"Andere Bekleidung, Bekleidungszubehör",1056922000,1489372000,2546294000
2023,9,WA63,"Andere Konfektion, Spinnstoffwaren usw.",254508000,368280000,622788000
2023,9,WA64,"Schuhe, Gamaschen, ähnliche Waren",869684000,1022079000,1891763000
2023,9,WA65,Kopfbedeckungen und Teile davon,68028000,75450000,143478000
2023,9,WA66,"Schirme, Gehstöcke usw., Peitschen",7925000,13864000,21789000
2023,9,WA67,"Zugerichtete Federn, Daunen, künstliche Blumen",14326000,22933000,37259000
2023,9,WA68,"Waren aus Steinen, Gips, Zement usw.",465497000,309861000,775358000
2023,9,WA69,Keramische Waren,324526000,243062000,567588000
2023,9,WA70,Glas und Glaswaren,635435000,465422000,1100857000
2023,9,WA71,"Perlen, Edelsteine, Edelmetalle",1552042000,1593364000,3145406000
2023,9,WA72,Eisen und Stahl,2483467000,2282918000,4766385000
2023,9,WA73,Waren aus Eisen oder Stahl,2813501000,2230983000,5044484000
2023,9,WA74,Kupfer und Waren daraus,1144366000,866846000,2011212000
2023,9,WA75,Nickel und Waren daraus,185903000,196571000,382474000
2023,9,WA76,Aluminium und Waren daraus,1443273000,1651254000,3094527000
2023,9,WA78,Blei und Waren daraus,37263000,40271000,77534000
2023,9,WA79,Zink und Waren daraus,56141000,128871000,185012000
2023,9,WA80,Zinn und Waren daraus,10894000,39711000,50605000
2023,9,WA81,"Andere unedle Metalle, Cermets usw.",135756000,153389000,289145000
2023,9,WA82,"Werkzeuge, Schneidwaren, Essbestecke",750997000,473029000,1224026000
2023,9,WA83,Verschiedene Waren aus unedlen Metallen,674809000,449207000,1124016000
2023,9,WA84,"Maschinen, Apparate, mechanische Geräte",21553721000,13764706000,35318427000
2023,9,WA85,Elektrotechnische Erzeugnisse,14811038000,17212681000,32023719000
2023,9,WA86,Schienenfahrzeuge,281535000,292243000,573778000
2023,9,WA87,"Kraftfahrzeuge, Landfahrzeuge",23191398000,12416339000,35607737000
2023,9,WA88,"Luftfahrzeuge, Raumfahrzeuge",2406144000,944612000,3350756000
2023,9,WA89,Wasserfahrzeuge,106871000,311908000,418779000
2023,9,WA90,"Optische, photografische usw. Erzeugnisse",6662091000,3852033000,10514124000
2023,9,WA91,Uhrmacherwaren,151889000,218986000,370875000
2023,9,WA92,Musikinstrumente,94813000,68104000,162917000
2023,9,WA93,Waffen und Munition,53166000,28862000,82028000
2023,9,WA94,"Möbel, Beleuchtungskörper usw.",1475197000,1767900000,3243097000
2023,9,WA95,"Spielzeug, Spiele usw., Sportgeräte",531452000,817312000,1348764000
2023,9,WA96,Verschiedene Waren,353052000,289701000,642753000
2023,9,WA97,"Kunstgegenstände, Sammlungsstücke",123401000,39951000,163352000
2023,9,WA98,Vollständige Fabrikationsanlagen,68373000,247000,68620000
2023,9,WA99,Zusammenstellungen verschiedener Waren,1328964000,941318000,2270282000
2023,10,WA01,Lebende Tiere,148999000,147430000,296429000
2023,10,WA02,Fleisch,640502000,688435000,1328937000
2023,10,WA03,"Fische, Krebs- und Weichtiere",123786000,373148000,496934000
2023,10,WA04,"Milch, Milcherzeugnisse, Eier, Honig",994872000,897253000,1892125000
2023,10,WA05,Andere Waren tierischen Ursprungs,71199000,88075000,159274000
2023,10,WA06,"Pflanzen, Waren des Blumenhandels",79065000,194581000,273646000
2023,10,WA07,"Gemüse, Pflanzen für Ernährung",133658000,571633000,705291000
2023,10,WA08,Genießbare Früchte und Nüsse,183358000,965623000,1148981000
2023,10,WA09,"Kaffee, Tee, Mate, Gewürze",330763000,383074000,713837000
2023,10,WA10,Getreide,236793000,315072000,551865000
2023,10,WA11,"Müllereierzeugnisse, Malz usw.",211098000,89134000,300232000
2023,10,WA12,"Ölsamen usw., Heilpflanzen usw.",110957000,599238000,710195000
2023,10,WA13,"Schellack, Gummen, Harz, Pflanzensaft",44713000,44097000,88810000
2023,10,WA14,Flechtstoffe usw. pflanzlichen Ursprungs,910000,3042000,3952000
2023,10,WA15,"Tierische und pflanzliche Fette, Öle, Wachs",338598000,438260000,776858000
2023,10,WA16,"Zubereitungen von Fleisch, Fisch usw.",316630000,328667000,645297000
2023,10,WA17,Zucker und Zuckerwaren,348500000,212412000,560912000
2023,10,WA18,Kakao und Zubereitungen aus Kakao,772698000,564907000,1337605000
2023,10,WA19,"Zubereitungen aus Getreide usw., Backwaren",834642000,584742000,1419384000
2023,10,WA20,"Zubereitungen von Gemüse, Früchten usw.",292992000,569160000,862152000
2023,10,WA21,Verschiedene Lebensmittelzubereitungen,687384000,423755000,1111139000
2023,10,WA22,"Getränke, alkoholhaltige Flüssigkeiten, Essig",634403000,772299000,1406702000
2023,10,WA23,"Rückstände der Lebensmittelindustrie, Futter",591475000,458174000,1049649000
2023,10,WA24,Tabak,250845000,521108000,771953000
2023,10,WA25,"Salz, Schwefel, Steine, Erden usw.",206024000,152169000,358193000
2023,10,WA26,"Erze, Schlacken, Aschen",52522000,911154000,963676000
2023,10,WA27,Mineralische Brennstoffe usw.,2731166000,10232799000,12963965000
2023,10,WA28,Anorganische chemische Erzeugnisse,983458000,618712000,1602170000
2023,10,WA29,Organische chemische Erzeugnisse,2057173000,3304842000,5362015000
2023,10,WA30,Pharmazeutische Erzeugnisse,8989135000,5667805000,14656940000
2023,10,WA31,Düngemittel,249757000,94263000,344020000
2023,10,WA32,"Gerb- und Farbstoffe, Farben, Lacke usw.",974972000,468942000,1443914000
2023,10,WA33,"Etherische Öle, Riech-, Schönheitsmittel",1104908000,750628000,1855536000
2023,10,WA34,"Seifen, Waschmittel usw.",743888000,473314000,1217202000
2023,10,WA35,"Eiweißstoffe, Klebstoffe, Enzyme",364017000,229752000,593769000
2023,10,WA36,"Sprengstoffe, pyrotechnische Artikel usw.",32258000,27521000,59779000
2023,10,WA37,Photochemische Erzeugnisse,85616000,57412000,143028000
2023,10,WA38,Verschiedene Erzeugnisse der Chemischen Industrie,2797148000,1623796000,4420944000
2023,10,WA39,Kunststoffe und Waren daraus,5622416000,3694951000,9317367000
2023,10,WA40,Kautschuk und Waren daraus,1488848000,1416915000,2905763000
2023,10,WA41,"Häute, Felle, Leder",48593000,41073000,89666000
2023,10,WA42,"Lederwaren, Sattlerwaren",260257000,384604000,644861000
2023,10,WA43,"Pelzfelle, künstliches Pelzwerk",6111000,7604000,13715000
2023,10,WA44,"Holz, Holzwaren, Holzkohle",818450000,677724000,1496174000
2023,10,WA45,"Kork, Korkwaren",2061000,6401000,8462000
2023,10,WA46,"Flechtwaren, Korbmacherwaren",4134000,9910000,14044000
2023,10,WA47,"Halbstoffe aus Holz usw., Papierabfall",97039000,281150000,378189000
2023,10,WA48,"Papier, Pappe und Waren daraus",1690651000,1109709000,2800360000
2023,10,WA49,"Bücher, Zeitungen, Bilddrucke usw.",342822000,244770000,587592000
2023,10,WA50,Seide,2382000,3668000,6050000
2023,10,WA51,"Wolle, feine und grobe Tierhaare",32393000,42688000,75081000
2023,10,WA52,Baumwolle,54583000,60351000,114934000
2023,10,WA53,"Andere pflanzliche Spinnstoffe, Papiergarn",4229000,7515000,11744000
2023,10,WA54,Synthetisches oder künstliches Filament,143331000,111901000,255232000
2023,10,WA55,Synthetische oder künstliche Spinnfaser,126526000,123068000,249594000
2023,10,WA56,"Watte, Filz, Vliesstoff usw., Tauwerk",224184000,132003000,356187000
2023,10,WA57,"Teppiche, Fußbodenbelag aus Spinnstoff",52959000,93429000,146388000
2023,10,WA58,"Spezialgewebe, Spitzen, Tapisserien",48166000,22768000,70934000
2023,10,WA59,"Getränkte, bestrichene usw. Gewebe",213039000,108546000,321585000
2023,10,WA60,Gewirke und Gestricke,56675000,36175000,92850000
2023,10,WA61,"Bekleidung usw. aus Gewirken, Gestricken",1132320000,1763549000,2895869000
2023,10,WA62,"Andere Bekleidung, Bekleidungszubehör",1072155000,1488376000,2560531000
2023,10,WA63,"Andere Konfektion, Spinnstoffwaren usw.",266586000,377052000,643638000
2023,10,WA64,"Schuhe, Gamaschen, ähnliche Waren",804376000,967075000,1771451000
2023,10,WA65,Kopfbedeckungen und Teile davon,66201000,80427000,146628000
2023,10,WA66,"Schirme, Gehstöcke usw., Peitschen",7483000,14918000,22401000
2023,10,WA67,"Zugerichtete Federn, Daunen, künstliche Blumen",14435000,21864000,36299000
2023,10,WA68,"Waren aus Steinen, Gips, Zement usw.",479965000,316778000,796743000
2023,10,WA69,Keramische Waren,335801000,248158000,583959000
2023,10,WA70,Glas und Glaswaren,658940000,491924000,1150864000
2023,10,WA71,"Perlen, Edelsteine, Edelmetalle",1536585000,1649341000,3185926000
2023,10,WA72,Eisen und Stahl,2437497000,2364397000,4801894000
2023,10,WA73,Waren aus Eisen oder Stahl,2965419000,2220472000,5185891000
2023,10,WA74,Kupfer und Waren daraus,1119199000,876780000,1995979000
2023,10,WA75,Nickel und Waren daraus,171766000,184283000,356049000
2023,10,WA76,Aluminium und Waren daraus,1450369000,1675389000,3125758000
2023,10,WA78,Blei und Waren daraus,39958000,47166000,87124000
2023,10,WA79,Zink und Waren daraus,59568000,134709000,194277000
2023,10,WA80,Zinn und Waren daraus,9639000,34436000,44075000
2023,10,WA81,"Andere unedle Metalle, Cermets usw.",128299000,164816000,293115000
2023,10,WA82,"Werkzeuge, Schneidwaren, Essbestecke",779947000,479406000,1259353000
2023,10,WA83,Verschiedene Waren aus unedlen Metallen,704805000,456599000,1161404000
2023,10,WA84,"Maschinen, Apparate, mechanische Geräte",21111987000,14116446000,35228433000
2023,10,WA85,Elektrotechnische Erzeugnisse,15076633000,17680456000,32757089000
2023,10,WA86,Schienenfahrzeuge,204564000,289719000,494283000
2023,10,WA87,"Kraftfahrzeuge, Landfahrzeuge",23875664000,12625027000,36500691000
2023,10,WA88,"Luftfahrzeuge, Raumfahrzeuge",3247600000,927597000,4175197000
2023,10,WA89,Wasserfahrzeuge,1226943000,82492000,1309435000
2023,10,WA90,"Optische, photografische usw. Erzeugnisse",6645532000,3851096000,10496628000
2023,10,WA91,Uhrmacherwaren,165847000,226525000,392372000
2023,10,WA92,Musikinstrumente,90230000,68110000,158340000
2023,10,WA93,Waffen und Munition,49195000,30511000,79706000
2023,10,WA94,"Möbel, Beleuchtungskörper usw.",1514881000,1846687000,3361568000
2023,10,WA95,"Spielzeug, Spiele usw., Sportgeräte",541182000,852277000,1393459000
2023,10,WA96,Verschiedene Waren,352473000,309626000,662099000
2023,10,WA97,"Kunstgegenstände, Sammlungsstücke",137397000,46229000,183626000
2023,10,WA98,Vollständige Fabrikationsanlagen,74264000,0,74264000
2023,10,WA99,Zusammenstellungen verschiedener Waren,1324483000,1033484000,2357967000
2023,11,WA01,Lebende Tiere,129618000,137348000,266966000
2023,11,WA02,Fleisch,675284000,699145000,1374429000
2023,11,WA03,"Fische, Krebs- und Weichtiere",134363000,394322000,528685000
2023,11,WA04,"Milch, Milcherzeugnisse, Eier, Honig",994315000,972376000,1966691000
2023,11,WA05,Andere Waren tierischen Ursprungs,73330000,90389000,163719000
2023,11,WA06,"Pflanzen, Waren des Blumenhandels",72540000,230337000,302877000
2023,11,WA07,"Gemüse, Pflanzen für Ernährung",127952000,700953000,828905000
2023,11,WA08,Genießbare Früchte und Nüsse,196081000,1016494000,1212575000
2023,11,WA09,"Kaffee, Tee, Mate, Gewürze",352975000,443404000,796379000
2023,11,WA10,Getreide,227929000,369756000,597685000
2023,11,WA11,"Müllereierzeugnisse, Malz usw.",210817000,87766000,298583000
2023,11,WA12,"Ölsamen usw., Heilpflanzen usw.",140778000,595752000,736530000
2023,11,WA13,"Schellack, Gummen, Harz, Pflanzensaft",58343000,57106000,115449000
2023,11,WA14,Flechtstoffe usw. pflanzlichen Ursprungs,1049000,2707000,3756000
2023,11,WA15,"Tierische und pflanzliche Fette, Öle, Wachs",334133000,452516000,786649000
2023,11,WA16,"Zubereitungen von Fleisch, Fisch usw.",322195000,347192000,669387000
2023,11,WA17,Zucker und Zuckerwaren,350123000,225171000,575294000
2023,11,WA18,Kakao und Zubereitungen aus Kakao,730095000,577677000,1307772000
2023,11,WA19,"Zubereitungen aus Getreide usw., Backwaren",843918000,599892000,1443810000
2023,11,WA20,"Zubereitungen von Gemüse, Früchten usw.",296723000,603907000,900630000
2023,11,WA21,Verschiedene Lebensmittelzubereitungen,733242000,461865000,1195107000
2023,11,WA22,"Getränke, alkoholhaltige Flüssigkeiten, Essig",649408000,825859000,1475267000
2023,11,WA23,"Rückstände der Lebensmittelindustrie, Futter",634286000,479849000,1114135000
2023,11,WA24,Tabak,295888000,445373000,741261000
2023,11,WA25,"Salz, Schwefel, Steine, Erden usw.",218099000,176959000,395058000
2023,11,WA26,"Erze, Schlacken, Aschen",61639000,746920000,808559000
2023,11,WA27,Mineralische Brennstoffe usw.,2732699000,10078037000,12810736000
2023,11,WA28,Anorganische chemische Erzeugnisse,1179913000,866184000,2046097000
2023,11,WA29,Organische chemische Erzeugnisse,2234761000,3314836000,5549597000
2023,11,WA30,Pharmazeutische Erzeugnisse,10354221000,6174237000,16528458000
2023,11,WA31,Düngemittel,246588000,131922000,378510000
2023,11,WA32,"Gerb- und Farbstoffe, Farben, Lacke usw.",1002732000,482849000,1485581000
2023,11,WA33,"Etherische Öle, Riech-, Schönheitsmittel",1120985000,801337000,1922322000
2023,11,WA34,"Seifen, Waschmittel usw.",757421000,479449000,1236870000
2023,11,WA35,"Eiweißstoffe, Klebstoffe, Enzyme",382341000,238654000,620995000
2023,11,WA36,"Sprengstoffe, pyrotechnische Artikel usw.",37350000,40328000,77678000
2023,11,WA37,Photochemische Erzeugnisse,94254000,57124000,151378000
2023,11,WA38,Verschiedene Erzeugnisse der Chemischen Industrie,2840907000,1650443000,4491350000
2023,11,WA39,Kunststoffe und Waren daraus,5733714000,3687989000,9421703000
2023,11,WA40,Kautschuk und Waren daraus,1543750000,1356293000,2900043000
2023,11,WA41,"Häute, Felle, Leder",50586000,40333000,90919000
2023,11,WA42,"Lederwaren, Sattlerwaren",272157000,393461000,665618000
2023,11,WA43,"Pelzfelle, künstliches Pelzwerk",6692000,8736000,15428000
2023,11,WA44,"Holz, Holzwaren, Holzkohle",844189000,675266000,1519455000
2023,11,WA45,"Kork, Korkwaren",2020000,7897000,9917000
2023,11,WA46,"Flechtwaren, Korbmacherwaren",4294000,10706000,15000000
2023,11,WA47,"Halbstoffe aus Holz usw., Papierabfall",117216000,286965000,404181000
2023,11,WA48,"Papier, Pappe und Waren daraus",1756006000,1120563000,2876569000
2023,11,WA49,"Bücher, Zeitungen, Bilddrucke usw.",329367000,269073000,598440000
2023,11,WA50,Seide,1360000,2720000,4080000
2023,11,WA51,"Wolle, feine und grobe Tierhaare",32416000,38194000,70610000
2023,11,WA52,Baumwolle,60628000,53507000,114135000
2023,11,WA53,"Andere pflanzliche Spinnstoffe, Papiergarn",5897000,8138000,14035000
2023,11,WA54,Synthetisches oder künstliches Filament,142302000,110649000,252951000
2023,11,WA55,Synthetische oder künstliche Spinnfaser,121597000,105647000,227244000
2023,11,WA56,"Watte, Filz, Vliesstoff usw., Tauwerk",223381000,137577000,360958000
2023,11,WA57,"Teppiche, Fußbodenbelag aus Spinnstoff",54249000,96892000,151141000
2023,11,WA58,"Spezialgewebe, Spitzen, Tapisserien",46607000,20862000,67469000
2023,11,WA59,"Getränkte, bestrichene usw. Gewebe",220528000,109240000,329768000
2023,11,WA60,Gewirke und Gestricke,55338000,36641000,91979000
2023,11,WA61,"Bekleidung usw. aus Gewirken, Gestricken",1198840000,1637445000,2836285000
2023,11,WA62,"Andere Bekleidung, Bekleidungszubehör",1151853000,1421512000,2573365000
2023,11,WA63,"Andere Konfektion, Spinnstoffwaren usw.",280186000,371772000,651958000
2023,11,WA64,"Schuhe, Gamaschen, ähnliche Waren",883924000,922668000,1806592000
2023,11,WA65,Kopfbedeckungen und Teile davon,83403000,77777000,161180000
2023,11,WA66,"Schirme, Gehstöcke usw., Peitschen",7924000,12310000,20234000
2023,11,WA67,"Zugerichtete Federn, Daunen, künstliche Blumen",14665000,20496000,35161000
2023,11,WA68,"Waren aus Steinen, Gips, Zement usw.",480960000,311415000,792375000
2023,11,WA69,Keramische Waren,340933000,244435000,585368000
2023,11,WA70,Glas und Glaswaren,653064000,476213000,1129277000
2023,11,WA71,"Perlen, Edelsteine, Edelmetalle",2810774000,1626424000,4437198000
2023,11,WA72,Eisen und Stahl,2510305000,2283741000,4794046000
2023,11,WA73,Waren aus Eisen oder Stahl,2834829000,2220422000,5055251000
2023,11,WA74,Kupfer und Waren daraus,1135499000,979406000,2114905000
2023,11,WA75,Nickel und Waren daraus,157362000,189300000,346662000
2023,11,WA76,Aluminium und Waren daraus,1472754000,1685150000,3157904000
2023,11,WA78,Blei und Waren daraus,41442000,55219000,96661000
2023,11,WA79,Zink und Waren daraus,53994000,131404000,185398000
2023,11,WA80,Zinn und Waren daraus,10108000,40241000,50349000
2023,11,WA81,"Andere unedle Metalle, Cermets usw.",130223000,171473000,301696000
2023,11,WA82,"Werkzeuge, Schneidwaren, Essbestecke",829862000,512394000,1342256000
2023,11,WA83,Verschiedene Waren aus unedlen Metallen,713406000,466575000,1179981000
2023,11,WA84,"Maschinen, Apparate, mechanische Geräte",22777630000,14291312000,37068942000
2023,11,WA85,Elektrotechnische Erzeugnisse,15536378000,17878633000,33415011000
2023,11,WA86,Schienenfahrzeuge,318913000,370369000,689282000
2023,11,WA87,"Kraftfahrzeuge, Landfahrzeuge",25400284000,13459972000,38860256000
2023,11,WA88,"Luftfahrzeuge, Raumfahrzeuge",2907755000,1094880000,4002635000
2023,11,WA89,Wasserfahrzeuge,237773000,214449000,452222000
2023,11,WA90,"Optische, photografische usw. Erzeugnisse",7073470000,3951448000,11024918000
2023,11,WA91,Uhrmacherwaren,198794000,268218000,467012000
2023,11,WA92,Musikinstrumente,100187000,75648000,175835000
2023,11,WA93,Waffen und Munition,57196000,26914000,84110000
2023,11,WA94,"Möbel, Beleuchtungskörper usw.",1620629000,1904264000,3524893000
2023,11,WA95,"Spielzeug, Spiele usw., Sportgeräte",580259000,948845000,1529104000
2023,11,WA96,Verschiedene Waren,374824000,324860000,699684000
2023,11,WA97,"Kunstgegenstände, Sammlungsstücke",62847000,52593000,115440000
2023,11,WA98,Vollständige Fabrikationsanlagen,88155000,23000,88178000
2023,11,WA99,Zusammenstellungen verschiedener Waren,1506677000,1213095000,2719772000
2023,12,WA01,Lebende Tiere,127118000,129484000,256602000
2023,12,WA02,Fleisch,589048000,656901000,1245949000
2023,12,WA03,"Fische, Krebs- und Weichtiere",134164000,468186000,602350000
2023,12,WA04,"Milch, Milcherzeugnisse, Eier, Honig",937225000,889678000,1826903000
2023,12,WA05,Andere Waren tierischen Ursprungs,59672000,87184000,146856000
2023,12,WA06,"Pflanzen, Waren des Blumenhandels",51157000,196408000,247565000
2023,12,WA07,"Gemüse, Pflanzen für Ernährung",117882000,733831000,851713000
2023,12,WA08,Genießbare Früchte und Nüsse,171755000,942610000,1114365000
2023,12,WA09,"Kaffee, Tee, Mate, Gewürze",296387000,360773000,657160000
2023,12,WA10,Getreide,252720000,339898000,592618000
2023,12,WA11,"Müllereierzeugnisse, Malz usw.",182488000,76458000,258946000
2023,12,WA12,"Ölsamen usw., Heilpflanzen usw.",130522000,599813000,730335000
2023,12,WA13,"Schellack, Gummen, Harz, Pflanzensaft",50476000,44272000,94748000
2023,12,WA14,Flechtstoffe usw. pflanzlichen Ursprungs,658000,2275000,2933000
2023,12,WA15,"Tierische und pflanzliche Fette, Öle, Wachs",261250000,381365000,642615000
2023,12,WA16,"Zubereitungen von Fleisch, Fisch usw.",285683000,329269000,614952000
2023,12,WA17,Zucker und Zuckerwaren,282741000,179803000,462544000
2023,12,WA18,Kakao und Zubereitungen aus Kakao,569234000,469688000,1038922000
2023,12,WA19,"Zubereitungen aus Getreide usw., Backwaren",709061000,549112000,1258173000
2023,12,WA20,"Zubereitungen von Gemüse, Früchten usw.",269478000,536988000,806466000
2023,12,WA21,Verschiedene Lebensmittelzubereitungen,615233000,450676000,1065909000
2023,12,WA22,"Getränke, alkoholhaltige Flüssigkeiten, Essig",524319000,704603000,1228922000
2023,12,WA23,"Rückstände der Lebensmittelindustrie, Futter",561318000,422672000,983990000
2023,12,WA24,Tabak,230302000,406390000,636692000
2023,12,WA25,"Salz, Schwefel, Steine, Erden usw.",163574000,144954000,308528000
2023,12,WA26,"Erze, Schlacken, Aschen",58426000,1009487000,1067913000
2023,12,WA27,Mineralische Brennstoffe usw.,2563200000,10529068000,13092268000
2023,12,WA28,Anorganische chemische Erzeugnisse,872734000,795637000,1668371000
2023,12,WA29,Organische chemische Erzeugnisse,1764358000,2342968000,4107326000
2023,12,WA30,Pharmazeutische Erzeugnisse,7416202000,5033485000,12449687000
2023,12,WA31,Düngemittel,205658000,121736000,327394000
2023,12,WA32,"Gerb- und Farbstoffe, Farben, Lacke usw.",734535000,353262000,1087797000
2023,12,WA33,"Etherische Öle, Riech-, Schönheitsmittel",888387000,672132000,1560519000
2023,12,WA34,"Seifen, Waschmittel usw.",584582000,392623000,977205000
2023,12,WA35,"Eiweißstoffe, Klebstoffe, Enzyme",288662000,202945000,491607000
2023,12,WA36,"Sprengstoffe, pyrotechnische Artikel usw.",40965000,32269000,73234000
2023,12,WA37,Photochemische Erzeugnisse,74985000,45041000,120026000
2023,12,WA38,Verschiedene Erzeugnisse der Chemischen Industrie,2314685000,1503126000,3817811000
2023,12,WA39,Kunststoffe und Waren daraus,4206319000,2983097000,7189416000
2023,12,WA40,Kautschuk und Waren daraus,1104931000,924955000,2029886000
2023,12,WA41,"Häute, Felle, Leder",39960000,31110000,71070000
2023,12,WA42,"Lederwaren, Sattlerwaren",222203000,358662000,580865000
2023,12,WA43,"Pelzfelle, künstliches Pelzwerk",5675000,5138000,10813000
2023,12,WA44,"Holz, Holzwaren, Holzkohle",620249000,505064000,1125313000
2023,12,WA45,"Kork, Korkwaren",1373000,6038000,7411000
2023,12,WA46,"Flechtwaren, Korbmacherwaren",4054000,12053000,16107000
2023,12,WA47,"Halbstoffe aus Holz usw., Papierabfall",89228000,276195000,365423000
2023,12,WA48,"Papier, Pappe und Waren daraus",1371986000,992258000,2364244000
2023,12,WA49,"Bücher, Zeitungen, Bilddrucke usw.",295144000,270286000,565430000
2023,12,WA50,Seide,1520000,2901000,4421000
2023,12,WA51,"Wolle, feine und grobe Tierhaare",22802000,24757000,47559000
2023,12,WA52,Baumwolle,38588000,40258000,78846000
2023,12,WA53,"Andere pflanzliche Spinnstoffe, Papiergarn",4208000,5472000,9680000
2023,12,WA54,Synthetisches oder künstliches Filament,103928000,75639000,179567000
2023,12,WA55,Synthetische oder künstliche Spinnfaser,102673000,76528000,179201000
2023,12,WA56,"Watte, Filz, Vliesstoff usw., Tauwerk",160948000,103688000,264636000
2023,12,WA57,"Teppiche, Fußbodenbelag aus Spinnstoff",46800000,84605000,131405000
2023,12,WA58,"Spezialgewebe, Spitzen, Tapisserien",34742000,15710000,50452000
2023,12,WA59,"Getränkte, bestrichene usw. Gewebe",164751000,81091000,245842000
2023,12,WA60,Gewirke und Gestricke,39511000,24182000,63693000
2023,12,WA61,"Bekleidung usw. aus Gewirken, Gestricken",972382000,1383875000,2356257000
2023,12,WA62,"Andere Bekleidung, Bekleidungszubehör",876268000,1234309000,2110577000
2023,12,WA63,"Andere Konfektion, Spinnstoffwaren usw.",223707000,290595000,514302000
2023,12,WA64,"Schuhe, Gamaschen, ähnliche Waren",737471000,821387000,1558858000
2023,12,WA65,Kopfbedeckungen und Teile davon,62677000,67678000,130355000
2023,12,WA66,"Schirme, Gehstöcke usw., Peitschen",5634000,11672000,17306000
2023,12,WA67,"Zugerichtete Federn, Daunen, künstliche Blumen",11305000,19983000,31288000
2023,12,WA68,"Waren aus Steinen, Gips, Zement usw.",360472000,241396000,601868000
2023,12,WA69,Keramische Waren,283792000,196831000,480623000
2023,12,WA70,Glas und Glaswaren,477201000,364217000,841418000
2023,12,WA71,"Perlen, Edelsteine, Edelmetalle",2175329000,1368334000,3543663000
2023,12,WA72,Eisen und Stahl,1767428000,1569076000,3336504000
2023,12,WA73,Waren aus Eisen oder Stahl,2200130000,1684172000,3884302000
2023,12,WA74,Kupfer und Waren daraus,787580000,621942000,1409522000
2023,12,WA75,Nickel und Waren daraus,115744000,137949000,253693000
2023,12,WA76,Aluminium und Waren daraus,1009983000,1194616000,2204599000
2023,12,WA78,Blei und Waren daraus,31218000,41581000,72799000
2023,12,WA79,Zink und Waren daraus,43144000,119356000,162500000
2023,12,WA80,Zinn und Waren daraus,10118000,30405000,40523000
2023,12,WA81,"Andere unedle Metalle, Cermets usw.",120486000,132123000,252609000
2023,12,WA82,"Werkzeuge, Schneidwaren, Essbestecke",649057000,409412000,1058469000
2023,12,WA83,Verschiedene Waren aus unedlen Metallen,497176000,375425000,872601000
2023,12,WA84,"Maschinen, Apparate, mechanische Geräte",19903336000,12342201000,32245537000
2023,12,WA85,Elektrotechnische Erzeugnisse,12897927000,13836373000,26734300000
2023,12,WA86,Schienenfahrzeuge,204790000,262224000,467014000
2023,12,WA87,"Kraftfahrzeuge, Landfahrzeuge",18837904000,10034220000,28872124000
2023,12,WA88,"Luftfahrzeuge, Raumfahrzeuge",4257875000,1482246000,5740121000
2023,12,WA89,Wasserfahrzeuge,195409000,185780000,381189000
2023,12,WA90,"Optische, photografische usw. Erzeugnisse",6202086000,3544147000,9746233000
2023,12,WA91,Uhrmacherwaren,164070000,209094000,373164000
2023,12,WA92,Musikinstrumente,105898000,65480000,171378000
2023,12,WA93,Waffen und Munition,55650000,22593000,78243000
2023,12,WA94,"Möbel, Beleuchtungskörper usw.",1220282000,1540571000,2760853000
2023,12,WA95,"Spielzeug, Spiele usw., Sportgeräte",434030000,732805000,1166835000
2023,12,WA96,Verschiedene Waren,308727000,270599000,579326000
2023,12,WA97,"Kunstgegenstände, Sammlungsstücke",58280000,70918000,129198000
2023,12,WA98,Vollständige Fabrikationsanlagen,70089000,0,70089000
2023,12,WA99,Zusammenstellungen verschiedener Waren,1759497000,1151995000,2911492000
2024,1,WA01,Lebende Tiere,144680000,170911000,315591000
2024,1,WA02,Fleisch,635686000,663965000,1299651000
2024,1,WA03,"Fische, Krebs- und Weichtiere",107995000,330921000,438916000
2024,1,WA04,"Milch, Milcherzeugnisse, Eier, Honig",1114701000,973288000,2087989000
2024,1,WA05,Andere Waren tierischen Ursprungs,70666000,81438000,152104000
2024,1,WA06,"Pflanzen, Waren des Blumenhandels",53483000,236089000,289572000
2024,1,WA07,"Gemüse, Pflanzen für Ernährung",145983000,857598000,1003581000
2024,1,WA08,Genießbare Früchte und Nüsse,183527000,1064298000,1247825000
2024,1,WA09,"Kaffee, Tee, Mate, Gewürze",336768000,467072000,803840000
2024,1,WA10,Getreide,275730000,408428000,684158000
2024,1,WA11,"Müllereierzeugnisse, Malz usw.",223711000,83029000,306740000
2024,1,WA12,"Ölsamen usw., Heilpflanzen usw.",221540000,688220000,909760000
2024,1,WA13,"Schellack, Gummen, Harz, Pflanzensaft",66112000,49976000,116088000
2024,1,WA14,Flechtstoffe usw. pflanzlichen Ursprungs,1160000,3062000,4222000
2024,1,WA15,"Tierische und pflanzliche Fette, Öle, Wachs",343799000,458020000,801819000
2024,1,WA16,"Zubereitungen von Fleisch, Fisch usw.",338545000,353449000,691994000
2024,1,WA17,Zucker und Zuckerwaren,326433000,214143000,540576000
2024,1,WA18,Kakao und Zubereitungen aus Kakao,726688000,585633000,1312321000
2024,1,WA19,"Zubereitungen aus Getreide usw., Backwaren",796320000,588548000,1384868000
2024,1,WA20,"Zubereitungen von Gemüse, Früchten usw.",317843000,600080000,917923000
2024,1,WA21,Verschiedene Lebensmittelzubereitungen,759797000,465068000,1224865000
2024,1,WA22,"Getränke, alkoholhaltige Flüssigkeiten, Essig",569764000,643783000,1213547000
2024,1,WA23,"Rückstände der Lebensmittelindustrie, Futter",715980000,542680000,1258660000
2024,1,WA24,Tabak,229692000,445641000,675333000
2024,1,WA25,"Salz, Schwefel, Steine, Erden usw.",201167000,157911000,359078000
2024,1,WA26,"Erze, Schlacken, Aschen",72050000,722900000,794950000
2024,1,WA27,Mineralische Brennstoffe usw.,2866794000,8881439000,11748233000
2024,1,WA28,Anorganische chemische Erzeugnisse,1066046000,690279000,1756325000
2024,1,WA29,Organische chemische Erzeugnisse,2455368000,3337140000,5792508000
2024,1,WA30,Pharmazeutische Erzeugnisse,9788924000,6705113000,16494037000
2024,1,WA31,Düngemittel,236512000,122879000,359391000
2024,1,WA32,"Gerb- und Farbstoffe, Farben, Lacke usw.",1046314000,455646000,1501960000
2024,1,WA33,"Etherische Öle, Riech-, Schönheitsmittel",1070970000,774783000,1845753000
2024,1,WA34,"Seifen, Waschmittel usw.",816972000,432678000,1249650000
2024,1,WA35,"Eiweißstoffe, Klebstoffe, Enzyme",414905000,245167000,660072000
2024,1,WA36,"Sprengstoffe, pyrotechnische Artikel usw.",38246000,20646000,58892000
2024,1,WA37,Photochemische Erzeugnisse,86174000,48406000,134580000
2024,1,WA38,Verschiedene Erzeugnisse der Chemischen Industrie,3087221000,1640052000,4727273000
2024,1,WA39,Kunststoffe und Waren daraus,6098673000,3737789000,9836462000
2024,1,WA40,Kautschuk und Waren daraus,1324585000,1147092000,2471677000
2024,1,WA41,"Häute, Felle, Leder",47940000,25739000,73679000
2024,1,WA42,"Lederwaren, Sattlerwaren",264285000,359112000,623397000
2024,1,WA43,"Pelzfelle, künstliches Pelzwerk",4758000,3967000,8725000
2024,1,WA44,"Holz, Holzwaren, Holzkohle",791702000,641408000,1433110000
2024,1,WA45,"Kork, Korkwaren",1945000,7890000,9835000
2024,1,WA46,"Flechtwaren, Korbmacherwaren",6479000,11542000,18021000
2024,1,WA47,"Halbstoffe aus Holz usw., Papierabfall",117819000,315059000,432878000
2024,1,WA48,"Papier, Pappe und Waren daraus",1730432000,1146331000,2876763000
2024,1,WA49,"Bücher, Zeitungen, Bilddrucke usw.",290977000,231386000,522363000
2024,1,WA50,Seide,2295000,2976000,5271000
2024,1,WA51,"Wolle, feine und grobe Tierhaare",38980000,40475000,79455000
2024,1,WA52,Baumwolle,53989000,51291000,105280000
2024,1,WA53,"Andere pflanzliche Spinnstoffe, Papiergarn",4870000,5545000,10415000
2024,1,WA54,Synthetisches oder künstliches Filament,141486000,112151000,253637000
2024,1,WA55,Synthetische oder künstliche Spinnfaser,124695000,108884000,233579000
2024,1,WA56,"Watte, Filz, Vliesstoff usw., Tauwerk",227051000,140015000,367066000
2024,1,WA57,"Teppiche, Fußbodenbelag aus Spinnstoff",54718000,99758000,154476000
2024,1,WA58,"Spezialgewebe, Spitzen, Tapisserien",47926000,22536000,70462000
2024,1,WA59,"Getränkte, bestrichene usw. Gewebe",244736000,106130000,350866000
2024,1,WA60,Gewirke und Gestricke,51742000,31389000,83131000
2024,1,WA61,"Bekleidung usw. aus Gewirken, Gestricken",1140807000,1600303000,2741110000
2024,1,WA62,"Andere Bekleidung, Bekleidungszubehör",1179300000,1519169000,2698469000
2024,1,WA63,"Andere Konfektion, Spinnstoffwaren usw.",264817000,321356000,586173000
2024,1,WA64,"Schuhe, Gamaschen, ähnliche Waren",960481000,1039927000,2000408000
2024,1,WA65,Kopfbedeckungen und Teile davon,62481000,71010000,133491000
2024,1,WA66,"Schirme, Gehstöcke usw., Peitschen",5768000,14918000,20686000
2024,1,WA67,"Zugerichtete Federn, Daunen, künstliche Blumen",16340000,22541000,38881000
2024,1,WA68,"Waren aus Steinen, Gips, Zement usw.",444051000,282252000,726303000
2024,1,WA69,Keramische Waren,336198000,235155000,571353000
2024,1,WA70,Glas und Glaswaren,651907000,459246000,1111153000
2024,1,WA71,"Perlen, Edelsteine, Edelmetalle",2320852000,1608424000,3929276000
2024,1,WA72,Eisen und Stahl,2611340000,2314152000,4925492000
2024,1,WA73,Waren aus Eisen oder Stahl,2868310000,2019220000,4887530000
2024,1,WA74,Kupfer und Waren daraus,1184621000,865999000,2050620000
2024,1,WA75,Nickel und Waren daraus,200070000,196611000,396681000
2024,1,WA76,Aluminium und Waren daraus,1432565000,1559835000,2992400000
2024,1,WA78,Blei und Waren daraus,51418000,49995000,101413000
2024,1,WA79,Zink und Waren daraus,59959000,131728000,191687000
2024,1,WA80,Zinn und Waren daraus,10782000,35311000,46093000
2024,1,WA81,"Andere unedle Metalle, Cermets usw.",149706000,159219000,308925000
2024,1,WA82,"Werkzeuge, Schneidwaren, Essbestecke",831470000,477126000,1308596000
2024,1,WA83,Verschiedene Waren aus unedlen Metallen,777723000,460537000,1238260000
2024,1,WA84,"Maschinen, Apparate, mechanische Geräte",20915271000,13390341000,34305612000
2024,1,WA85,Elektrotechnische Erzeugnisse,14581766000,15707009000,30288775000
2024,1,WA86,Schienenfahrzeuge,329865000,264119000,593984000
2024,1,WA87,"Kraftfahrzeuge, Landfahrzeuge",20311329000,11201978000,31513307000
2024,1,WA88,"Luftfahrzeuge, Raumfahrzeuge",1776386000,763885000,2540271000
2024,1,WA89,Wasserfahrzeuge,148502000,301601000,450103000
2024,1,WA90,"Optische, photografische usw. Erzeugnisse",6408937000,3716265000,10125202000
2024,1,WA91,Uhrmacherwaren,146953000,203122000,350075000
2024,1,WA92,Musikinstrumente,82452000,55360000,137812000
2024,1,WA93,Waffen und Munition,52651000,21285000,73936000
2024,1,WA94,"Möbel, Beleuchtungskörper usw.",1453907000,1726874000,3180781000
2024,1,WA95,"Spielzeug, Spiele usw., Sportgeräte",350655000,537049000,887704000
2024,1,WA96,Verschiedene Waren,368798000,282931000,651729000
2024,1,WA97,"Kunstgegenstände, Sammlungsstücke",82874000,36331000,119205000
2024,1,WA98,Vollständige Fabrikationsanlagen,75111000,0,75111000
2024,1,WA99,Zusammenstellungen verschiedener Waren,1152784000,1104706000,2257490000
2024,2,WA01,Lebende Tiere,113885000,145384000,259269000
2024,2,WA02,Fleisch,626872000,625718000,1252590000
2024,2,WA03,"Fische, Krebs- und Weichtiere",109554000,359254000,468808000
2024,2,WA04,"Milch, Milcherzeugnisse, Eier, Honig",1011358000,889464000,1900822000
2024,2,WA05,Andere Waren tierischen Ursprungs,74904000,93921000,168825000
2024,2,WA06,"Pflanzen, Waren des Blumenhandels",83438000,292506000,375944000
2024,2,WA07,"Gemüse, Pflanzen für Ernährung",150307000,776423000,926730000
2024,2,WA08,Genießbare Früchte und Nüsse,184785000,1000232000,1185017000
2024,2,WA09,"Kaffee, Tee, Mate, Gewürze",316269000,470059000,786328000
2024,2,WA10,Getreide,277993000,419841000,697834000
2024,2,WA11,"Müllereierzeugnisse, Malz usw.",209392000,83878000,293270000
2024,2,WA12,"Ölsamen usw., Heilpflanzen usw.",279809000,651011000,930820000
2024,2,WA13,"Schellack, Gummen, Harz, Pflanzensaft",60842000,52391000,113233000
2024,2,WA14,Flechtstoffe usw. pflanzlichen Ursprungs,1188000,3425000,4613000
2024,2,WA15,"Tierische und pflanzliche Fette, Öle, Wachs",285427000,454311000,739738000
2024,2,WA16,"Zubereitungen von Fleisch, Fisch usw.",300502000,327514000,628016000
2024,2,WA17,Zucker und Zuckerwaren,302676000,212706000,515382000
2024,2,WA18,Kakao und Zubereitungen aus Kakao,675815000,619844000,1295659000
2024,2,WA19,"Zubereitungen aus Getreide usw., Backwaren",777674000,588621000,1366295000
2024,2,WA20,"Zubereitungen von Gemüse, Früchten usw.",306078000,571124000,877202000
2024,2,WA21,Verschiedene Lebensmittelzubereitungen,741031000,487569000,1228600000
2024,2,WA22,"Getränke, alkoholhaltige Flüssigkeiten, Essig",563705000,685034000,1248739000
2024,2,WA23,"Rückstände der Lebensmittelindustrie, Futter",604975000,461205000,1066180000
2024,2,WA24,Tabak,271379000,462510000,733889000
2024,2,WA25,"Salz, Schwefel, Steine, Erden usw.",208960000,163940000,372900000
2024,2,WA26,"Erze, Schlacken, Aschen",69462000,812455000,881917000
2024,2,WA27,Mineralische Brennstoffe usw.,2937026000,8550911000,11487937000
2024,2,WA28,Anorganische chemische Erzeugnisse,1036024000,714114000,1750138000
2024,2,WA29,Organische chemische Erzeugnisse,2373880000,2962912000,5336792000
2024,2,WA30,Pharmazeutische Erzeugnisse,9688612000,6047591000,15736203000
2024,2,WA31,Düngemittel,277865000,144687000,422552000
2024,2,WA32,"Gerb- und Farbstoffe, Farben, Lacke usw.",1026970000,461656000,1488626000
2024,2,WA33,"Etherische Öle, Riech-, Schönheitsmittel",1089674000,746096000,1835770000
2024,2,WA34,"Seifen, Waschmittel usw.",795944000,456204000,1252148000
2024,2,WA35,"Eiweißstoffe, Klebstoffe, Enzyme",392859000,239147000,632006000
2024,2,WA36,"Sprengstoffe, pyrotechnische Artikel usw.",37889000,19547000,57436000
2024,2,WA37,Photochemische Erzeugnisse,82841000,54037000,136878000
2024,2,WA38,Verschiedene Erzeugnisse der Chemischen Industrie,2892722000,1738918000,4631640000
2024,2,WA39,Kunststoffe und Waren daraus,6050452000,3874659000,9925111000
2024,2,WA40,Kautschuk und Waren daraus,1555689000,1444394000,3000083000
2024,2,WA41,"Häute, Felle, Leder",45855000,41300000,87155000
2024,2,WA42,"Lederwaren, Sattlerwaren",253413000,365601000,619014000
2024,2,WA43,"Pelzfelle, künstliches Pelzwerk",4307000,5407000,9714000
2024,2,WA44,"Holz, Holzwaren, Holzkohle",851808000,666661000,1518469000
2024,2,WA45,"Kork, Korkwaren",1814000,7461000,9275000
2024,2,WA46,"Flechtwaren, Korbmacherwaren",5464000,12859000,18323000
2024,2,WA47,"Halbstoffe aus Holz usw., Papierabfall",123949000,328779000,452728000
2024,2,WA48,"Papier, Pappe und Waren daraus",1730170000,1118722000,2848892000
2024,2,WA49,"Bücher, Zeitungen, Bilddrucke usw.",278888000,228507000,507395000
2024,2,WA50,Seide,1786000,3852000,5638000
2024,2,WA51,"Wolle, feine und grobe Tierhaare",37489000,39882000,77371000
2024,2,WA52,Baumwolle,53811000,46051000,99862000
2024,2,WA53,"Andere pflanzliche Spinnstoffe, Papiergarn",3852000,5225000,9077000
2024,2,WA54,Synthetisches oder künstliches Filament,141700000,117018000,258718000
2024,2,WA55,Synthetische oder künstliche Spinnfaser,125429000,110666000,236095000
2024,2,WA56,"Watte, Filz, Vliesstoff usw., Tauwerk",225977000,140778000,366755000
2024,2,WA57,"Teppiche, Fußbodenbelag aus Spinnstoff",55601000,94200000,149801000
2024,2,WA58,"Spezialgewebe, Spitzen, Tapisserien",46511000,22365000,68876000
2024,2,WA59,"Getränkte, bestrichene usw. Gewebe",235179000,114094000,349273000
2024,2,WA60,Gewirke und Gestricke,55608000,35903000,91511000
2024,2,WA61,"Bekleidung usw. aus Gewirken, Gestricken",1075203000,1572131000,2647334000
2024,2,WA62,"Andere Bekleidung, Bekleidungszubehör",1159258000,1571010000,2730268000
2024,2,WA63,"Andere Konfektion, Spinnstoffwaren usw.",263659000,340193000,603852000
2024,2,WA64,"Schuhe, Gamaschen, ähnliche Waren",1006422000,1165462000,2171884000
2024,2,WA65,Kopfbedeckungen und Teile davon,66337000,79479000,145816000
2024,2,WA66,"Schirme, Gehstöcke usw., Peitschen",7308000,30701000,38009000
2024,2,WA67,"Zugerichtete Federn, Daunen, künstliche Blumen",12370000,23598000,35968000
2024,2,WA68,"Waren aus Steinen, Gips, Zement usw.",474981000,317106000,792087000
2024,2,WA69,Keramische Waren,326105000,242097000,568202000
2024,2,WA70,Glas und Glaswaren,653065000,485209000,1138274000
2024,2,WA71,"Perlen, Edelsteine, Edelmetalle",1888549000,1479860000,3368409000
2024,2,WA72,Eisen und Stahl,2630358000,2322655000,4953013000
2024,2,WA73,Waren aus Eisen oder Stahl,2800881000,2156674000,4957555000
2024,2,WA74,Kupfer und Waren daraus,1218629000,880153000,2098782000
2024,2,WA75,Nickel und Waren daraus,172430000,211424000,383854000
2024,2,WA76,Aluminium und Waren daraus,1502147000,1643451000,3145598000
2024,2,WA78,Blei und Waren daraus,52314000,50149000,102463000
2024,2,WA79,Zink und Waren daraus,61567000,117579000,179146000
2024,2,WA80,Zinn und Waren daraus,11043000,40164000,51207000
2024,2,WA81,"Andere unedle Metalle, Cermets usw.",148626000,175407000,324033000
2024,2,WA82,"Werkzeuge, Schneidwaren, Essbestecke",861866000,480973000,1342839000
2024,2,WA83,Verschiedene Waren aus unedlen Metallen,738863000,490822000,1229685000
2024,2,WA84,"Maschinen, Apparate, mechanische Geräte",21373121000,13489362000,34862483000
2024,2,WA85,Elektrotechnische Erzeugnisse,13926167000,15372046000,29298213000
2024,2,WA86,Schienenfahrzeuge,231779000,307738000,539517000
2024,2,WA87,"Kraftfahrzeuge, Landfahrzeuge",23884296000,11629215000,35513511000
2024,2,WA88,"Luftfahrzeuge, Raumfahrzeuge",2263731000,848948000,3112679000
2024,2,WA89,Wasserfahrzeuge,144814000,638443000,783257000
2024,2,WA90,"Optische, photografische usw. Erzeugnisse",6574346000,3843389000,10417735000
2024,2,WA91,Uhrmacherwaren,139414000,212580000,351994000
2024,2,WA92,Musikinstrumente,79237000,63905000,143142000
2024,2,WA93,Waffen und Munition,60745000,35521000,96266000
2024,2,WA94,"Möbel, Beleuchtungskörper usw.",1488205000,1898333000,3386538000
2024,2,WA95,"Spielzeug, Spiele usw., Sportgeräte",369657000,530211000,899868000
2024,2,WA96,Verschiedene Waren,350741000,299412000,650153000
2024,2,WA97,"Kunstgegenstände, Sammlungsstücke",172528000,42728000,215256000
2024,2,WA98,Vollständige Fabrikationsanlagen,87000000,0,87000000
2024,2,WA99,Zusammenstellungen verschiedener Waren,1234851000,1004195000,2239046000
2024,3,WA01,Lebende Tiere,137941000,162299000,300240000
2024,3,WA02,Fleisch,650949000,655505000,1306454000
2024,3,WA03,"Fische, Krebs- und Weichtiere",100604000,355018000,455622000
2024,3,WA04,"Milch, Milcherzeugnisse, Eier, Honig",1082087000,985616000,2067703000
2024,3,WA05,Andere Waren tierischen Ursprungs,76670000,90738000,167408000
2024,3,WA06,"Pflanzen, Waren des Blumenhandels",116070000,376542000,492612000
2024,3,WA07,"Gemüse, Pflanzen für Ernährung",158370000,845335000,1003705000
2024,3,WA08,Genießbare Früchte und Nüsse,185071000,1092110000,1277181000
2024,3,WA09,"Kaffee, Tee, Mate, Gewürze",316523000,467078000,783601000
2024,3,WA10,Getreide,244345000,379348000,623693000
2024,3,WA11,"Müllereierzeugnisse, Malz usw.",214391000,91108000,305499000
2024,3,WA12,"Ölsamen usw., Heilpflanzen usw.",251480000,621961000,873441000
2024,3,WA13,"Schellack, Gummen, Harz, Pflanzensaft",69352000,58029000,127381000
2024,3,WA14,Flechtstoffe usw. pflanzlichen Ursprungs,1202000,4066000,5268000
2024,3,WA15,"Tierische und pflanzliche Fette, Öle, Wachs",256918000,421067000,677985000
2024,3,WA16,"Zubereitungen von Fleisch, Fisch usw.",297163000,310249000,607412000
2024,3,WA17,Zucker und Zuckerwaren,290723000,208791000,499514000
2024,3,WA18,Kakao und Zubereitungen aus Kakao,615236000,629141000,1244377000
2024,3,WA19,"Zubereitungen aus Getreide usw., Backwaren",807685000,594978000,1402663000
2024,3,WA20,"Zubereitungen von Gemüse, Früchten usw.",289917000,570766000,860683000
2024,3,WA21,Verschiedene Lebensmittelzubereitungen,770545000,493342000,1263887000
2024,3,WA22,"Getränke, alkoholhaltige Flüssigkeiten, Essig",590128000,730460000,1320588000
2024,3,WA23,"Rückstände der Lebensmittelindustrie, Futter",510198000,468618000,978816000
2024,3,WA24,Tabak,270072000,492218000,762290000
2024,3,WA25,"Salz, Schwefel, Steine, Erden usw.",217543000,175637000,393180000
2024,3,WA26,"Erze, Schlacken, Aschen",72560000,984236000,1056796000
2024,3,WA27,Mineralische Brennstoffe usw.,3001104000,9499219000,12500323000
2024,3,WA28,Anorganische chemische Erzeugnisse,1133801000,731137000,1864938000
2024,3,WA29,Organische chemische Erzeugnisse,2374584000,3340580000,5715164000
2024,3,WA30,Pharmazeutische Erzeugnisse,10227314000,6308609000,16535923000
2024,3,WA31,Düngemittel,286211000,156868000,443079000
2024,3,WA32,"Gerb- und Farbstoffe, Farben, Lacke usw.",1043323000,474898000,1518221000
2024,3,WA33,"Etherische Öle, Riech-, Schönheitsmittel",1042778000,731108000,1773886000
2024,3,WA34,"Seifen, Waschmittel usw.",766425000,451549000,1217974000
2024,3,WA35,"Eiweißstoffe, Klebstoffe, Enzyme",410969000,239487000,650456000
2024,3,WA36,"Sprengstoffe, pyrotechnische Artikel usw.",34678000,19094000,53772000
2024,3,WA37,Photochemische Erzeugnisse,82756000,49574000,132330000
2024,3,WA38,Verschiedene Erzeugnisse der Chemischen Industrie,2902347000,1744144000,4646491000
2024,3,WA39,Kunststoffe und Waren daraus,6108599000,3934204000,10042803000
2024,3,WA40,Kautschuk und Waren daraus,1463386000,1355285000,2818671000
2024,3,WA41,"Häute, Felle, Leder",61222000,47962000,109184000
2024,3,WA42,"Lederwaren, Sattlerwaren",254238000,391012000,645250000
2024,3,WA43,"Pelzfelle, künstliches Pelzwerk",3282000,3297000,6579000
2024,3,WA44,"Holz, Holzwaren, Holzkohle",866255000,690948000,1557203000
2024,3,WA45,"Kork, Korkwaren",2049000,7657000,9706000
2024,3,WA46,"Flechtwaren, Korbmacherwaren",6267000,12483000,18750000
2024,3,WA47,"Halbstoffe aus Holz usw., Papierabfall",124147000,347142000,471289000
2024,3,WA48,"Papier, Pappe und Waren daraus",1681541000,1089455000,2770996000
2024,3,WA49,"Bücher, Zeitungen, Bilddrucke usw.",268980000,225427000,494407000
2024,3,WA50,Seide,1451000,5646000,7097000
2024,3,WA51,"Wolle, feine und grobe Tierhaare",34974000,40725000,75699000
2024,3,WA52,Baumwolle,47994000,49506000,97500000
2024,3,WA53,"Andere pflanzliche Spinnstoffe, Papiergarn",2978000,5539000,8517000
2024,3,WA54,Synthetisches oder künstliches Filament,142202000,118304000,260506000
2024,3,WA55,Synthetische oder künstliche Spinnfaser,126051000,108268000,234319000
2024,3,WA56,"Watte, Filz, Vliesstoff usw., Tauwerk",232559000,139480000,372039000
2024,3,WA57,"Teppiche, Fußbodenbelag aus Spinnstoff",50632000,92658000,143290000
2024,3,WA58,"Spezialgewebe, Spitzen, Tapisserien",46192000,21999000,68191000
2024,3,WA59,"Getränkte, bestrichene usw. Gewebe",229973000,106862000,336835000
2024,3,WA60,Gewirke und Gestricke,60606000,38828000,99434000
2024,3,WA61,"Bekleidung usw. aus Gewirken, Gestricken",1034847000,1584038000,2618885000
2024,3,WA62,"Andere Bekleidung, Bekleidungszubehör",1134553000,1607434000,2741987000
2024,3,WA63,"Andere Konfektion, Spinnstoffwaren usw.",262592000,351603000,614195000
2024,3,WA64,"Schuhe, Gamaschen, ähnliche Waren",973994000,1095707000,2069701000
2024,3,WA65,Kopfbedeckungen und Teile davon,66813000,80261000,147074000
2024,3,WA66,"Schirme, Gehstöcke usw., Peitschen",9908000,25627000,35535000
2024,3,WA67,"Zugerichtete Federn, Daunen, künstliche Blumen",17519000,21584000,39103000
2024,3,WA68,"Waren aus Steinen, Gips, Zement usw.",492021000,309589000,801610000
2024,3,WA69,Keramische Waren,340008000,252541000,592549000
2024,3,WA70,Glas und Glaswaren,637474000,468778000,1106252000
2024,3,WA71,"Perlen, Edelsteine, Edelmetalle",1999954000,1599726000,3599680000
2024,3,WA72,Eisen und Stahl,2609570000,2313757000,4923327000
2024,3,WA73,Waren aus Eisen oder Stahl,2874600000,2195687000,5070287000
2024,3,WA74,Kupfer und Waren daraus,1154985000,1230963000,2385948000
2024,3,WA75,Nickel und Waren daraus,159813000,175218000,335031000
2024,3,WA76,Aluminium und Waren daraus,1480617000,1638007000,3118624000
2024,3,WA78,Blei und Waren daraus,33731000,51399000,85130000
2024,3,WA79,Zink und Waren daraus,61783000,104329000,166112000
2024,3,WA80,Zinn und Waren daraus,11345000,35356000,46701000
2024,3,WA81,"Andere unedle Metalle, Cermets usw.",144622000,186890000,331512000
2024,3,WA82,"Werkzeuge, Schneidwaren, Essbestecke",838633000,495078000,1333711000
2024,3,WA83,Verschiedene Waren aus unedlen Metallen,734833000,487061000,1221894000
2024,3,WA84,"Maschinen, Apparate, mechanische Geräte",22273684000,13635478000,35909162000
2024,3,WA85,Elektrotechnische Erzeugnisse,14389486000,15581658000,29971144000
2024,3,WA86,Schienenfahrzeuge,357805000,287742000,645547000
2024,3,WA87,"Kraftfahrzeuge, Landfahrzeuge",23982616000,12332637000,36315253000
2024,3,WA88,"Luftfahrzeuge, Raumfahrzeuge",3016258000,1054219000,4070477000
2024,3,WA89,Wasserfahrzeuge,103137000,837354000,940491000
2024,3,WA90,"Optische, photografische usw. Erzeugnisse",6945940000,3839754000,10785694000
2024,3,WA91,Uhrmacherwaren,154110000,203648000,357758000
2024,3,WA92,Musikinstrumente,80733000,52971000,133704000
2024,3,WA93,Waffen und Munition,71414000,25600000,97014000
2024,3,WA94,"Möbel, Beleuchtungskörper usw.",1444404000,1961775000,3406179000
2024,3,WA95,"Spielzeug, Spiele usw., Sportgeräte",364491000,568516000,933007000
2024,3,WA96,Verschiedene Waren,358592000,294287000,652879000
2024,3,WA97,"Kunstgegenstände, Sammlungsstücke",82643000,100193000,182836000
2024,3,WA98,Vollständige Fabrikationsanlagen,90873000,13000,90886000
2024,3,WA99,Zusammenstellungen verschiedener Waren,1219251000,975734000,2194985000
2024,4,WA01,Lebende Tiere,127902000,159523000,287425000
2024,4,WA02,Fleisch,660236000,696782000,1357018000
2024,4,WA03,"Fische, Krebs- und Weichtiere",115573000,371853000,487426000
2024,4,WA04,"Milch, Milcherzeugnisse, Eier, Honig",1123010000,1031709000,2154719000
2024,4,WA05,Andere Waren tierischen Ursprungs,81977000,96056000,178033000
2024,4,WA06,"Pflanzen, Waren des Blumenhandels",141029000,408214000,549243000
2024,4,WA07,"Gemüse, Pflanzen für Ernährung",165261000,851545000,1016806000
2024,4,WA08,Genießbare Früchte und Nüsse,190486000,1118550000,1309036000
2024,4,WA09,"Kaffee, Tee, Mate, Gewürze",353190000,513839000,867029000
2024,4,WA10,Getreide,235758000,374570000,610328000
2024,4,WA11,"Müllereierzeugnisse, Malz usw.",222773000,92828000,315601000
2024,4,WA12,"Ölsamen usw., Heilpflanzen usw.",154521000,571677000,726198000
2024,4,WA13,"Schellack, Gummen, Harz, Pflanzensaft",63906000,64776000,128682000
2024,4,WA14,Flechtstoffe usw. pflanzlichen Ursprungs,1315000,3990000,5305000
2024,4,WA15,"Tierische und pflanzliche Fette, Öle, Wachs",307310000,482074000,789384000
2024,4,WA16,"Zubereitungen von Fleisch, Fisch usw.",319632000,321438000,641070000
2024,4,WA17,Zucker und Zuckerwaren,303466000,222492000,525958000
2024,4,WA18,Kakao und Zubereitungen aus Kakao,654982000,653237000,1308219000
2024,4,WA19,"Zubereitungen aus Getreide usw., Backwaren",816953000,595503000,1412456000
2024,4,WA20,"Zubereitungen von Gemüse, Früchten usw.",354040000,616318000,970358000
2024,4,WA21,Verschiedene Lebensmittelzubereitungen,812750000,502247000,1314997000
2024,4,WA22,"Getränke, alkoholhaltige Flüssigkeiten, Essig",693558000,802184000,1495742000
2024,4,WA23,"Rückstände der Lebensmittelindustrie, Futter",601350000,523804000,1125154000
2024,4,WA24,Tabak,279116000,501199000,780315000
2024,4,WA25,"Salz, Schwefel, Steine, Erden usw.",226002000,180723000,406725000
2024,4,WA26,"Erze, Schlacken, Aschen",85044000,944255000,1029299000
2024,4,WA27,Mineralische Brennstoffe usw.,2858872000,9351951000,12210823000
2024,4,WA28,Anorganische chemische Erzeugnisse,1099965000,860935000,1960900000
2024,4,WA29,Organische chemische Erzeugnisse,2494770000,3998236000,6493006000
2024,4,WA30,Pharmazeutische Erzeugnisse,9419496000,5928171000,15347667000
2024,4,WA31,Düngemittel,235083000,174291000,409374000
2024,4,WA32,"Gerb- und Farbstoffe, Farben, Lacke usw.",1057307000,508334000,1565641000
2024,4,WA33,"Etherische Öle, Riech-, Schönheitsmittel",1058475000,787863000,1846338000
2024,4,WA34,"Seifen, Waschmittel usw.",803690000,469425000,1273115000
2024,4,WA35,"Eiweißstoffe, Klebstoffe, Enzyme",423675000,264833000,688508000
2024,4,WA36,"Sprengstoffe, pyrotechnische Artikel usw.",46715000,22412000,69127000
2024,4,WA37,Photochemische Erzeugnisse,84111000,60879000,144990000
2024,4,WA38,Verschiedene Erzeugnisse der Chemischen Industrie,2863592000,1887947000,4751539000
2024,4,WA39,Kunststoffe und Waren daraus,6210324000,4214531000,10424855000
2024,4,WA40,Kautschuk und Waren daraus,1536742000,1493462000,3030204000
2024,4,WA41,"Häute, Felle, Leder",52583000,41336000,93919000
2024,4,WA42,"Lederwaren, Sattlerwaren",241185000,330095000,571280000
2024,4,WA43,"Pelzfelle, künstliches Pelzwerk",4165000,4824000,8989000
2024,4,WA44,"Holz, Holzwaren, Holzkohle",886781000,732567000,1619348000
2024,4,WA45,"Kork, Korkwaren",2037000,8884000,10921000
2024,4,WA46,"Flechtwaren, Korbmacherwaren",6838000,13303000,20141000
2024,4,WA47,"Halbstoffe aus Holz usw., Papierabfall",126946000,393643000,520589000
2024,4,WA48,"Papier, Pappe und Waren daraus",1768958000,1177243000,2946201000
2024,4,WA49,"Bücher, Zeitungen, Bilddrucke usw.",277231000,216835000,494066000
2024,4,WA50,Seide,2052000,3611000,5663000
2024,4,WA51,"Wolle, feine und grobe Tierhaare",35709000,43883000,79592000
2024,4,WA52,Baumwolle,53829000,53979000,107808000
2024,4,WA53,"Andere pflanzliche Spinnstoffe, Papiergarn",2948000,5895000,8843000
2024,4,WA54,Synthetisches oder künstliches Filament,143920000,118479000,262399000
2024,4,WA55,Synthetische oder künstliche Spinnfaser,123369000,121577000,244946000
2024,4,WA56,"Watte, Filz, Vliesstoff usw., Tauwerk",240572000,163483000,404055000
2024,4,WA57,"Teppiche, Fußbodenbelag aus Spinnstoff",53202000,94892000,148094000
2024,4,WA58,"Spezialgewebe, Spitzen, Tapisserien",47375000,23082000,70457000
2024,4,WA59,"Getränkte, bestrichene usw. Gewebe",243247000,119725000,362972000
2024,4,WA60,Gewirke und Gestricke,60870000,44329000,105199000
2024,4,WA61,"Bekleidung usw. aus Gewirken, Gestricken",1009686000,1561668000,2571354000
2024,4,WA62,"Andere Bekleidung, Bekleidungszubehör",1088810000,1523609000,2612419000
2024,4,WA63,"Andere Konfektion, Spinnstoffwaren usw.",277884000,368159000,646043000
2024,4,WA64,"Schuhe, Gamaschen, ähnliche Waren",883326000,1067036000,1950362000
2024,4,WA65,Kopfbedeckungen und Teile davon,63948000,73232000,137180000
2024,4,WA66,"Schirme, Gehstöcke usw., Peitschen",12965000,26075000,39040000
2024,4,WA67,"Zugerichtete Federn, Daunen, künstliche Blumen",13233000,20008000,33241000
2024,4,WA68,"Waren aus Steinen, Gips, Zement usw.",503860000,324371000,828231000
2024,4,WA69,Keramische Waren,364396000,257261000,621657000
2024,4,WA70,Glas und Glaswaren,689133000,502563000,1191696000
2024,4,WA71,"Perlen, Edelsteine, Edelmetalle",2690984000,1720538000,4411522000
2024,4,WA72,Eisen und Stahl,2637833000,2499739000,5137572000
2024,4,WA73,Waren aus Eisen oder Stahl,2905023000,2307018000,5212041000
2024,4,WA74,Kupfer und Waren daraus,1325581000,1274516000,2600097000
2024,4,WA75,Nickel und Waren daraus,175614000,189932000,365546000
2024,4,WA76,Aluminium und Waren daraus,1559868000,1740084000,3299952000
2024,4,WA78,Blei und Waren daraus,65102000,53097000,118199000
2024,4,WA79,Zink und Waren daraus,68308000,118633000,186941000
2024,4,WA80,Zinn und Waren daraus,9544000,37960000,47504000
2024,4,WA81,"Andere unedle Metalle, Cermets usw.",157944000,178943000,336887000
2024,4,WA82,"Werkzeuge, Schneidwaren, Essbestecke",841580000,494950000,1336530000
2024,4,WA83,Verschiedene Waren aus unedlen Metallen,755546000,488526000,1244072000
2024,4,WA84,"Maschinen, Apparate, mechanische Geräte",22699849000,14263739000,36963588000
2024,4,WA85,Elektrotechnische Erzeugnisse,14738235000,16042118000,30780353000
2024,4,WA86,Schienenfahrzeuge,247302000,307796000,555098000
2024,4,WA87,"Kraftfahrzeuge, Landfahrzeuge",24221734000,12409694000,36631428000
2024,4,WA88,"Luftfahrzeuge, Raumfahrzeuge",3206601000,1002280000,4208881000
2024,4,WA89,Wasserfahrzeuge,1222474000,313556000,1536030000
2024,4,WA90,"Optische, photografische usw. Erzeugnisse",6738837000,4159176000,10898013000
2024,4,WA91,Uhrmacherwaren,156127000,215641000,371768000
2024,4,WA92,Musikinstrumente,84543000,61394000,145937000
2024,4,WA93,Waffen und Munition,66277000,32718000,98995000
2024,4,WA94,"Möbel, Beleuchtungskörper usw.",1516102000,1865058000,3381160000
2024,4,WA95,"Spielzeug, Spiele usw., Sportgeräte",369674000,553761000,923435000
2024,4,WA96,Verschiedene Waren,362792000,299739000,662531000
2024,4,WA97,"Kunstgegenstände, Sammlungsstücke",73377000,58528000,131905000
2024,4,WA98,Vollständige Fabrikationsanlagen,70172000,0,70172000
2024,4,WA99,Zusammenstellungen verschiedener Waren,1259946000,1088830000,2348776000
2024,5,WA01,Lebende Tiere,113929000,139831000,253760000
2024,5,WA02,Fleisch,602105000,640244000,1242349000
2024,5,WA03,"Fische, Krebs- und Weichtiere",105593000,294861000,400454000
2024,5,WA04,"Milch, Milcherzeugnisse, Eier, Honig",1070935000,932046000,2002981000
2024,5,WA05,Andere Waren tierischen Ursprungs,75907000,85558000,161465000
2024,5,WA06,"Pflanzen, Waren des Blumenhandels",106403000,375474000,481877000
2024,5,WA07,"Gemüse, Pflanzen für Ernährung",147129000,750064000,897193000
2024,5,WA08,Genießbare Früchte und Nüsse,175856000,1111670000,1287526000
2024,5,WA09,"Kaffee, Tee, Mate, Gewürze",336687000,502993000,839680000
2024,5,WA10,Getreide,236298000,285606000,521904000
2024,5,WA11,"Müllereierzeugnisse, Malz usw.",192178000,81450000,273628000
2024,5,WA12,"Ölsamen usw., Heilpflanzen usw.",134096000,453813000,587909000
2024,5,WA13,"Schellack, Gummen, Harz, Pflanzensaft",54278000,61719000,115997000
2024,5,WA14,Flechtstoffe usw. pflanzlichen Ursprungs,1024000,4952000,5976000
2024,5,WA15,"Tierische und pflanzliche Fette, Öle, Wachs",321723000,375091000,696814000
2024,5,WA16,"Zubereitungen von Fleisch, Fisch usw.",319531000,316097000,635628000
2024,5,WA17,Zucker und Zuckerwaren,300543000,215991000,516534000
2024,5,WA18,Kakao und Zubereitungen aus Kakao,652360000,640491000,1292851000
2024,5,WA19,"Zubereitungen aus Getreide usw., Backwaren",787398000,584486000,1371884000
2024,5,WA20,"Zubereitungen von Gemüse, Früchten usw.",319293000,558235000,877528000
2024,5,WA21,Verschiedene Lebensmittelzubereitungen,805924000,520567000,1326491000
2024,5,WA22,"Getränke, alkoholhaltige Flüssigkeiten, Essig",639002000,730892000,1369894000
2024,5,WA23,"Rückstände der Lebensmittelindustrie, Futter",612021000,475816000,1087837000
2024,5,WA24,Tabak,270864000,488911000,759775000
2024,5,WA25,"Salz, Schwefel, Steine, Erden usw.",212533000,157671000,370204000
2024,5,WA26,"Erze, Schlacken, Aschen",61752000,643198000,704950000
2024,5,WA27,Mineralische Brennstoffe usw.,2822480000,9392064000,12214544000
2024,5,WA28,Anorganische chemische Erzeugnisse,992674000,616375000,1609049000
2024,5,WA29,Organische chemische Erzeugnisse,2607430000,2870978000,5478408000
2024,5,WA30,Pharmazeutische Erzeugnisse,9030499000,5621604000,14652103000
2024,5,WA31,Düngemittel,213201000,102770000,315971000
2024,5,WA32,"Gerb- und Farbstoffe, Farben, Lacke usw.",996797000,457320000,1454117000
2024,5,WA33,"Etherische Öle, Riech-, Schönheitsmittel",976910000,747681000,1724591000
2024,5,WA34,"Seifen, Waschmittel usw.",751840000,416191000,1168031000
2024,5,WA35,"Eiweißstoffe, Klebstoffe, Enzyme",411569000,236395000,647964000
2024,5,WA36,"Sprengstoffe, pyrotechnische Artikel usw.",32173000,19459000,51632000
2024,5,WA37,Photochemische Erzeugnisse,84600000,50888000,135488000
2024,5,WA38,Verschiedene Erzeugnisse der Chemischen Industrie,2762334000,1654652000,4416986000
2024,5,WA39,Kunststoffe und Waren daraus,5786689000,3796264000,9582953000
2024,5,WA40,Kautschuk und Waren daraus,1358099000,1228837000,2586936000
2024,5,WA41,"Häute, Felle, Leder",46616000,42746000,89362000
2024,5,WA42,"Lederwaren, Sattlerwaren",245477000,393901000,639378000
2024,5,WA43,"Pelzfelle, künstliches Pelzwerk",4152000,4707000,8859000
2024,5,WA44,"Holz, Holzwaren, Holzkohle",838529000,683278000,1521807000
2024,5,WA45,"Kork, Korkwaren",2006000,7037000,9043000
2024,5,WA46,"Flechtwaren, Korbmacherwaren",6333000,13835000,20168000
2024,5,WA47,"Halbstoffe aus Holz usw., Papierabfall",122489000,375296000,497785000
2024,5,WA48,"Papier, Pappe und Waren daraus",1676754000,1080155000,2756909000
2024,5,WA49,"Bücher, Zeitungen, Bilddrucke usw.",260877000,199428000,460305000
2024,5,WA50,Seide,2019000,3859000,5878000
2024,5,WA51,"Wolle, feine und grobe Tierhaare",36179000,38912000,75091000
2024,5,WA52,Baumwolle,44302000,51813000,96115000
2024,5,WA53,"Andere pflanzliche Spinnstoffe, Papiergarn",2348000,6126000,8474000
2024,5,WA54,Synthetisches oder künstliches Filament,127163000,118817000,245980000
2024,5,WA55,Synthetische oder künstliche Spinnfaser,115657000,116808000,232465000
2024,5,WA56,"Watte, Filz, Vliesstoff usw., Tauwerk",217625000,140372000,357997000
2024,5,WA57,"Teppiche, Fußbodenbelag aus Spinnstoff",51132000,95305000,146437000
2024,5,WA58,"Spezialgewebe, Spitzen, Tapisserien",44685000,21615000,66300000
2024,5,WA59,"Getränkte, bestrichene usw. Gewebe",220487000,103079000,323566000
2024,5,WA60,Gewirke und Gestricke,55861000,35922000,91783000
2024,5,WA61,"Bekleidung usw. aus Gewirken, Gestricken",1014836000,1566829000,2581665000
2024,5,WA62,"Andere Bekleidung, Bekleidungszubehör",1033800000,1495085000,2528885000
2024,5,WA63,"Andere Konfektion, Spinnstoffwaren usw.",250529000,356012000,606541000
2024,5,WA64,"Schuhe, Gamaschen, ähnliche Waren",842243000,965224000,1807467000
2024,5,WA65,Kopfbedeckungen und Teile davon,61155000,73925000,135080000
2024,5,WA66,"Schirme, Gehstöcke usw., Peitschen",10294000,26652000,36946000
2024,5,WA67,"Zugerichtete Federn, Daunen, künstliche Blumen",11588000,19609000,31197000
2024,5,WA68,"Waren aus Steinen, Gips, Zement usw.",452115000,285671000,737786000
2024,5,WA69,Keramische Waren,317474000,226834000,544308000
2024,5,WA70,Glas und Glaswaren,626913000,438593000,1065506000
2024,5,WA71,"Perlen, Edelsteine, Edelmetalle",2108554000,1430661000,3539215000
2024,5,WA72,Eisen und Stahl,2459532000,2272181000,4731713000
2024,5,WA73,Waren aus Eisen oder Stahl,2814920000,2058256000,4873176000
2024,5,WA74,Kupfer und Waren daraus,1273204000,1180285000,2453489000
2024,5,WA75,Nickel und Waren daraus,155671000,205840000,361511000
2024,5,WA76,Aluminium und Waren daraus,1621921000,1683247000,3305168000
2024,5,WA78,Blei und Waren daraus,36599000,44967000,81566000
2024,5,WA79,Zink und Waren daraus,65652000,106400000,172052000
2024,5,WA80,Zinn und Waren daraus,14029000,41393000,55422000
2024,5,WA81,"Andere unedle Metalle, Cermets usw.",140432000,174496000,314928000
2024,5,WA82,"Werkzeuge, Schneidwaren, Essbestecke",748943000,460482000,1209425000
2024,5,WA83,Verschiedene Waren aus unedlen Metallen,677846000,443805000,1121651000
2024,5,WA84,"Maschinen, Apparate, mechanische Geräte",20159616000,13008684000,33168300000
2024,5,WA85,Elektrotechnische Erzeugnisse,13417794000,14944223000,28362017000
2024,5,WA86,Schienenfahrzeuge,280484000,260194000,540678000
2024,5,WA87,"Kraftfahrzeuge, Landfahrzeuge",22528212000,11756351000,34284563000
2024,5,WA88,"Luftfahrzeuge, Raumfahrzeuge",2500898000,896359000,3397257000
2024,5,WA89,Wasserfahrzeuge,643522000,244213000,887735000
2024,5,WA90,"Optische, photografische usw. Erzeugnisse",6230640000,3658332000,9888972000
2024,5,WA91,Uhrmacherwaren,166805000,210224000,377029000
2024,5,WA92,Musikinstrumente,72642000,50142000,122784000
2024,5,WA93,Waffen und Munition,61357000,27309000,88666000
2024,5,WA94,"Möbel, Beleuchtungskörper usw.",1370482000,1697967000,3068449000
2024,5,WA95,"Spielzeug, Spiele usw., Sportgeräte",336942000,548445000,885387000
2024,5,WA96,Verschiedene Waren,342879000,288563000,631442000
2024,5,WA97,"Kunstgegenstände, Sammlungsstücke",54483000,48732000,103215000
2024,5,WA98,Vollständige Fabrikationsanlagen,112024000,0,112024000
2024,5,WA99,Zusammenstellungen verschiedener Waren,1422082000,1043464000,2465546000
2024,6,WA01,Lebende Tiere,112799000,152106000,264905000
2024,6,WA02,Fleisch,607630000,628076000,1235706000
2024,6,WA03,"Fische, Krebs- und Weichtiere",111651000,325975000,437626000
2024,6,WA04,"Milch, Milcherzeugnisse, Eier, Honig",1048069000,947067000,1995136000
2024,6,WA05,Andere Waren tierischen Ursprungs,70767000,86760000,157527000
2024,6,WA06,"Pflanzen, Waren des Blumenhandels",62877000,237224000,300101000
2024,6,WA07,"Gemüse, Pflanzen für Ernährung",140630000,647244000,787874000
2024,6,WA08,Genießbare Früchte und Nüsse,159788000,1106919000,1266707000
2024,6,WA09,"Kaffee, Tee, Mate, Gewürze",316946000,520548000,837494000
2024,6,WA10,Getreide,256345000,291533000,547878000
2024,6,WA11,"Müllereierzeugnisse, Malz usw.",189241000,86340000,275581000
2024,6,WA12,"Ölsamen usw., Heilpflanzen usw.",124416000,478409000,602825000
2024,6,WA13,"Schellack, Gummen, Harz, Pflanzensaft",60026000,56203000,116229000
2024,6,WA14,Flechtstoffe usw. pflanzlichen Ursprungs,1071000,3995000,5066000
2024,6,WA15,"Tierische und pflanzliche Fette, Öle, Wachs",233652000,434300000,667952000
2024,6,WA16,"Zubereitungen von Fleisch, Fisch usw.",289312000,297765000,587077000
2024,6,WA17,Zucker und Zuckerwaren,321992000,219717000,541709000
2024,6,WA18,Kakao und Zubereitungen aus Kakao,692763000,658532000,1351295000
2024,6,WA19,"Zubereitungen aus Getreide usw., Backwaren",778606000,566664000,1345270000
2024,6,WA20,"Zubereitungen von Gemüse, Früchten usw.",294757000,581080000,875837000
2024,6,WA21,Verschiedene Lebensmittelzubereitungen,792679000,487234000,1279913000
2024,6,WA22,"Getränke, alkoholhaltige Flüssigkeiten, Essig",681527000,769253000,1450780000
2024,6,WA23,"Rückstände der Lebensmittelindustrie, Futter",538204000,423354000,961558000
2024,6,WA24,Tabak,271092000,466577000,737669000
2024,6,WA25,"Salz, Schwefel, Steine, Erden usw.",213437000,166051000,379488000
2024,6,WA26,"Erze, Schlacken, Aschen",68044000,617322000,685366000
2024,6,WA27,Mineralische Brennstoffe usw.,2736125000,9037787000,11773912000
2024,6,WA28,Anorganische chemische Erzeugnisse,1033346000,723865000,1757211000
2024,6,WA29,Organische chemische Erzeugnisse,2347665000,2606378000,4954043000
2024,6,WA30,Pharmazeutische Erzeugnisse,9204868000,5586231000,14791099000
2024,6,WA31,Düngemittel,223225000,118920000,342145000
2024,6,WA32,"Gerb- und Farbstoffe, Farben, Lacke usw.",1013957000,459180000,1473137000
2024,6,WA33,"Etherische Öle, Riech-, Schönheitsmittel",994776000,748841000,1743617000
2024,6,WA34,"Seifen, Waschmittel usw.",756231000,434664000,1190895000
2024,6,WA35,"Eiweißstoffe, Klebstoffe, Enzyme",383208000,255780000,638988000
2024,6,WA36,"Sprengstoffe, pyrotechnische Artikel usw.",51487000,29120000,80607000
2024,6,WA37,Photochemische Erzeugnisse,86965000,55847000,142812000
2024,6,WA38,Verschiedene Erzeugnisse der Chemischen Industrie,2704406000,1609416000,4313822000
2024,6,WA39,Kunststoffe und Waren daraus,5797933000,3860902000,9658835000
2024,6,WA40,Kautschuk und Waren daraus,1359547000,1291023000,2650570000
2024,6,WA41,"Häute, Felle, Leder",46926000,40694000,87620000
2024,6,WA42,"Lederwaren, Sattlerwaren",237602000,361314000,598916000
2024,6,WA43,"Pelzfelle, künstliches Pelzwerk",3004000,6242000,9246000
2024,6,WA44,"Holz, Holzwaren, Holzkohle",799600000,667529000,1467129000
2024,6,WA45,"Kork, Korkwaren",2416000,7494000,9910000
2024,6,WA46,"Flechtwaren, Korbmacherwaren",5300000,11213000,16513000
2024,6,WA47,"Halbstoffe aus Holz usw., Papierabfall",113628000,391461000,505089000
2024,6,WA48,"Papier, Pappe und Waren daraus",1705323000,1094224000,2799547000
2024,6,WA49,"Bücher, Zeitungen, Bilddrucke usw.",259895000,188648000,448543000
2024,6,WA50,Seide,1357000,3963000,5320000
2024,6,WA51,"Wolle, feine und grobe Tierhaare",34202000,37629000,71831000
2024,6,WA52,Baumwolle,47943000,51297000,99240000
2024,6,WA53,"Andere pflanzliche Spinnstoffe, Papiergarn",2251000,5114000,7365000
2024,6,WA54,Synthetisches oder künstliches Filament,125376000,113363000,238739000
2024,6,WA55,Synthetische oder künstliche Spinnfaser,121611000,119053000,240664000
2024,6,WA56,"Watte, Filz, Vliesstoff usw., Tauwerk",224885000,151537000,376422000
2024,6,WA57,"Teppiche, Fußbodenbelag aus Spinnstoff",45359000,83822000,129181000
2024,6,WA58,"Spezialgewebe, Spitzen, Tapisserien",42956000,22491000,65447000
2024,6,WA59,"Getränkte, bestrichene usw. Gewebe",219919000,107861000,327780000
2024,6,WA60,Gewirke und Gestricke,54863000,35420000,90283000
2024,6,WA61,"Bekleidung usw. aus Gewirken, Gestricken",958865000,1449094000,2407959000
2024,6,WA62,"Andere Bekleidung, Bekleidungszubehör",901842000,1287894000,2189736000
2024,6,WA63,"Andere Konfektion, Spinnstoffwaren usw.",250671000,380036000,630707000
2024,6,WA64,"Schuhe, Gamaschen, ähnliche Waren",879710000,978680000,1858390000
2024,6,WA65,Kopfbedeckungen und Teile davon,56339000,70472000,126811000
2024,6,WA66,"Schirme, Gehstöcke usw., Peitschen",10937000,21532000,32469000
2024,6,WA67,"Zugerichtete Federn, Daunen, künstliche Blumen",10798000,19137000,29935000
2024,6,WA68,"Waren aus Steinen, Gips, Zement usw.",460939000,314563000,775502000
2024,6,WA69,Keramische Waren,318332000,236995000,555327000
2024,6,WA70,Glas und Glaswaren,646213000,474243000,1120456000
2024,6,WA71,"Perlen, Edelsteine, Edelmetalle",1850445000,1724037000,3574482000
2024,6,WA72,Eisen und Stahl,2421763000,2373084000,4794847000
2024,6,WA73,Waren aus Eisen oder Stahl,2740151000,2118047000,4858198000
2024,6,WA74,Kupfer und Waren daraus,1204627000,1107345000,2311972000
2024,6,WA75,Nickel und Waren daraus,159882000,173639000,333521000
2024,6,WA76,Aluminium und Waren daraus,1599996000,1758199000,3358195000
2024,6,WA78,Blei und Waren daraus,43269000,64156000,107425000
2024,6,WA79,Zink und Waren daraus,75966000,122943000,198909000
2024,6,WA80,Zinn und Waren daraus,10156000,44722000,54878000
2024,6,WA81,"Andere unedle Metalle, Cermets usw.",136774000,181165000,317939000
2024,6,WA82,"Werkzeuge, Schneidwaren, Essbestecke",742489000,473214000,1215703000
2024,6,WA83,Verschiedene Waren aus unedlen Metallen,696559000,462152000,1158711000
2024,6,WA84,"Maschinen, Apparate, mechanische Geräte",21023181000,13098681000,34121862000
2024,6,WA85,Elektrotechnische Erzeugnisse,14039111000,15072268000,29111379000
2024,6,WA86,Schienenfahrzeuge,250270000,269354000,519624000
2024,6,WA87,"Kraftfahrzeuge, Landfahrzeuge",22237897000,11369670000,33607567000
2024,6,WA88,"Luftfahrzeuge, Raumfahrzeuge",2560665000,969306000,3529971000
2024,6,WA89,Wasserfahrzeuge,327257000,1296690000,1623947000
2024,6,WA90,"Optische, photografische usw. Erzeugnisse",6592495000,3758159000,10350654000
2024,6,WA91,Uhrmacherwaren,162374000,202939000,365313000
2024,6,WA92,Musikinstrumente,74575000,51855000,126430000
2024,6,WA93,Waffen und Munition,58608000,28431000,87039000
2024,6,WA94,"Möbel, Beleuchtungskörper usw.",1426995000,1730658000,3157653000
2024,6,WA95,"Spielzeug, Spiele usw., Sportgeräte",393096000,518420000,911516000
2024,6,WA96,Verschiedene Waren,351514000,287402000,638916000
2024,6,WA97,"Kunstgegenstände, Sammlungsstücke",53084000,72996000,126080000
2024,6,WA98,Vollständige Fabrikationsanlagen,83910000,0,83910000
2024,6,WA99,Zusammenstellungen verschiedener Waren,1385121000,1033131000,2418252000
2024,7,WA01,Lebende Tiere,119997000,150375000,270372000
2024,7,WA02,Fleisch,639356000,637309000,1276665000
2024,7,WA03,"Fische, Krebs- und Weichtiere",114989000,332833000,447822000
2024,7,WA04,"Milch, Milcherzeugnisse, Eier, Honig",1090118000,997022000,2087140000
2024,7,WA05,Andere Waren tierischen Ursprungs,73687000,94087000,167774000
2024,7,WA06,"Pflanzen, Waren des Blumenhandels",55828000,188578000,244406000
2024,7,WA07,"Gemüse, Pflanzen für Ernährung",158215000,620644000,778859000
2024,7,WA08,Genießbare Früchte und Nüsse,153681000,1192782000,1346463000
2024,7,WA09,"Kaffee, Tee, Mate, Gewürze",358978000,539201000,898179000
2024,7,WA10,Getreide,289278000,316790000,606068000
2024,7,WA11,"Müllereierzeugnisse, Malz usw.",189802000,88098000,277900000
2024,7,WA12,"Ölsamen usw., Heilpflanzen usw.",149471000,524314000,673785000
2024,7,WA13,"Schellack, Gummen, Harz, Pflanzensaft",56900000,60389000,117289000
2024,7,WA14,Flechtstoffe usw. pflanzlichen Ursprungs,975000,4284000,5259000
2024,7,WA15,"Tierische und pflanzliche Fette, Öle, Wachs",309960000,462543000,772503000
2024,7,WA16,"Zubereitungen von Fleisch, Fisch usw.",326603000,300623000,627226000
2024,7,WA17,Zucker und Zuckerwaren,342626000,227412000,570038000
2024,7,WA18,Kakao und Zubereitungen aus Kakao,833845000,871949000,1705794000
2024,7,WA19,"Zubereitungen aus Getreide usw., Backwaren",827154000,624194000,1451348000
2024,7,WA20,"Zubereitungen von Gemüse, Früchten usw.",312623000,640166000,952789000
2024,7,WA21,Verschiedene Lebensmittelzubereitungen,841007000,529954000,1370961000
2024,7,WA22,"Getränke, alkoholhaltige Flüssigkeiten, Essig",686036000,832466000,1518502000
2024,7,WA23,"Rückstände der Lebensmittelindustrie, Futter",602266000,511161000,1113427000
2024,7,WA24,Tabak,302576000,514962000,817538000
2024,7,WA25,"Salz, Schwefel, Steine, Erden usw.",218632000,184066000,402698000
2024,7,WA26,"Erze, Schlacken, Aschen",74788000,805893000,880681000
2024,7,WA27,Mineralische Brennstoffe usw.,2762215000,9271825000,12034040000
2024,7,WA28,Anorganische chemische Erzeugnisse,1075379000,803766000,1879145000
2024,7,WA29,Organische chemische Erzeugnisse,2372936000,4516944000,6889880000
2024,7,WA30,Pharmazeutische Erzeugnisse,10813832000,7074061000,17887893000
2024,7,WA31,Düngemittel,212223000,117734000,329957000
2024,7,WA32,"Gerb- und Farbstoffe, Farben, Lacke usw.",1025893000,515999000,1541892000
2024,7,WA33,"Etherische Öle, Riech-, Schönheitsmittel",1046906000,842516000,1889422000
2024,7,WA34,"Seifen, Waschmittel usw.",817865000,495754000,1313619000
2024,7,WA35,"Eiweißstoffe, Klebstoffe, Enzyme",426308000,275055000,701363000
2024,7,WA36,"Sprengstoffe, pyrotechnische Artikel usw.",29407000,34520000,63927000
2024,7,WA37,Photochemische Erzeugnisse,80447000,52903000,133350000
2024,7,WA38,Verschiedene Erzeugnisse der Chemischen Industrie,2759185000,1854279000,4613464000
2024,7,WA39,Kunststoffe und Waren daraus,5930268000,4145146000,10075414000
2024,7,WA40,Kautschuk und Waren daraus,1398796000,1292416000,2691212000
2024,7,WA41,"Häute, Felle, Leder",44911000,40341000,85252000
2024,7,WA42,"Lederwaren, Sattlerwaren",276009000,442789000,718798000
2024,7,WA43,"Pelzfelle, künstliches Pelzwerk",3868000,6695000,10563000
2024,7,WA44,"Holz, Holzwaren, Holzkohle",821050000,715399000,1536449000
2024,7,WA45,"Kork, Korkwaren",2366000,7540000,9906000
2024,7,WA46,"Flechtwaren, Korbmacherwaren",5471000,11325000,16796000
2024,7,WA47,"Halbstoffe aus Holz usw., Papierabfall",125875000,439133000,565008000
2024,7,WA48,"Papier, Pappe und Waren daraus",1760479000,1171055000,2931534000
2024,7,WA49,"Bücher, Zeitungen, Bilddrucke usw.",274440000,214106000,488546000
2024,7,WA50,Seide,1902000,4400000,6302000
2024,7,WA51,"Wolle, feine und grobe Tierhaare",28638000,34223000,62861000
2024,7,WA52,Baumwolle,40971000,54347000,95318000
2024,7,WA53,"Andere pflanzliche Spinnstoffe, Papiergarn",2351000,5628000,7979000
2024,7,WA54,Synthetisches oder künstliches Filament,137087000,117360000,254447000
2024,7,WA55,Synthetische oder künstliche Spinnfaser,124062000,123312000,247374000
2024,7,WA56,"Watte, Filz, Vliesstoff usw., Tauwerk",237634000,157131000,394765000
2024,7,WA57,"Teppiche, Fußbodenbelag aus Spinnstoff",51688000,91940000,143628000
2024,7,WA58,"Spezialgewebe, Spitzen, Tapisserien",44154000,22114000,66268000
2024,7,WA59,"Getränkte, bestrichene usw. Gewebe",231238000,108956000,340194000
2024,7,WA60,Gewirke und Gestricke,56010000,36577000,92587000
2024,7,WA61,"Bekleidung usw. aus Gewirken, Gestricken",1111757000,1932988000,3044745000
2024,7,WA62,"Andere Bekleidung, Bekleidungszubehör",1051413000,1653706000,2705119000
2024,7,WA63,"Andere Konfektion, Spinnstoffwaren usw.",280393000,400224000,680617000
2024,7,WA64,"Schuhe, Gamaschen, ähnliche Waren",987391000,1147136000,2134527000
2024,7,WA65,Kopfbedeckungen und Teile davon,67585000,90957000,158542000
2024,7,WA66,"Schirme, Gehstöcke usw., Peitschen",9397000,21618000,31015000
2024,7,WA67,"Zugerichtete Federn, Daunen, künstliche Blumen",11677000,25496000,37173000
2024,7,WA68,"Waren aus Steinen, Gips, Zement usw.",483421000,326257000,809678000
2024,7,WA69,Keramische Waren,316120000,266271000,582391000
2024,7,WA70,Glas und Glaswaren,644471000,482142000,1126613000
2024,7,WA71,"Perlen, Edelsteine, Edelmetalle",2032322000,1825919000,3858241000
2024,7,WA72,Eisen und Stahl,2465138000,2538289000,5003427000
2024,7,WA73,Waren aus Eisen oder Stahl,2776534000,2244538000,5021072000
2024,7,WA74,Kupfer und Waren daraus,1272982000,990255000,2263237000
2024,7,WA75,Nickel und Waren daraus,174649000,180223000,354872000
2024,7,WA76,Aluminium und Waren daraus,1574557000,1840072000,3414629000
2024,7,WA78,Blei und Waren daraus,44325000,61400000,105725000
2024,7,WA79,Zink und Waren daraus,68995000,134379000,203374000
2024,7,WA80,Zinn und Waren daraus,12505000,43325000,55830000
2024,7,WA81,"Andere unedle Metalle, Cermets usw.",145035000,205281000,350316000
2024,7,WA82,"Werkzeuge, Schneidwaren, Essbestecke",798205000,524269000,1322474000
2024,7,WA83,Verschiedene Waren aus unedlen Metallen,686538000,506767000,1193305000
2024,7,WA84,"Maschinen, Apparate, mechanische Geräte",22043872000,13798097000,35841969000
2024,7,WA85,Elektrotechnische Erzeugnisse,14061427000,15647250000,29708677000
2024,7,WA86,Schienenfahrzeuge,215251000,259737000,474988000
2024,7,WA87,"Kraftfahrzeuge, Landfahrzeuge",21917352000,10567249000,32484601000
2024,7,WA88,"Luftfahrzeuge, Raumfahrzeuge",2656152000,569122000,3225274000
2024,7,WA89,Wasserfahrzeuge,143137000,173967000,317104000
2024,7,WA90,"Optische, photografische usw. Erzeugnisse",6827107000,4018216000,10845323000
2024,7,WA91,Uhrmacherwaren,174469000,243312000,417781000
2024,7,WA92,Musikinstrumente,75444000,57643000,133087000
2024,7,WA93,Waffen und Munition,59907000,28954000,88861000
2024,7,WA94,"Möbel, Beleuchtungskörper usw.",1399857000,1676250000,3076107000
2024,7,WA95,"Spielzeug, Spiele usw., Sportgeräte",388645000,564776000,953421000
2024,7,WA96,Verschiedene Waren,351669000,325109000,676778000
2024,7,WA97,"Kunstgegenstände, Sammlungsstücke",85152000,60666000,145818000
2024,7,WA98,Vollständige Fabrikationsanlagen,44281000,62000,44343000
2024,7,WA99,Zusammenstellungen verschiedener Waren,1955247000,1145463000,3100710000
2024,8,WA01,Lebende Tiere,135578000,133005000,268583000
2024,8,WA02,Fleisch,623904000,612878000,1236782000
2024,8,WA03,"Fische, Krebs- und Weichtiere",130769000,329879000,460648000
2024,8,WA04,"Milch, Milcherzeugnisse, Eier, Honig",1062926000,930295000,1993221000
2024,8,WA05,Andere Waren tierischen Ursprungs,68410000,90858000,159268000
2024,8,WA06,"Pflanzen, Waren des Blumenhandels",59749000,186422000,246171000
2024,8,WA07,"Gemüse, Pflanzen für Ernährung",138135000,512658000,650793000
2024,8,WA08,Genießbare Früchte und Nüsse,173852000,1064440000,1238292000
2024,8,WA09,"Kaffee, Tee, Mate, Gewürze",364012000,501890000,865902000
2024,8,WA10,Getreide,171343000,272181000,443524000
2024,8,WA11,"Müllereierzeugnisse, Malz usw.",174016000,86911000,260927000
2024,8,WA12,"Ölsamen usw., Heilpflanzen usw.",109716000,531747000,641463000
2024,8,WA13,"Schellack, Gummen, Harz, Pflanzensaft",52266000,53072000,105338000
2024,8,WA14,Flechtstoffe usw. pflanzlichen Ursprungs,1058000,3766000,4824000
2024,8,WA15,"Tierische und pflanzliche Fette, Öle, Wachs",240837000,419364000,660201000
2024,8,WA16,"Zubereitungen von Fleisch, Fisch usw.",302755000,327768000,630523000
2024,8,WA17,Zucker und Zuckerwaren,337359000,220367000,557726000
2024,8,WA18,Kakao und Zubereitungen aus Kakao,952356000,778951000,1731307000
2024,8,WA19,"Zubereitungen aus Getreide usw., Backwaren",875107000,548673000,1423780000
2024,8,WA20,"Zubereitungen von Gemüse, Früchten usw.",306983000,538441000,845424000
2024,8,WA21,Verschiedene Lebensmittelzubereitungen,805813000,476739000,1282552000
2024,8,WA22,"Getränke, alkoholhaltige Flüssigkeiten, Essig",671317000,711597000,1382914000
2024,8,WA23,"Rückstände der Lebensmittelindustrie, Futter",504822000,432118000,936940000
2024,8,WA24,Tabak,289043000,472974000,762017000
2024,8,WA25,"Salz, Schwefel, Steine, Erden usw.",186774000,169757000,356531000
2024,8,WA26,"Erze, Schlacken, Aschen",46632000,766555000,813187000
2024,8,WA27,Mineralische Brennstoffe usw.,2656652000,9521615000,12178267000
2024,8,WA28,Anorganische chemische Erzeugnisse,1062302000,670921000,1733223000
2024,8,WA29,Organische chemische Erzeugnisse,2125942000,2540410000,4666352000
2024,8,WA30,Pharmazeutische Erzeugnisse,9972848000,5830735000,15803583000
2024,8,WA31,Düngemittel,229729000,94317000,324046000
2024,8,WA32,"Gerb- und Farbstoffe, Farben, Lacke usw.",943811000,453909000,1397720000
2024,8,WA33,"Etherische Öle, Riech-, Schönheitsmittel",967930000,742745000,1710675000
2024,8,WA34,"Seifen, Waschmittel usw.",758631000,476423000,1235054000
2024,8,WA35,"Eiweißstoffe, Klebstoffe, Enzyme",380320000,237491000,617811000
2024,8,WA36,"Sprengstoffe, pyrotechnische Artikel usw.",30835000,49921000,80756000
2024,8,WA37,Photochemische Erzeugnisse,77275000,51249000,128524000
2024,8,WA38,Verschiedene Erzeugnisse der Chemischen Industrie,2492327000,1505391000,3997718000
2024,8,WA39,Kunststoffe und Waren daraus,5376165000,3648782000,9024947000
2024,8,WA40,Kautschuk und Waren daraus,1224997000,1171713000,2396710000
2024,8,WA41,"Häute, Felle, Leder",35608000,27772000,63380000
2024,8,WA42,"Lederwaren, Sattlerwaren",261563000,407459000,669022000
2024,8,WA43,"Pelzfelle, künstliches Pelzwerk",4230000,7314000,11544000
2024,8,WA44,"Holz, Holzwaren, Holzkohle",739298000,619818000,1359116000
2024,8,WA45,"Kork, Korkwaren",1877000,6312000,8189000
2024,8,WA46,"Flechtwaren, Korbmacherwaren",4650000,10834000,15484000
2024,8,WA47,"Halbstoffe aus Holz usw., Papierabfall",115207000,378956000,494163000
2024,8,WA48,"Papier, Pappe und Waren daraus",1657114000,1114911000,2772025000
2024,8,WA49,"Bücher, Zeitungen, Bilddrucke usw.",295800000,202378000,498178000
2024,8,WA50,Seide,1258000,2656000,3914000
2024,8,WA51,"Wolle, feine und grobe Tierhaare",25016000,27381000,52397000
2024,8,WA52,Baumwolle,36543000,41943000,78486000
2024,8,WA53,"Andere pflanzliche Spinnstoffe, Papiergarn",2224000,3622000,5846000
2024,8,WA54,Synthetisches oder künstliches Filament,112793000,104234000,217027000
2024,8,WA55,Synthetische oder künstliche Spinnfaser,103706000,95033000,198739000
2024,8,WA56,"Watte, Filz, Vliesstoff usw., Tauwerk",201646000,138369000,340015000
2024,8,WA57,"Teppiche, Fußbodenbelag aus Spinnstoff",47063000,85800000,132863000
2024,8,WA58,"Spezialgewebe, Spitzen, Tapisserien",38649000,18498000,57147000
2024,8,WA59,"Getränkte, bestrichene usw. Gewebe",199244000,96795000,296039000
2024,8,WA60,Gewirke und Gestricke,42698000,26384000,69082000
2024,8,WA61,"Bekleidung usw. aus Gewirken, Gestricken",1144688000,1932645000,3077333000
2024,8,WA62,"Andere Bekleidung, Bekleidungszubehör",1014047000,1642850000,2656897000
2024,8,WA63,"Andere Konfektion, Spinnstoffwaren usw.",251631000,388742000,640373000
2024,8,WA64,"Schuhe, Gamaschen, ähnliche Waren",979847000,1087996000,2067843000
2024,8,WA65,Kopfbedeckungen und Teile davon,59652000,83527000,143179000
2024,8,WA66,"Schirme, Gehstöcke usw., Peitschen",8275000,15146000,23421000
2024,8,WA67,"Zugerichtete Federn, Daunen, künstliche Blumen",12887000,30438000,43325000
2024,8,WA68,"Waren aus Steinen, Gips, Zement usw.",428495000,296911000,725406000
2024,8,WA69,Keramische Waren,307645000,234071000,541716000
2024,8,WA70,Glas und Glaswaren,541294000,441022000,982316000
2024,8,WA71,"Perlen, Edelsteine, Edelmetalle",1659964000,1505217000,3165181000
2024,8,WA72,Eisen und Stahl,2188058000,1952241000,4140299000
2024,8,WA73,Waren aus Eisen oder Stahl,2545445000,1967501000,4512946000
2024,8,WA74,Kupfer und Waren daraus,1015050000,957413000,1972463000
2024,8,WA75,Nickel und Waren daraus,153194000,175760000,328954000
2024,8,WA76,Aluminium und Waren daraus,1412978000,1559694000,2972672000
2024,8,WA78,Blei und Waren daraus,46880000,44662000,91542000
2024,8,WA79,Zink und Waren daraus,57612000,112180000,169792000
2024,8,WA80,Zinn und Waren daraus,10719000,41718000,52437000
2024,8,WA81,"Andere unedle Metalle, Cermets usw.",133053000,178045000,311098000
2024,8,WA82,"Werkzeuge, Schneidwaren, Essbestecke",695391000,470571000,1165962000
2024,8,WA83,Verschiedene Waren aus unedlen Metallen,644511000,431549000,1076060000
2024,8,WA84,"Maschinen, Apparate, mechanische Geräte",19254478000,12547405000,31801883000
2024,8,WA85,Elektrotechnische Erzeugnisse,13322778000,14382925000,27705703000
2024,8,WA86,Schienenfahrzeuge,263107000,250588000,513695000
2024,8,WA87,"Kraftfahrzeuge, Landfahrzeuge",19040075000,9517438000,28557513000
2024,8,WA88,"Luftfahrzeuge, Raumfahrzeuge",2264748000,1088705000,3353453000
2024,8,WA89,Wasserfahrzeuge,175257000,139194000,314451000
2024,8,WA90,"Optische, photografische usw. Erzeugnisse",6088766000,3531548000,9620314000
2024,8,WA91,Uhrmacherwaren,150403000,193815000,344218000
2024,8,WA92,Musikinstrumente,71142000,55314000,126456000
2024,8,WA93,Waffen und Munition,57390000,25320000,82710000
2024,8,WA94,"Möbel, Beleuchtungskörper usw.",1339363000,1657939000,2997302000
2024,8,WA95,"Spielzeug, Spiele usw., Sportgeräte",425468000,650893000,1076361000
2024,8,WA96,Verschiedene Waren,326077000,284018000,610095000
2024,8,WA97,"Kunstgegenstände, Sammlungsstücke",49694000,41045000,90739000
2024,8,WA98,Vollständige Fabrikationsanlagen,60472000,0,60472000
2024,8,WA99,Zusammenstellungen verschiedener Waren,1325169000,1020459000,2345628000
2024,9,WA01,Lebende Tiere,110749000,134373000,245122000
2024,9,WA02,Fleisch,659297000,639717000,1299014000
2024,9,WA03,"Fische, Krebs- und Weichtiere",108663000,335303000,443966000
2024,9,WA04,"Milch, Milcherzeugnisse, Eier, Honig",1056038000,989172000,2045210000
2024,9,WA05,Andere Waren tierischen Ursprungs,71641000,88120000,159761000
2024,9,WA06,"Pflanzen, Waren des Blumenhandels",81982000,185497000,267479000
2024,9,WA07,"Gemüse, Pflanzen für Ernährung",152975000,553812000,706787000
2024,9,WA08,Genießbare Früchte und Nüsse,155021000,1029238000,1184259000
2024,9,WA09,"Kaffee, Tee, Mate, Gewürze",360462000,547933000,908395000
2024,9,WA10,Getreide,157291000,304003000,461294000
2024,9,WA11,"Müllereierzeugnisse, Malz usw.",187298000,88244000,275542000
2024,9,WA12,"Ölsamen usw., Heilpflanzen usw.",123757000,587271000,711028000
2024,9,WA13,"Schellack, Gummen, Harz, Pflanzensaft",52450000,60583000,113033000
2024,9,WA14,Flechtstoffe usw. pflanzlichen Ursprungs,1132000,3374000,4506000
2024,9,WA15,"Tierische und pflanzliche Fette, Öle, Wachs",324390000,489332000,813722000
2024,9,WA16,"Zubereitungen von Fleisch, Fisch usw.",292927000,316011000,608938000
2024,9,WA17,Zucker und Zuckerwaren,328464000,216015000,544479000
2024,9,WA18,Kakao und Zubereitungen aus Kakao,1018784000,887662000,1906446000
2024,9,WA19,"Zubereitungen aus Getreide usw., Backwaren",869974000,589936000,1459910000
2024,9,WA20,"Zubereitungen von Gemüse, Früchten usw.",296430000,594760000,891190000
2024,9,WA21,Verschiedene Lebensmittelzubereitungen,726717000,462159000,1188876000
2024,9,WA22,"Getränke, alkoholhaltige Flüssigkeiten, Essig",634566000,750305000,1384871000
2024,9,WA23,"Rückstände der Lebensmittelindustrie, Futter",613207000,454901000,1068108000
2024,9,WA24,Tabak,332590000,510271000,842861000
2024,9,WA25,"Salz, Schwefel, Steine, Erden usw.",215801000,164104000,379905000
2024,9,WA26,"Erze, Schlacken, Aschen",61020000,747656000,808676000
2024,9,WA27,Mineralische Brennstoffe usw.,2432753000,8790689000,11223442000
2024,9,WA28,Anorganische chemische Erzeugnisse,978989000,750082000,1729071000
2024,9,WA29,Organische chemische Erzeugnisse,2322273000,3222651000,5544924000
2024,9,WA30,Pharmazeutische Erzeugnisse,9389456000,5885808000,15275264000
2024,9,WA31,Düngemittel,238718000,104697000,343415000
2024,9,WA32,"Gerb- und Farbstoffe, Farben, Lacke usw.",990604000,468121000,1458725000
2024,9,WA33,"Etherische Öle, Riech-, Schönheitsmittel",999830000,738972000,1738802000
2024,9,WA34,"Seifen, Waschmittel usw.",746855000,488732000,1235587000
2024,9,WA35,"Eiweißstoffe, Klebstoffe, Enzyme",387352000,265061000,652413000
2024,9,WA36,"Sprengstoffe, pyrotechnische Artikel usw.",30930000,54061000,84991000
2024,9,WA37,Photochemische Erzeugnisse,78216000,58283000,136499000
2024,9,WA38,Verschiedene Erzeugnisse der Chemischen Industrie,2596986000,1641454000,4238440000
2024,9,WA39,Kunststoffe und Waren daraus,5619443000,3950129000,9569572000
2024,9,WA40,Kautschuk und Waren daraus,1442472000,1550373000,2992845000
2024,9,WA41,"Häute, Felle, Leder",40715000,32477000,73192000
2024,9,WA42,"Lederwaren, Sattlerwaren",247820000,421941000,669761000
2024,9,WA43,"Pelzfelle, künstliches Pelzwerk",7616000,8953000,16569000
2024,9,WA44,"Holz, Holzwaren, Holzkohle",757274000,671155000,1428429000
2024,9,WA45,"Kork, Korkwaren",1494000,5735000,7229000
2024,9,WA46,"Flechtwaren, Korbmacherwaren",4263000,11958000,16221000
2024,9,WA47,"Halbstoffe aus Holz usw., Papierabfall",118247000,370067000,488314000
2024,9,WA48,"Papier, Pappe und Waren daraus",1682273000,1151984000,2834257000
2024,9,WA49,"Bücher, Zeitungen, Bilddrucke usw.",299817000,215942000,515759000
2024,9,WA50,Seide,2198000,5071000,7269000
2024,9,WA51,"Wolle, feine und grobe Tierhaare",31323000,32639000,63962000
2024,9,WA52,Baumwolle,46806000,46105000,92911000
2024,9,WA53,"Andere pflanzliche Spinnstoffe, Papiergarn",2446000,5683000,8129000
2024,9,WA54,Synthetisches oder künstliches Filament,130596000,112526000,243122000
2024,9,WA55,Synthetische oder künstliche Spinnfaser,121077000,113936000,235013000
2024,9,WA56,"Watte, Filz, Vliesstoff usw., Tauwerk",219233000,142635000,361868000
2024,9,WA57,"Teppiche, Fußbodenbelag aus Spinnstoff",53220000,97830000,151050000
2024,9,WA58,"Spezialgewebe, Spitzen, Tapisserien",41104000,20327000,61431000
2024,9,WA59,"Getränkte, bestrichene usw. Gewebe",222975000,111848000,334823000
2024,9,WA60,Gewirke und Gestricke,48202000,29333000,77535000
2024,9,WA61,"Bekleidung usw. aus Gewirken, Gestricken",1172611000,1972016000,3144627000
2024,9,WA62,"Andere Bekleidung, Bekleidungszubehör",1161327000,1708628000,2869955000
2024,9,WA63,"Andere Konfektion, Spinnstoffwaren usw.",256010000,406787000,662797000
2024,9,WA64,"Schuhe, Gamaschen, ähnliche Waren",999117000,1222128000,2221245000
2024,9,WA65,Kopfbedeckungen und Teile davon,63539000,96081000,159620000
2024,9,WA66,"Schirme, Gehstöcke usw., Peitschen",7708000,13906000,21614000
2024,9,WA67,"Zugerichtete Federn, Daunen, künstliche Blumen",15230000,28639000,43869000
2024,9,WA68,"Waren aus Steinen, Gips, Zement usw.",454897000,295092000,749989000
2024,9,WA69,Keramische Waren,325995000,261731000,587726000
2024,9,WA70,Glas und Glaswaren,658522000,518917000,1177439000
2024,9,WA71,"Perlen, Edelsteine, Edelmetalle",1772295000,1568640000,3340935000
2024,9,WA72,Eisen und Stahl,2306621000,2264601000,4571222000
2024,9,WA73,Waren aus Eisen oder Stahl,2574915000,2156740000,4731655000
2024,9,WA74,Kupfer und Waren daraus,1141882000,1015535000,2157417000
2024,9,WA75,Nickel und Waren daraus,151168000,192784000,343952000
2024,9,WA76,Aluminium und Waren daraus,1458504000,1729769000,3188273000
2024,9,WA78,Blei und Waren daraus,36396000,45678000,82074000
2024,9,WA79,Zink und Waren daraus,73291000,114798000,188089000
2024,9,WA80,Zinn und Waren daraus,10736000,44292000,55028000
2024,9,WA81,"Andere unedle Metalle, Cermets usw.",148982000,180803000,329785000
2024,9,WA82,"Werkzeuge, Schneidwaren, Essbestecke",726452000,499444000,1225896000
2024,9,WA83,Verschiedene Waren aus unedlen Metallen,687498000,501947000,1189445000
2024,9,WA84,"Maschinen, Apparate, mechanische Geräte",21016618000,13670899000,34687517000
2024,9,WA85,Elektrotechnische Erzeugnisse,14091652000,16662727000,30754379000
2024,9,WA86,Schienenfahrzeuge,352445000,288792000,641237000
2024,9,WA87,"Kraftfahrzeuge, Landfahrzeuge",22452573000,11084870000,33537443000
2024,9,WA88,"Luftfahrzeuge, Raumfahrzeuge",2438811000,836792000,3275603000
2024,9,WA89,Wasserfahrzeuge,1354432000,751649000,2106081000
2024,9,WA90,"Optische, photografische usw. Erzeugnisse",6634294000,3949354000,10583648000
2024,9,WA91,Uhrmacherwaren,166304000,232458000,398762000
2024,9,WA92,Musikinstrumente,86991000,75258000,162249000
2024,9,WA93,Waffen und Munition,58170000,30730000,88900000
2024,9,WA94,"Möbel, Beleuchtungskörper usw.",1443720000,1879621000,3323341000
2024,9,WA95,"Spielzeug, Spiele usw., Sportgeräte",512164000,808463000,1320627000
2024,9,WA96,Verschiedene Waren,327792000,302816000,630608000
2024,9,WA97,"Kunstgegenstände, Sammlungsstücke",123817000,41959000,165776000
2024,9,WA98,Vollständige Fabrikationsanlagen,81634000,0,81634000
2024,9,WA99,Zusammenstellungen verschiedener Waren,1518009000,1058466000,2576475000
2024,10,WA01,Lebende Tiere,135387000,147475000,282862000
2024,10,WA02,Fleisch,682118000,722556000,1404674000
2024,10,WA03,"Fische, Krebs- und Weichtiere",112586000,352514000,465100000
2024,10,WA04,"Milch, Milcherzeugnisse, Eier, Honig",1147504000,1079681000,2227185000
2024,10,WA05,Andere Waren tierischen Ursprungs,73940000,100757000,174697000
2024,10,WA06,"Pflanzen, Waren des Blumenhandels",80610000,196230000,276840000
2024,10,WA07,"Gemüse, Pflanzen für Ernährung",159980000,588634000,748614000
2024,10,WA08,Genießbare Früchte und Nüsse,195287000,1043250000,1238537000
2024,10,WA09,"Kaffee, Tee, Mate, Gewürze",380224000,689344000,1069568000
2024,10,WA10,Getreide,174461000,335218000,509679000
2024,10,WA11,"Müllereierzeugnisse, Malz usw.",226879000,94318000,321197000
2024,10,WA12,"Ölsamen usw., Heilpflanzen usw.",119764000,658509000,778273000
2024,10,WA13,"Schellack, Gummen, Harz, Pflanzensaft",60521000,61687000,122208000
2024,10,WA14,Flechtstoffe usw. pflanzlichen Ursprungs,906000,5288000,6194000
2024,10,WA15,"Tierische und pflanzliche Fette, Öle, Wachs",320398000,427553000,747951000
2024,10,WA16,"Zubereitungen von Fleisch, Fisch usw.",333651000,328713000,662364000
2024,10,WA17,Zucker und Zuckerwaren,363619000,230812000,594431000
2024,10,WA18,Kakao und Zubereitungen aus Kakao,1093850000,967588000,2061438000
2024,10,WA19,"Zubereitungen aus Getreide usw., Backwaren",941226000,633962000,1575188000
2024,10,WA20,"Zubereitungen von Gemüse, Früchten usw.",326827000,639679000,966506000
2024,10,WA21,Verschiedene Lebensmittelzubereitungen,756365000,487347000,1243712000
2024,10,WA22,"Getränke, alkoholhaltige Flüssigkeiten, Essig",668501000,805757000,1474258000
2024,10,WA23,"Rückstände der Lebensmittelindustrie, Futter",658475000,502469000,1160944000
2024,10,WA24,Tabak,265499000,495764000,761263000
2024,10,WA25,"Salz, Schwefel, Steine, Erden usw.",235117000,169045000,404162000
2024,10,WA26,"Erze, Schlacken, Aschen",58954000,865605000,924559000
2024,10,WA27,Mineralische Brennstoffe usw.,2295277000,9137946000,11433223000
2024,10,WA28,Anorganische chemische Erzeugnisse,1103516000,664104000,1767620000
2024,10,WA29,Organische chemische Erzeugnisse,2096344000,3616473000,5712817000
2024,10,WA30,Pharmazeutische Erzeugnisse,8675720000,6286499000,14962219000
2024,10,WA31,Düngemittel,227152000,116002000,343154000
2024,10,WA32,"Gerb- und Farbstoffe, Farben, Lacke usw.",996757000,587206000,1583963000
2024,10,WA33,"Etherische Öle, Riech-, Schönheitsmittel",1028690000,827198000,1855888000
2024,10,WA34,"Seifen, Waschmittel usw.",819915000,544329000,1364244000
2024,10,WA35,"Eiweißstoffe, Klebstoffe, Enzyme",429564000,296607000,726171000
2024,10,WA36,"Sprengstoffe, pyrotechnische Artikel usw.",41016000,71565000,112581000
2024,10,WA37,Photochemische Erzeugnisse,83186000,55041000,138227000
2024,10,WA38,Verschiedene Erzeugnisse der Chemischen Industrie,2713408000,1545311000,4258719000
2024,10,WA39,Kunststoffe und Waren daraus,5713568000,3950399000,9663967000
2024,10,WA40,Kautschuk und Waren daraus,1488520000,1570895000,3059415000
2024,10,WA41,"Häute, Felle, Leder",54075000,46640000,100715000
2024,10,WA42,"Lederwaren, Sattlerwaren",250899000,402930000,653829000
2024,10,WA43,"Pelzfelle, künstliches Pelzwerk",5500000,7640000,13140000
2024,10,WA44,"Holz, Holzwaren, Holzkohle",849631000,745016000,1594647000
2024,10,WA45,"Kork, Korkwaren",2261000,8020000,10281000
2024,10,WA46,"Flechtwaren, Korbmacherwaren",4427000,10956000,15383000
2024,10,WA47,"Halbstoffe aus Holz usw., Papierabfall",112426000,364755000,477181000
2024,10,WA48,"Papier, Pappe und Waren daraus",1751353000,1165127000,2916480000
2024,10,WA49,"Bücher, Zeitungen, Bilddrucke usw.",316619000,230631000,547250000
2024,10,WA50,Seide,2426000,4664000,7090000
2024,10,WA51,"Wolle, feine und grobe Tierhaare",37352000,34050000,71402000
2024,10,WA52,Baumwolle,51326000,56222000,107548000
2024,10,WA53,"Andere pflanzliche Spinnstoffe, Papiergarn",4673000,7759000,12432000
2024,10,WA54,Synthetisches oder künstliches Filament,140168000,118667000,258835000
2024,10,WA55,Synthetische oder künstliche Spinnfaser,125072000,129588000,254660000
2024,10,WA56,"Watte, Filz, Vliesstoff usw., Tauwerk",241782000,157594000,399376000
2024,10,WA57,"Teppiche, Fußbodenbelag aus Spinnstoff",50382000,89073000,139455000
2024,10,WA58,"Spezialgewebe, Spitzen, Tapisserien",46237000,22921000,69158000
2024,10,WA59,"Getränkte, bestrichene usw. Gewebe",240995000,118748000,359743000
2024,10,WA60,Gewirke und Gestricke,55014000,34248000,89262000
2024,10,WA61,"Bekleidung usw. aus Gewirken, Gestricken",1205350000,2022790000,3228140000
2024,10,WA62,"Andere Bekleidung, Bekleidungszubehör",1132515000,1644460000,2776975000
2024,10,WA63,"Andere Konfektion, Spinnstoffwaren usw.",275304000,429543000,704847000
2024,10,WA64,"Schuhe, Gamaschen, ähnliche Waren",800054000,1074158000,1874212000
2024,10,WA65,Kopfbedeckungen und Teile davon,66417000,86466000,152883000
2024,10,WA66,"Schirme, Gehstöcke usw., Peitschen",7516000,14540000,22056000
2024,10,WA67,"Zugerichtete Federn, Daunen, künstliche Blumen",17247000,27905000,45152000
2024,10,WA68,"Waren aus Steinen, Gips, Zement usw.",489067000,301665000,790732000
2024,10,WA69,Keramische Waren,341840000,251797000,593637000
2024,10,WA70,Glas und Glaswaren,641671000,503661000,1145332000
2024,10,WA71,"Perlen, Edelsteine, Edelmetalle",2281480000,2178526000,4460006000
2024,10,WA72,Eisen und Stahl,2431117000,2452277000,4883394000
2024,10,WA73,Waren aus Eisen oder Stahl,2930687000,2319069000,5249756000
2024,10,WA74,Kupfer und Waren daraus,1224390000,1213426000,2437816000
2024,10,WA75,Nickel und Waren daraus,169862000,199626000,369488000
2024,10,WA76,Aluminium und Waren daraus,1615842000,1813287000,3429129000
2024,10,WA78,Blei und Waren daraus,53060000,52541000,105601000
2024,10,WA79,Zink und Waren daraus,78801000,120572000,199373000
2024,10,WA80,Zinn und Waren daraus,13511000,46801000,60312000
2024,10,WA81,"Andere unedle Metalle, Cermets usw.",154201000,194617000,348818000
2024,10,WA82,"Werkzeuge, Schneidwaren, Essbestecke",849568000,539019000,1388587000
2024,10,WA83,Verschiedene Waren aus unedlen Metallen,716453000,502023000,1218476000
2024,10,WA84,"Maschinen, Apparate, mechanische Geräte",21557212000,14467510000,36024722000
2024,10,WA85,Elektrotechnische Erzeugnisse,14109143000,17180136000,31289279000
2024,10,WA86,Schienenfahrzeuge,225569000,228152000,453721000
2024,10,WA87,"Kraftfahrzeuge, Landfahrzeuge",23165882000,11953136000,35119018000
2024,10,WA88,"Luftfahrzeuge, Raumfahrzeuge",3034018000,1317975000,4351993000
2024,10,WA89,Wasserfahrzeuge,87083000,237137000,324220000
2024,10,WA90,"Optische, photografische usw. Erzeugnisse",6986698000,4061837000,11048535000
2024,10,WA91,Uhrmacherwaren,171496000,237631000,409127000
2024,10,WA92,Musikinstrumente,93498000,82612000,176110000
2024,10,WA93,Waffen und Munition,69215000,31626000,100841000
2024,10,WA94,"Möbel, Beleuchtungskörper usw.",1530242000,2018218000,3548460000
2024,10,WA95,"Spielzeug, Spiele usw., Sportgeräte",574212000,941079000,1515291000
2024,10,WA96,Verschiedene Waren,356736000,326767000,683503000
2024,10,WA97,"Kunstgegenstände, Sammlungsstücke",57260000,44557000,101817000
2024,10,WA98,Vollständige Fabrikationsanlagen,60504000,0,60504000
2024,10,WA99,Zusammenstellungen verschiedener Waren,1441426000,1150637000,2592063000
2024,11,WA01,Lebende Tiere,125204000,109080000,234284000
2024,11,WA02,Fleisch,675417000,703465000,1378882000
2024,11,WA03,"Fische, Krebs- und Weichtiere",100810000,387128000,487938000
2024,11,WA04,"Milch, Milcherzeugnisse, Eier, Honig",1009047000,1013691000,2022738000
2024,11,WA05,Andere Waren tierischen Ursprungs,73957000,94506000,168463000
2024,11,WA06,"Pflanzen, Waren des Blumenhandels",61435000,198523000,259958000
2024,11,WA07,"Gemüse, Pflanzen für Ernährung",148982000,663733000,812715000
2024,11,WA08,Genießbare Früchte und Nüsse,172327000,1049145000,1221472000
2024,11,WA09,"Kaffee, Tee, Mate, Gewürze",393773000,788183000,1181956000
2024,11,WA10,Getreide,207156000,311514000,518670000
2024,11,WA11,"Müllereierzeugnisse, Malz usw.",203348000,85816000,289164000
2024,11,WA12,"Ölsamen usw., Heilpflanzen usw.",150944000,593869000,744813000
2024,11,WA13,"Schellack, Gummen, Harz, Pflanzensaft",57599000,55712000,113311000
2024,11,WA14,Flechtstoffe usw. pflanzlichen Ursprungs,1045000,3725000,4770000
2024,11,WA15,"Tierische und pflanzliche Fette, Öle, Wachs",318407000,430097000,748504000
2024,11,WA16,"Zubereitungen von Fleisch, Fisch usw.",280918000,316782000,597700000
2024,11,WA17,Zucker und Zuckerwaren,347640000,201693000,549333000
2024,11,WA18,Kakao und Zubereitungen aus Kakao,949960000,959835000,1909795000
2024,11,WA19,"Zubereitungen aus Getreide usw., Backwaren",789474000,582698000,1372172000
2024,11,WA20,"Zubereitungen von Gemüse, Früchten usw.",304165000,609172000,913337000
2024,11,WA21,Verschiedene Lebensmittelzubereitungen,744192000,462919000,1207111000
2024,11,WA22,"Getränke, alkoholhaltige Flüssigkeiten, Essig",627479000,740626000,1368105000
2024,11,WA23,"Rückstände der Lebensmittelindustrie, Futter",581057000,507208000,1088265000
2024,11,WA24,Tabak,285816000,526815000,812631000
2024,11,WA25,"Salz, Schwefel, Steine, Erden usw.",199464000,152250000,351714000
2024,11,WA26,"Erze, Schlacken, Aschen",60373000,766320000,826693000
2024,11,WA27,Mineralische Brennstoffe usw.,2791111000,8790633000,11581744000
2024,11,WA28,Anorganische chemische Erzeugnisse,1071971000,754717000,1826688000
2024,11,WA29,Organische chemische Erzeugnisse,2134462000,2919333000,5053795000
2024,11,WA30,Pharmazeutische Erzeugnisse,10054084000,5881652000,15935736000
2024,11,WA31,Düngemittel,252618000,123717000,376335000
2024,11,WA32,"Gerb- und Farbstoffe, Farben, Lacke usw.",943246000,473108000,1416354000
2024,11,WA33,"Etherische Öle, Riech-, Schönheitsmittel",1017622000,740810000,1758432000
2024,11,WA34,"Seifen, Waschmittel usw.",750049000,485947000,1235996000
2024,11,WA35,"Eiweißstoffe, Klebstoffe, Enzyme",381160000,250075000,631235000
2024,11,WA36,"Sprengstoffe, pyrotechnische Artikel usw.",31078000,49560000,80638000
2024,11,WA37,Photochemische Erzeugnisse,84184000,50341000,134525000
2024,11,WA38,Verschiedene Erzeugnisse der Chemischen Industrie,2740948000,1431998000,4172946000
2024,11,WA39,Kunststoffe und Waren daraus,5385138000,3670096000,9055234000
2024,11,WA40,Kautschuk und Waren daraus,1255958000,1313444000,2569402000
2024,11,WA41,"Häute, Felle, Leder",38898000,36378000,75276000
2024,11,WA42,"Lederwaren, Sattlerwaren",256786000,395734000,652520000
2024,11,WA43,"Pelzfelle, künstliches Pelzwerk",6141000,8117000,14258000
2024,11,WA44,"Holz, Holzwaren, Holzkohle",744253000,668598000,1412851000
2024,11,WA45,"Kork, Korkwaren",2170000,7101000,9271000
2024,11,WA46,"Flechtwaren, Korbmacherwaren",4305000,10951000,15256000
2024,11,WA47,"Halbstoffe aus Holz usw., Papierabfall",138828000,346921000,485749000
2024,11,WA48,"Papier, Pappe und Waren daraus",1652536000,1121446000,2773982000
2024,11,WA49,"Bücher, Zeitungen, Bilddrucke usw.",311108000,241596000,552704000
2024,11,WA50,Seide,1255000,3499000,4754000
2024,11,WA51,"Wolle, feine und grobe Tierhaare",31289000,29388000,60677000
2024,11,WA52,Baumwolle,50033000,51437000,101470000
2024,11,WA53,"Andere pflanzliche Spinnstoffe, Papiergarn",5033000,7906000,12939000
2024,11,WA54,Synthetisches oder künstliches Filament,114158000,98434000,212592000
2024,11,WA55,Synthetische oder künstliche Spinnfaser,124825000,115756000,240581000
2024,11,WA56,"Watte, Filz, Vliesstoff usw., Tauwerk",206745000,136612000,343357000
2024,11,WA57,"Teppiche, Fußbodenbelag aus Spinnstoff",63234000,107110000,170344000
2024,11,WA58,"Spezialgewebe, Spitzen, Tapisserien",43578000,20465000,64043000
2024,11,WA59,"Getränkte, bestrichene usw. Gewebe",211022000,94399000,305421000
2024,11,WA60,Gewirke und Gestricke,48475000,31178000,79653000
2024,11,WA61,"Bekleidung usw. aus Gewirken, Gestricken",1319490000,1848762000,3168252000
2024,11,WA62,"Andere Bekleidung, Bekleidungszubehör",1204631000,1460523000,2665154000
2024,11,WA63,"Andere Konfektion, Spinnstoffwaren usw.",276729000,395548000,672277000
2024,11,WA64,"Schuhe, Gamaschen, ähnliche Waren",1025235000,1107491000,2132726000
2024,11,WA65,Kopfbedeckungen und Teile davon,67778000,79334000,147112000
2024,11,WA66,"Schirme, Gehstöcke usw., Peitschen",7987000,15503000,23490000
2024,11,WA67,"Zugerichtete Federn, Daunen, künstliche Blumen",15292000,27032000,42324000
2024,11,WA68,"Waren aus Steinen, Gips, Zement usw.",480701000,277037000,757738000
2024,11,WA69,Keramische Waren,329088000,262167000,591255000
2024,11,WA70,Glas und Glaswaren,617737000,465838000,1083575000
2024,11,WA71,"Perlen, Edelsteine, Edelmetalle",2871075000,2146953000,5018028000
2024,11,WA72,Eisen und Stahl,2172225000,1942352000,4114577000
2024,11,WA73,Waren aus Eisen oder Stahl,2708210000,2035489000,4743699000
2024,11,WA74,Kupfer und Waren daraus,1095980000,960450000,2056430000
2024,11,WA75,Nickel und Waren daraus,169912000,157397000,327309000
2024,11,WA76,Aluminium und Waren daraus,1484802000,1682608000,3167410000
2024,11,WA78,Blei und Waren daraus,46275000,50702000,96977000
2024,11,WA79,Zink und Waren daraus,78983000,110933000,189916000
2024,11,WA80,Zinn und Waren daraus,13580000,38601000,52181000
2024,11,WA81,"Andere unedle Metalle, Cermets usw.",130522000,184516000,315038000
2024,11,WA82,"Werkzeuge, Schneidwaren, Essbestecke",777929000,480649000,1258578000
2024,11,WA83,Verschiedene Waren aus unedlen Metallen,678015000,458513000,1136528000
2024,11,WA84,"Maschinen, Apparate, mechanische Geräte",21179867000,13773139000,34953006000
2024,11,WA85,Elektrotechnische Erzeugnisse,13650902000,16287979000,29938881000
2024,11,WA86,Schienenfahrzeuge,264548000,218038000,482586000
2024,11,WA87,"Kraftfahrzeuge, Landfahrzeuge",22234329000,11626214000,33860543000
2024,11,WA88,"Luftfahrzeuge, Raumfahrzeuge",3342411000,1258418000,4600829000
2024,11,WA89,Wasserfahrzeuge,46169000,239716000,285885000
2024,11,WA90,"Optische, photografische usw. Erzeugnisse",6883761000,3947937000,10831698000
2024,11,WA91,Uhrmacherwaren,181715000,239535000,421250000
2024,11,WA92,Musikinstrumente,97861000,79627000,177488000
2024,11,WA93,Waffen und Munition,51476000,28430000,79906000
2024,11,WA94,"Möbel, Beleuchtungskörper usw.",1468561000,1871008000,3339569000
2024,11,WA95,"Spielzeug, Spiele usw., Sportgeräte",550851000,936242000,1487093000
2024,11,WA96,Verschiedene Waren,330609000,316576000,647185000
2024,11,WA97,"Kunstgegenstände, Sammlungsstücke",151948000,67349000,219297000
2024,11,WA98,Vollständige Fabrikationsanlagen,53608000,9000,53617000
2024,11,WA99,Zusammenstellungen verschiedener Waren,1523860000,1128298000,2652158000
2024,12,WA01,Lebende Tiere,167253000,132795000,300048000
2024,12,WA02,Fleisch,631717000,723566000,1355283000
2024,12,WA03,"Fische, Krebs- und Weichtiere",124755000,372950000,497705000
2024,12,WA04,"Milch, Milcherzeugnisse, Eier, Honig",1037689000,1114333000,2152022000
2024,12,WA05,Andere Waren tierischen Ursprungs,63101000,81520000,144621000
2024,12,WA06,"Pflanzen, Waren des Blumenhandels",55792000,204605000,260397000
2024,12,WA07,"Gemüse, Pflanzen für Ernährung",140879000,750919000,891798000
2024,12,WA08,Genießbare Früchte und Nüsse,189028000,1130421000,1319449000
2024,12,WA09,"Kaffee, Tee, Mate, Gewürze",370154000,600189000,970343000
2024,12,WA10,Getreide,200389000,271668000,472057000
2024,12,WA11,"Müllereierzeugnisse, Malz usw.",173851000,84919000,258770000
2024,12,WA12,"Ölsamen usw., Heilpflanzen usw.",152940000,683020000,835960000
2024,12,WA13,"Schellack, Gummen, Harz, Pflanzensaft",51839000,49435000,101274000
2024,12,WA14,Flechtstoffe usw. pflanzlichen Ursprungs,682000,2580000,3262000
2024,12,WA15,"Tierische und pflanzliche Fette, Öle, Wachs",276730000,414466000,691196000
2024,12,WA16,"Zubereitungen von Fleisch, Fisch usw.",282779000,359599000,642378000
2024,12,WA17,Zucker und Zuckerwaren,285571000,179659000,465230000
2024,12,WA18,Kakao und Zubereitungen aus Kakao,838899000,889350000,1728249000
2024,12,WA19,"Zubereitungen aus Getreide usw., Backwaren",795929000,622820000,1418749000
2024,12,WA20,"Zubereitungen von Gemüse, Früchten usw.",313693000,593143000,906836000
2024,12,WA21,Verschiedene Lebensmittelzubereitungen,682977000,472806000,1155783000
2024,12,WA22,"Getränke, alkoholhaltige Flüssigkeiten, Essig",560657000,663851000,1224508000
2024,12,WA23,"Rückstände der Lebensmittelindustrie, Futter",605294000,446182000,1051476000
2024,12,WA24,Tabak,238128000,434428000,672556000
2024,12,WA25,"Salz, Schwefel, Steine, Erden usw.",175875000,140546000,316421000
2024,12,WA26,"Erze, Schlacken, Aschen",55859000,821381000,877240000
2024,12,WA27,Mineralische Brennstoffe usw.,2813368000,9942243000,12755611000
2024,12,WA28,Anorganische chemische Erzeugnisse,855827000,674492000,1530319000
2024,12,WA29,Organische chemische Erzeugnisse,1833954000,2374927000,4208881000
2024,12,WA30,Pharmazeutische Erzeugnisse,8446607000,5258595000,13705202000
2024,12,WA31,Düngemittel,211532000,121167000,332699000
2024,12,WA32,"Gerb- und Farbstoffe, Farben, Lacke usw.",764015000,381632000,1145647000
2024,12,WA33,"Etherische Öle, Riech-, Schönheitsmittel",890015000,704054000,1594069000
2024,12,WA34,"Seifen, Waschmittel usw.",646293000,390716000,1037009000
2024,12,WA35,"Eiweißstoffe, Klebstoffe, Enzyme",348777000,225774000,574551000
2024,12,WA36,"Sprengstoffe, pyrotechnische Artikel usw.",48222000,32905000,81127000
2024,12,WA37,Photochemische Erzeugnisse,75035000,58448000,133483000
2024,12,WA38,Verschiedene Erzeugnisse der Chemischen Industrie,2288130000,1295792000,3583922000
2024,12,WA39,Kunststoffe und Waren daraus,4440954000,3076154000,7517108000
2024,12,WA40,Kautschuk und Waren daraus,1122793000,1010113000,2132906000
2024,12,WA41,"Häute, Felle, Leder",39494000,36162000,75656000
2024,12,WA42,"Lederwaren, Sattlerwaren",257295000,392913000,650208000
2024,12,WA43,"Pelzfelle, künstliches Pelzwerk",4323000,5642000,9965000
2024,12,WA44,"Holz, Holzwaren, Holzkohle",633587000,534855000,1168442000
2024,12,WA45,"Kork, Korkwaren",1574000,5147000,6721000
2024,12,WA46,"Flechtwaren, Korbmacherwaren",3739000,12777000,16516000
2024,12,WA47,"Halbstoffe aus Holz usw., Papierabfall",119036000,338017000,457053000
2024,12,WA48,"Papier, Pappe und Waren daraus",1486294000,1011377000,2497671000
2024,12,WA49,"Bücher, Zeitungen, Bilddrucke usw.",287860000,261794000,549654000
2024,12,WA50,Seide,697000,2121000,2818000
2024,12,WA51,"Wolle, feine und grobe Tierhaare",23386000,25115000,48501000
2024,12,WA52,Baumwolle,36225000,39835000,76060000
2024,12,WA53,"Andere pflanzliche Spinnstoffe, Papiergarn",5278000,6017000,11295000
2024,12,WA54,Synthetisches oder künstliches Filament,95801000,75911000,171712000
2024,12,WA55,Synthetische oder künstliche Spinnfaser,111871000,87095000,198966000
2024,12,WA56,"Watte, Filz, Vliesstoff usw., Tauwerk",168029000,114592000,282621000
2024,12,WA57,"Teppiche, Fußbodenbelag aus Spinnstoff",44744000,93364000,138108000
2024,12,WA58,"Spezialgewebe, Spitzen, Tapisserien",31872000,16611000,48483000
2024,12,WA59,"Getränkte, bestrichene usw. Gewebe",169035000,91415000,260450000
2024,12,WA60,Gewirke und Gestricke,36296000,22410000,58706000
2024,12,WA61,"Bekleidung usw. aus Gewirken, Gestricken",1108803000,1727406000,2836209000
2024,12,WA62,"Andere Bekleidung, Bekleidungszubehör",938384000,1402921000,2341305000
2024,12,WA63,"Andere Konfektion, Spinnstoffwaren usw.",234793000,358998000,593791000
2024,12,WA64,"Schuhe, Gamaschen, ähnliche Waren",773471000,957139000,1730610000
2024,12,WA65,Kopfbedeckungen und Teile davon,60175000,77420000,137595000
2024,12,WA66,"Schirme, Gehstöcke usw., Peitschen",5654000,14606000,20260000
2024,12,WA67,"Zugerichtete Federn, Daunen, künstliche Blumen",13894000,32196000,46090000
2024,12,WA68,"Waren aus Steinen, Gips, Zement usw.",369692000,238181000,607873000
2024,12,WA69,Keramische Waren,278537000,220143000,498680000
2024,12,WA70,Glas und Glaswaren,488900000,362991000,851891000
2024,12,WA71,"Perlen, Edelsteine, Edelmetalle",2006711000,1900419000,3907130000
2024,12,WA72,Eisen und Stahl,1720789000,1543052000,3263841000
2024,12,WA73,Waren aus Eisen oder Stahl,2170043000,1753918000,3923961000
2024,12,WA74,Kupfer und Waren daraus,879244000,789029000,1668273000
2024,12,WA75,Nickel und Waren daraus,120584000,129527000,250111000
2024,12,WA76,Aluminium und Waren daraus,1131641000,1290493000,2422134000
2024,12,WA78,Blei und Waren daraus,49783000,52802000,102585000
2024,12,WA79,Zink und Waren daraus,53911000,105884000,159795000
2024,12,WA80,Zinn und Waren daraus,10521000,31345000,41866000
2024,12,WA81,"Andere unedle Metalle, Cermets usw.",128768000,143273000,272041000
2024,12,WA82,"Werkzeuge, Schneidwaren, Essbestecke",637238000,452243000,1089481000
2024,12,WA83,Verschiedene Waren aus unedlen Metallen,525987000,401590000,927577000
2024,12,WA84,"Maschinen, Apparate, mechanische Geräte",19193097000,12277975000,31471072000
2024,12,WA85,Elektrotechnische Erzeugnisse,12545326000,14276674000,26822000000
2024,12,WA86,Schienenfahrzeuge,267559000,297399000,564958000
2024,12,WA87,"Kraftfahrzeuge, Landfahrzeuge",16430082000,9570236000,26000318000
2024,12,WA88,"Luftfahrzeuge, Raumfahrzeuge",4478788000,1008205000,5486993000
2024,12,WA89,Wasserfahrzeuge,480381000,149116000,629497000
2024,12,WA90,"Optische, photografische usw. Erzeugnisse",6384493000,3732268000,10116761000
2024,12,WA91,Uhrmacherwaren,164104000,206704000,370808000
2024,12,WA92,Musikinstrumente,104689000,75163000,179852000
2024,12,WA93,Waffen und Munition,50435000,20352000,70787000
2024,12,WA94,"Möbel, Beleuchtungskörper usw.",1257923000,1622712000,2880635000
2024,12,WA95,"Spielzeug, Spiele usw., Sportgeräte",449527000,784989000,1234516000
2024,12,WA96,Verschiedene Waren,305623000,281780000,587403000
2024,12,WA97,"Kunstgegenstände, Sammlungsstücke",81572000,63991000,145563000
2024,12,WA98,Vollständige Fabrikationsanlagen,44255000,0,44255000
2024,12,WA99,Zusammenstellungen verschiedener Waren,1799901000,1278787000,3078688000
